frame,i,x1,y1,x2,y2,x,y,angle,size
5, 38, 110, 368, 109, 367, 1, 1, 0.7853981633974483, 1.4142135623730951
5, 50, 487, 198, 489, 199, -2, -1, -2.677945044588987, 2.23606797749979
5, 59, 502, 171, 501, 170, 1, 1, 0.7853981633974483, 1.4142135623730951
5, 66, 454, 112, 453, 114, 1, -2, -1.1071487177940904, 2.23606797749979
5, 74, 77, 317, 77, 319, 0, -2, -1.5707963267948966, 2.0
5, 82, 116, 315, 116, 317, 0, -2, -1.5707963267948966, 2.0
5, 105, 391, 350, 391, 352, 0, -2, -1.5707963267948966, 2.0
5, 111, 313, 235, 315, 238, -2, -3, -2.158798930342464, 3.605551275463989
5, 130, 350, 151, 352, 151, -2, 0, 3.141592653589793, 2.0
5, 138, 475, 281, 475, 283, 0, -2, -1.5707963267948966, 2.0
5, 144, 503, 296, 504, 295, -1, 1, 2.356194490192345, 1.4142135623730951
6, 1, 113, 271, 115, 272, -2, -1, -2.677945044588987, 2.23606797749979
6, 39, 353, 110, 355, 112, -2, -2, -2.356194490192345, 2.8284271247461903
6, 62, 77, 315, 77, 317, 0, -2, -1.5707963267948966, 2.0
6, 66, 99, 223, 99, 225, 0, -2, -1.5707963267948966, 2.0
6, 96, 312, 233, 313, 235, -1, -2, -2.0344439357957027, 2.23606797749979
6, 115, 475, 279, 475, 281, 0, -2, -1.5707963267948966, 2.0
7, 20, 538, 163, 540, 163, -2, 0, 3.141592653589793, 2.0
7, 90, 433, 264, 434, 263, -1, 1, 2.356194490192345, 1.4142135623730951
7, 110, 503, 293, 503, 295, 0, -2, -1.5707963267948966, 2.0
8, 1, 110, 270, 112, 271, -2, -1, -2.677945044588987, 2.23606797749979
8, 46, 241, 254, 240, 255, 1, -1, -0.7853981633974483, 1.4142135623730951
8, 98, 503, 291, 503, 293, 0, -2, -1.5707963267948966, 2.0
9, 10, 601, 239, 599, 239, 2, 0, 0.0, 2.0
9, 36, 210, 328, 209, 329, 1, -1, -0.7853981633974483, 1.4142135623730951
9, 63, 395, 309, 394, 310, 1, -1, -0.7853981633974483, 1.4142135623730951
9, 91, 90, 221, 92, 219, -2, 2, 2.356194490192345, 2.8284271247461903
9, 92, 475, 275, 475, 277, 0, -2, -1.5707963267948966, 2.0
10, 1, 192, 151, 194, 151, -2, 0, 3.141592653589793, 2.0
10, 3, 253, 121, 255, 122, -2, -1, -2.677945044588987, 2.23606797749979
10, 43, 418, 358, 420, 358, -2, 0, 3.141592653589793, 2.0
10, 66, 54, 177, 56, 177, -2, 0, 3.141592653589793, 2.0
10, 76, 359, 225, 358, 228, 1, -3, -1.2490457723982544, 3.1622776601683795
10, 96, 69, 193, 69, 195, 0, -2, -1.5707963267948966, 2.0
11, 11, 109, 366, 111, 368, -2, -2, -2.356194490192345, 2.8284271247461903
11, 12, 430, 212, 429, 213, 1, -1, -0.7853981633974483, 1.4142135623730951
11, 13, 450, 234, 449, 235, 1, -1, -0.7853981633974483, 1.4142135623730951
11, 42, 174, 330, 175, 329, -1, 1, 2.356194490192345, 1.4142135623730951
11, 69, 357, 227, 359, 225, -2, 2, 2.356194490192345, 2.8284271247461903
11, 87, 68, 191, 69, 193, -1, -2, -2.0344439357957027, 2.23606797749979
11, 117, 289, 312, 291, 313, -2, -1, -2.677945044588987, 2.23606797749979
12, 12, 450, 232, 450, 234, 0, -2, -1.5707963267948966, 2.0
12, 23, 484, 158, 484, 160, 0, -2, -1.5707963267948966, 2.0
12, 40, 194, 344, 195, 343, -1, 1, 2.356194490192345, 1.4142135623730951
12, 42, 211, 330, 210, 331, 1, -1, -0.7853981633974483, 1.4142135623730951
12, 81, 66, 190, 68, 191, -2, -1, -2.677945044588987, 2.23606797749979
12, 111, 92, 216, 92, 218, 0, -2, -1.5707963267948966, 2.0
13, 49, 50, 176, 52, 177, -2, -1, -2.677945044588987, 2.23606797749979
13, 72, 64, 189, 66, 190, -2, -1, -2.677945044588987, 2.23606797749979
14, 41, 66, 242, 67, 241, -1, 1, 2.356194490192345, 1.4142135623730951
14, 56, 339, 197, 340, 196, -1, 1, 2.356194490192345, 1.4142135623730951
14, 66, 61, 188, 64, 189, -3, -1, -2.819842099193151, 3.1622776601683795
15, 13, 253, 118, 254, 120, -1, -2, -2.0344439357957027, 2.23606797749979
15, 67, 566, 332, 565, 333, 1, -1, -0.7853981633974483, 1.4142135623730951
15, 118, 523, 275, 525, 276, -2, -1, -2.677945044588987, 2.23606797749979
15, 123, 91, 329, 93, 330, -2, -1, -2.677945044588987, 2.23606797749979
16, 91, 161, 361, 162, 360, -1, 1, 2.356194490192345, 1.4142135623730951
16, 110, 179, 268, 180, 267, -1, 1, 2.356194490192345, 1.4142135623730951
17, 3, 180, 225, 182, 226, -2, -1, -2.677945044588987, 2.23606797749979
17, 92, 412, 158, 411, 159, 1, -1, -0.7853981633974483, 1.4142135623730951
17, 94, 520, 275, 522, 275, -2, 0, 3.141592653589793, 2.0
17, 96, 180, 270, 179, 268, 1, 2, 1.1071487177940904, 2.23606797749979
18, 3, 450, 230, 449, 231, 1, -1, -0.7853981633974483, 1.4142135623730951
18, 22, 79, 366, 77, 367, 2, -1, -0.4636476090008061, 2.23606797749979
18, 72, 160, 362, 161, 361, -1, 1, 2.356194490192345, 1.4142135623730951
18, 85, 518, 275, 520, 275, -2, 0, 3.141592653589793, 2.0
18, 87, 181, 269, 180, 270, 1, -1, -0.7853981633974483, 1.4142135623730951
19, 12, 43, 358, 43, 360, 0, -2, -1.5707963267948966, 2.0
19, 19, 79, 364, 79, 366, 0, -2, -1.5707963267948966, 2.0
19, 41, 566, 330, 565, 331, 1, -1, -0.7853981633974483, 1.4142135623730951
19, 78, 516, 273, 518, 275, -2, -2, -2.356194490192345, 2.8284271247461903
19, 80, 182, 268, 181, 269, 1, -1, -0.7853981633974483, 1.4142135623730951
20, 23, 39, 311, 38, 312, 1, -1, -0.7853981633974483, 1.4142135623730951
20, 45, 327, 222, 329, 221, -2, 1, 2.677945044588987, 2.23606797749979
20, 92, 404, 111, 404, 113, 0, -2, -1.5707963267948966, 2.0
20, 132, 80, 366, 80, 368, 0, -2, -1.5707963267948966, 2.0
21, 55, 144, 211, 146, 211, -2, 0, 3.141592653589793, 2.0
21, 112, 176, 182, 177, 181, -1, 1, 2.356194490192345, 1.4142135623730951
22, 2, 45, 366, 46, 365, -1, 1, 2.356194490192345, 1.4142135623730951
22, 19, 41, 310, 40, 311, 1, -1, -0.7853981633974483, 1.4142135623730951
22, 77, 409, 219, 411, 220, -2, -1, -2.677945044588987, 2.23606797749979
22, 111, 401, 140, 400, 141, 1, -1, -0.7853981633974483, 1.4142135623730951
23, 2, 44, 368, 45, 366, -1, 2, 2.0344439357957027, 2.23606797749979
23, 30, 212, 330, 211, 331, 1, -1, -0.7853981633974483, 1.4142135623730951
23, 97, 401, 136, 401, 140, 0, -4, -1.5707963267948966, 4.0
23, 102, 282, 244, 284, 243, -2, 1, 2.677945044588987, 2.23606797749979
24, 2, 42, 368, 44, 368, -2, 0, 3.141592653589793, 2.0
24, 51, 94, 161, 93, 162, 1, -1, -0.7853981633974483, 1.4142135623730951
24, 74, 211, 148, 212, 147, -1, 1, 2.356194490192345, 1.4142135623730951
24, 88, 163, 311, 162, 313, 1, -2, -1.1071487177940904, 2.23606797749979
25, 87, 398, 196, 399, 195, -1, 1, 2.356194490192345, 1.4142135623730951
25, 90, 167, 257, 167, 259, 0, -2, -1.5707963267948966, 2.0
25, 100, 72, 314, 73, 313, -1, 1, 2.356194490192345, 1.4142135623730951
25, 135, 478, 133, 479, 135, -1, -2, -2.0344439357957027, 2.23606797749979
25, 138, 207, 269, 209, 268, -2, 1, 2.677945044588987, 2.23606797749979
25, 145, 494, 278, 494, 280, 0, -2, -1.5707963267948966, 2.0
26, 26, 349, 110, 351, 110, -2, 0, 3.141592653589793, 2.0
26, 36, 500, 357, 501, 356, -1, 1, 2.356194490192345, 1.4142135623730951
26, 72, 390, 349, 393, 351, -3, -2, -2.5535900500422257, 3.605551275463989
26, 118, 479, 132, 478, 133, 1, -1, -0.7853981633974483, 1.4142135623730951
26, 126, 495, 277, 494, 278, 1, -1, -0.7853981633974483, 1.4142135623730951
27, 4, 451, 111, 453, 111, -2, 0, 3.141592653589793, 2.0
27, 40, 38, 307, 39, 309, -1, -2, -2.0344439357957027, 2.23606797749979
27, 95, 53, 310, 50, 308, 3, 2, 0.5880026035475675, 3.605551275463989
27, 114, 496, 274, 495, 277, 1, -3, -1.2490457723982544, 3.1622776601683795
28, 2, 449, 111, 451, 111, -2, 0, 3.141592653589793, 2.0
28, 43, 417, 201, 419, 202, -2, -1, -2.677945044588987, 2.23606797749979
28, 81, 473, 164, 474, 163, -1, 1, 2.356194490192345, 1.4142135623730951
28, 99, 497, 272, 496, 274, 1, -2, -1.1071487177940904, 2.23606797749979
28, 102, 366, 173, 368, 174, -2, -1, -2.677945044588987, 2.23606797749979
29, 0, 43, 111, 41, 111, 2, 0, 0.0, 2.0
29, 4, 41, 234, 42, 233, -1, 1, 2.356194490192345, 1.4142135623730951
29, 42, 415, 201, 417, 201, -2, 0, 3.141592653589793, 2.0
29, 50, 390, 282, 391, 281, -1, 1, 2.356194490192345, 1.4142135623730951
29, 93, 498, 271, 497, 272, 1, -1, -0.7853981633974483, 1.4142135623730951
30, 2, 230, 159, 231, 158, -1, 1, 2.356194490192345, 1.4142135623730951
30, 6, 43, 115, 42, 114, 1, 1, 0.7853981633974483, 1.4142135623730951
30, 12, 221, 214, 222, 213, -1, 1, 2.356194490192345, 1.4142135623730951
30, 18, 194, 333, 196, 331, -2, 2, 2.356194490192345, 2.8284271247461903
30, 57, 538, 164, 538, 167, 0, -3, -1.5707963267948966, 3.0
30, 141, 499, 270, 497, 271, 2, -1, -0.4636476090008061, 2.23606797749979
30, 163, 198, 130, 201, 131, -3, -1, -2.819842099193151, 3.1622776601683795
31, 10, 217, 215, 221, 214, -4, 1, 2.896613990462929, 4.123105625617661
31, 28, 273, 297, 272, 298, 1, -1, -0.7853981633974483, 1.4142135623730951
31, 52, 538, 162, 538, 164, 0, -2, -1.5707963267948966, 2.0
31, 127, 500, 269, 499, 270, 1, -1, -0.7853981633974483, 1.4142135623730951
31, 129, 205, 311, 207, 310, -2, 1, 2.677945044588987, 2.23606797749979
32, 10, 215, 213, 217, 215, -2, -2, -2.356194490192345, 2.8284271247461903
32, 97, 134, 196, 134, 198, 0, -2, -1.5707963267948966, 2.0
33, 10, 215, 211, 215, 213, 0, -2, -1.5707963267948966, 2.0
33, 57, 583, 328, 582, 329, 1, -1, -0.7853981633974483, 1.4142135623730951
33, 72, 125, 196, 123, 197, 2, -1, -0.4636476090008061, 2.23606797749979
33, 77, 97, 194, 98, 193, -1, 1, 2.356194490192345, 1.4142135623730951
33, 88, 132, 195, 134, 196, -2, -1, -2.677945044588987, 2.23606797749979
34, 0, 37, 363, 39, 364, -2, -1, -2.677945044588987, 2.23606797749979
34, 42, 538, 159, 538, 161, 0, -2, -1.5707963267948966, 2.0
34, 70, 125, 194, 125, 196, 0, -2, -1.5707963267948966, 2.0
34, 75, 96, 195, 97, 194, -1, 1, 2.356194490192345, 1.4142135623730951
34, 85, 130, 194, 132, 195, -2, -1, -2.677945044588987, 2.23606797749979
35, 40, 229, 159, 231, 159, -2, 0, 3.141592653589793, 2.0
35, 100, 51, 308, 51, 310, 0, -2, -1.5707963267948966, 2.0
35, 148, 124, 195, 125, 197, -1, -2, -2.0344439357957027, 2.23606797749979
35, 163, 120, 298, 122, 298, -2, 0, 3.141592653589793, 2.0
36, 47, 114, 274, 113, 275, 1, -1, -0.7853981633974483, 1.4142135623730951
36, 74, 327, 189, 329, 190, -2, -1, -2.677945044588987, 2.23606797749979
36, 93, 113, 290, 115, 291, -2, -1, -2.677945044588987, 2.23606797749979
36, 141, 117, 295, 120, 298, -3, -3, -2.356194490192345, 4.242640687119285
37, 9, 429, 109, 429, 111, 0, -2, -1.5707963267948966, 2.0
37, 29, 226, 158, 228, 159, -2, -1, -2.677945044588987, 2.23606797749979
38, 9, 430, 107, 429, 109, 1, -2, -1.1071487177940904, 2.23606797749979
38, 76, 434, 105, 433, 106, 1, -1, -0.7853981633974483, 1.4142135623730951
38, 105, 347, 153, 348, 152, -1, 1, 2.356194490192345, 1.4142135623730951
39, 8, 431, 106, 430, 107, 1, -1, -0.7853981633974483, 1.4142135623730951
39, 49, 325, 186, 326, 188, -1, -2, -2.0344439357957027, 2.23606797749979
39, 68, 435, 104, 434, 105, 1, -1, -0.7853981633974483, 1.4142135623730951
40, 106, 372, 238, 374, 238, -2, 0, 3.141592653589793, 2.0
43, 62, 507, 167, 506, 166, 1, 1, 0.7853981633974483, 1.4142135623730951
43, 75, 570, 310, 569, 311, 1, -1, -0.7853981633974483, 1.4142135623730951
43, 80, 474, 204, 476, 204, -2, 0, 3.141592653589793, 2.0
43, 82, 73, 299, 73, 301, 0, -2, -1.5707963267948966, 2.0
44, 71, 572, 309, 570, 310, 2, -1, -0.4636476090008061, 2.23606797749979
44, 75, 472, 202, 474, 204, -2, -2, -2.356194490192345, 2.8284271247461903
45, 16, 223, 110, 223, 112, 0, -2, -1.5707963267948966, 2.0
45, 34, 503, 219, 505, 221, -2, -2, -2.356194490192345, 2.8284271247461903
46, 32, 500, 218, 503, 219, -3, -1, -2.819842099193151, 3.1622776601683795
46, 51, 126, 176, 126, 180, 0, -4, -1.5707963267948966, 4.0
47, 39, 594, 169, 595, 168, -1, 1, 2.356194490192345, 1.4142135623730951
47, 43, 431, 208, 433, 208, -2, 0, 3.141592653589793, 2.0
47, 47, 123, 173, 126, 176, -3, -3, -2.356194490192345, 4.242640687119285
48, 100, 306, 134, 307, 133, -1, 1, 2.356194490192345, 1.4142135623730951
49, 89, 77, 216, 78, 215, -1, 1, 2.356194490192345, 1.4142135623730951
50, 40, 43, 113, 44, 117, -1, -4, -1.8157749899217608, 4.123105625617661
50, 47, 137, 178, 138, 180, -1, -2, -2.0344439357957027, 2.23606797749979
50, 105, 154, 344, 155, 343, -1, 1, 2.356194490192345, 1.4142135623730951
51, 14, 221, 113, 223, 112, -2, 1, 2.677945044588987, 2.23606797749979
51, 33, 39, 112, 43, 113, -4, -1, -2.896613990462929, 4.123105625617661
51, 34, 479, 158, 479, 160, 0, -2, -1.5707963267948966, 2.0
51, 54, 598, 171, 600, 171, -2, 0, 3.141592653589793, 2.0
51, 109, 421, 348, 420, 347, 1, 1, 0.7853981633974483, 1.4142135623730951
52, 27, 37, 112, 39, 112, -2, 0, 3.141592653589793, 2.0
52, 48, 596, 171, 598, 171, -2, 0, 3.141592653589793, 2.0
55, 102, 126, 303, 127, 302, -1, 1, 2.356194490192345, 1.4142135623730951
56, 23, 595, 359, 597, 358, -2, 1, 2.677945044588987, 2.23606797749979
60, 22, 37, 191, 38, 190, -1, 1, 2.356194490192345, 1.4142135623730951
60, 117, 146, 205, 147, 207, -1, -2, -2.0344439357957027, 2.23606797749979
61, 14, 38, 192, 37, 191, 1, 1, 0.7853981633974483, 1.4142135623730951
61, 69, 117, 339, 119, 339, -2, 0, 3.141592653589793, 2.0
61, 83, 146, 203, 146, 205, 0, -2, -1.5707963267948966, 2.0
62, 29, 109, 293, 110, 292, -1, 1, 2.356194490192345, 1.4142135623730951
62, 45, 51, 189, 51, 191, 0, -2, -1.5707963267948966, 2.0
63, 24, 106, 292, 109, 293, -3, -1, -2.819842099193151, 3.1622776601683795
67, 24, 586, 185, 588, 185, -2, 0, 3.141592653589793, 2.0
69, 0, 296, 227, 295, 228, 1, -1, -0.7853981633974483, 1.4142135623730951
70, 2, 179, 225, 181, 225, -2, 0, 3.141592653589793, 2.0
70, 8, 229, 159, 231, 159, -2, 0, 3.141592653589793, 2.0
70, 9, 114, 271, 116, 272, -2, -1, -2.677945044588987, 2.23606797749979
70, 29, 542, 163, 544, 164, -2, -1, -2.677945044588987, 2.23606797749979
70, 30, 498, 153, 500, 154, -2, -1, -2.677945044588987, 2.23606797749979
70, 93, 82, 120, 82, 122, 0, -2, -1.5707963267948966, 2.0
70, 146, 532, 166, 533, 168, -1, -2, -2.0344439357957027, 2.23606797749979
70, 149, 124, 269, 126, 271, -2, -2, -2.356194490192345, 2.8284271247461903
73, 18, 499, 152, 497, 152, 2, 0, 0.0, 2.0
74, 0, 306, 307, 304, 308, 2, -1, -0.4636476090008061, 2.23606797749979
74, 1, 296, 226, 294, 228, 2, -2, -0.7853981633974483, 2.8284271247461903
74, 2, 136, 182, 134, 180, 2, 2, 0.7853981633974483, 2.8284271247461903
74, 4, 589, 209, 595, 208, -6, 1, 2.976443976175166, 6.082762530298219
74, 5, 46, 116, 44, 114, 2, 2, 0.7853981633974483, 2.8284271247461903
74, 6, 257, 114, 258, 113, -1, 1, 2.356194490192345, 1.4142135623730951
74, 7, 381, 364, 378, 363, 3, 1, 0.3217505543966422, 3.1622776601683795
74, 8, 485, 279, 486, 278, -1, 1, 2.356194490192345, 1.4142135623730951
74, 11, 493, 362, 495, 359, -2, 3, 2.158798930342464, 3.605551275463989
74, 12, 455, 111, 455, 108, 0, 3, 1.5707963267948966, 3.0
74, 13, 596, 244, 599, 244, -3, 0, 3.141592653589793, 3.0
74, 14, 562, 252, 564, 253, -2, -1, -2.677945044588987, 2.23606797749979
74, 16, 416, 145, 418, 143, -2, 2, 2.356194490192345, 2.8284271247461903
74, 17, 436, 301, 435, 300, 1, 1, 0.7853981633974483, 1.4142135623730951
74, 18, 497, 152, 499, 152, -2, 0, 3.141592653589793, 2.0
74, 20, 219, 214, 218, 215, 1, -1, -0.7853981633974483, 1.4142135623730951
74, 21, 267, 299, 268, 298, -1, 1, 2.356194490192345, 1.4142135623730951
74, 22, 179, 114, 178, 112, 1, 2, 1.1071487177940904, 2.23606797749979
74, 23, 578, 311, 581, 313, -3, -2, -2.5535900500422257, 3.605551275463989
74, 24, 43, 192, 42, 193, 1, -1, -0.7853981633974483, 1.4142135623730951
74, 25, 482, 157, 484, 159, -2, -2, -2.356194490192345, 2.8284271247461903
74, 26, 597, 333, 598, 335, -1, -2, -2.0344439357957027, 2.23606797749979
74, 27, 456, 160, 457, 158, -1, 2, 2.0344439357957027, 2.23606797749979
74, 28, 143, 335, 141, 335, 2, 0, 0.0, 2.0
74, 29, 585, 208, 587, 209, -2, -1, -2.677945044588987, 2.23606797749979
74, 30, 386, 302, 385, 303, 1, -1, -0.7853981633974483, 1.4142135623730951
74, 31, 552, 122, 555, 120, -3, 2, 2.5535900500422257, 3.605551275463989
74, 32, 85, 277, 86, 275, -1, 2, 2.0344439357957027, 2.23606797749979
74, 33, 532, 224, 534, 224, -2, 0, 3.141592653589793, 2.0
74, 34, 588, 256, 589, 253, -1, 3, 1.892546881191539, 3.1622776601683795
74, 37, 506, 168, 507, 166, -1, 2, 2.0344439357957027, 2.23606797749979
74, 38, 553, 363, 554, 365, -1, -2, -2.0344439357957027, 2.23606797749979
74, 39, 42, 305, 39, 305, 3, 0, 0.0, 3.0
74, 41, 570, 331, 572, 331, -2, 0, 3.141592653589793, 2.0
74, 42, 344, 272, 343, 271, 1, 1, 0.7853981633974483, 1.4142135623730951
74, 43, 85, 218, 86, 217, -1, 1, 2.356194490192345, 1.4142135623730951
74, 44, 298, 208, 296, 209, 2, -1, -0.4636476090008061, 2.23606797749979
74, 47, 594, 270, 596, 271, -2, -1, -2.677945044588987, 2.23606797749979
74, 48, 543, 147, 546, 147, -3, 0, 3.141592653589793, 3.0
74, 50, 128, 300, 125, 302, 3, -2, -0.5880026035475675, 3.605551275463989
74, 51, 120, 337, 119, 338, 1, -1, -0.7853981633974483, 1.4142135623730951
74, 52, 219, 331, 217, 335, 2, -4, -1.1071487177940904, 4.47213595499958
74, 53, 522, 193, 524, 193, -2, 0, 3.141592653589793, 2.0
74, 56, 83, 365, 80, 365, 3, 0, 0.0, 3.0
74, 57, 142, 218, 141, 216, 1, 2, 1.1071487177940904, 2.23606797749979
74, 58, 198, 344, 196, 345, 2, -1, -0.4636476090008061, 2.23606797749979
74, 59, 448, 213, 449, 212, -1, 1, 2.356194490192345, 1.4142135623730951
74, 60, 413, 207, 414, 206, -1, 1, 2.356194490192345, 1.4142135623730951
74, 61, 480, 265, 481, 264, -1, 1, 2.356194490192345, 1.4142135623730951
74, 62, 395, 197, 397, 197, -2, 0, 3.141592653589793, 2.0
74, 63, 236, 298, 235, 299, 1, -1, -0.7853981633974483, 1.4142135623730951
74, 64, 511, 310, 512, 309, -1, 1, 2.356194490192345, 1.4142135623730951
74, 65, 316, 290, 314, 291, 2, -1, -0.4636476090008061, 2.23606797749979
74, 66, 344, 318, 343, 320, 1, -2, -1.1071487177940904, 2.23606797749979
74, 67, 549, 331, 549, 333, 0, -2, -1.5707963267948966, 2.0
74, 71, 116, 362, 115, 364, 1, -2, -1.1071487177940904, 2.23606797749979
74, 73, 165, 270, 164, 271, 1, -1, -0.7853981633974483, 1.4142135623730951
74, 74, 175, 343, 177, 345, -2, -2, -2.356194490192345, 2.8284271247461903
74, 75, 521, 274, 524, 274, -3, 0, 3.141592653589793, 3.0
74, 76, 111, 200, 107, 199, 4, 1, 0.24497866312686414, 4.123105625617661
74, 77, 127, 123, 126, 121, 1, 2, 1.1071487177940904, 2.23606797749979
74, 78, 361, 132, 364, 131, -3, 1, 2.819842099193151, 3.1622776601683795
74, 79, 376, 233, 372, 233, 4, 0, 0.0, 4.0
74, 80, 498, 222, 499, 221, -1, 1, 2.356194490192345, 1.4142135623730951
74, 81, 514, 162, 516, 161, -2, 1, 2.677945044588987, 2.23606797749979
74, 82, 532, 160, 532, 163, 0, -3, -1.5707963267948966, 3.0
74, 83, 474, 205, 474, 201, 0, 4, 1.5707963267948966, 4.0
74, 84, 156, 341, 154, 344, 2, -3, -0.982793723247329, 3.605551275463989
74, 86, 523, 210, 522, 211, 1, -1, -0.7853981633974483, 1.4142135623730951
74, 88, 266, 247, 263, 248, 3, -1, -0.3217505543966422, 3.1622776601683795
74, 90, 504, 146, 503, 147, 1, -1, -0.7853981633974483, 1.4142135623730951
74, 91, 482, 233, 485, 231, -3, 2, 2.5535900500422257, 3.605551275463989
74, 93, 340, 199, 338, 197, 2, 2, 0.7853981633974483, 2.8284271247461903
74, 94, 171, 326, 173, 327, -2, -1, -2.677945044588987, 2.23606797749979
74, 95, 547, 359, 548, 358, -1, 1, 2.356194490192345, 1.4142135623730951
75, 0, 373, 222, 371, 219, 2, 3, 0.982793723247329, 3.605551275463989
75, 1, 299, 235, 295, 233, 4, 2, 0.4636476090008061, 4.47213595499958
75, 6, 430, 110, 430, 113, 0, -3, -1.5707963267948966, 3.0
75, 8, 440, 150, 440, 148, 0, 2, 1.5707963267948966, 2.0
75, 10, 307, 309, 305, 309, 2, 0, 0.0, 2.0
75, 11, 432, 212, 432, 208, 0, 4, 1.5707963267948966, 4.0
75, 13, 508, 292, 507, 293, 1, -1, -0.7853981633974483, 1.4142135623730951
75, 15, 385, 173, 386, 172, -1, 1, 2.356194490192345, 1.4142135623730951
75, 16, 327, 225, 328, 220, -1, 5, 1.7681918866447774, 5.0990195135927845
75, 17, 449, 236, 449, 231, 0, 5, 1.5707963267948966, 5.0
75, 18, 42, 363, 45, 363, -3, 0, 3.141592653589793, 3.0
75, 19, 598, 298, 596, 297, 2, 1, 0.4636476090008061, 2.23606797749979
75, 20, 448, 292, 451, 294, -3, -2, -2.5535900500422257, 3.605551275463989
75, 21, 405, 273, 408, 276, -3, -3, -2.356194490192345, 4.242640687119285
75, 23, 384, 301, 387, 303, -3, -2, -2.5535900500422257, 3.605551275463989
75, 24, 477, 351, 474, 352, 3, -1, -0.3217505543966422, 3.1622776601683795
75, 26, 480, 163, 478, 163, 2, 0, 0.0, 2.0
75, 31, 488, 283, 490, 281, -2, 2, 2.356194490192345, 2.8284271247461903
75, 32, 434, 304, 436, 305, -2, -1, -2.677945044588987, 2.23606797749979
75, 33, 592, 173, 591, 174, 1, -1, -0.7853981633974483, 1.4142135623730951
75, 34, 43, 116, 45, 117, -2, -1, -2.677945044588987, 2.23606797749979
75, 36, 219, 217, 220, 216, -1, 1, 2.356194490192345, 1.4142135623730951
75, 39, 123, 178, 125, 179, -2, -1, -2.677945044588987, 2.23606797749979
75, 40, 297, 212, 298, 214, -1, -2, -2.0344439357957027, 2.23606797749979
75, 42, 436, 260, 438, 262, -2, -2, -2.356194490192345, 2.8284271247461903
75, 44, 357, 227, 359, 229, -2, -2, -2.356194490192345, 2.8284271247461903
75, 46, 221, 112, 223, 114, -2, -2, -2.356194490192345, 2.8284271247461903
75, 47, 86, 202, 89, 203, -3, -1, -2.819842099193151, 3.1622776601683795
75, 48, 202, 332, 201, 331, 1, 1, 0.7853981633974483, 1.4142135623730951
75, 49, 578, 116, 576, 117, 2, -1, -0.4636476090008061, 2.23606797749979
75, 50, 417, 204, 419, 207, -2, -3, -2.158798930342464, 3.605551275463989
75, 51, 315, 234, 318, 235, -3, -1, -2.819842099193151, 3.1622776601683795
75, 52, 572, 151, 571, 152, 1, -1, -0.7853981633974483, 1.4142135623730951
75, 53, 588, 212, 586, 212, 2, 0, 0.0, 2.0
75, 54, 334, 335, 336, 335, -2, 0, 3.141592653589793, 2.0
75, 56, 457, 159, 458, 161, -1, -2, -2.0344439357957027, 2.23606797749979
75, 57, 71, 203, 73, 203, -2, 0, 3.141592653589793, 2.0
75, 58, 353, 112, 355, 114, -2, -2, -2.356194490192345, 2.8284271247461903
75, 59, 602, 170, 599, 172, 3, -2, -0.5880026035475675, 3.605551275463989
75, 60, 539, 162, 538, 163, 1, -1, -0.7853981633974483, 1.4142135623730951
75, 62, 110, 293, 111, 292, -1, 1, 2.356194490192345, 1.4142135623730951
75, 63, 596, 212, 593, 212, 3, 0, 0.0, 3.0
75, 67, 75, 313, 77, 315, -2, -2, -2.356194490192345, 2.8284271247461903
75, 68, 484, 280, 483, 282, 1, -2, -1.1071487177940904, 2.23606797749979
75, 69, 40, 311, 42, 311, -2, 0, 3.141592653589793, 2.0
75, 70, 95, 213, 95, 219, 0, -6, -1.5707963267948966, 6.0
75, 71, 534, 224, 533, 226, 1, -2, -1.1071487177940904, 2.23606797749979
75, 72, 339, 200, 340, 202, -1, -2, -2.0344439357957027, 2.23606797749979
75, 73, 576, 171, 578, 171, -2, 0, 3.141592653589793, 2.0
75, 75, 324, 187, 326, 189, -2, -2, -2.356194490192345, 2.8284271247461903
75, 76, 547, 152, 547, 155, 0, -3, -1.5707963267948966, 3.0
75, 77, 202, 364, 205, 363, -3, 1, 2.819842099193151, 3.1622776601683795
75, 78, 312, 111, 314, 114, -2, -3, -2.158798930342464, 3.605551275463989
75, 79, 303, 133, 305, 135, -2, -2, -2.356194490192345, 2.8284271247461903
75, 80, 346, 153, 348, 154, -2, -1, -2.677945044588987, 2.23606797749979
75, 82, 128, 195, 127, 196, 1, -1, -0.7853981633974483, 1.4142135623730951
75, 83, 113, 366, 115, 366, -2, 0, 3.141592653589793, 2.0
75, 84, 80, 122, 82, 124, -2, -2, -2.356194490192345, 2.8284271247461903
75, 85, 391, 187, 392, 189, -1, -2, -2.0344439357957027, 2.23606797749979
75, 86, 481, 130, 481, 134, 0, -4, -1.5707963267948966, 4.0
75, 87, 80, 370, 82, 370, -2, 0, 3.141592653589793, 2.0
75, 88, 414, 220, 416, 223, -2, -3, -2.158798930342464, 3.605551275463989
75, 89, 559, 162, 560, 166, -1, -4, -1.8157749899217608, 4.123105625617661
75, 90, 562, 137, 564, 137, -2, 0, 3.141592653589793, 2.0
75, 91, 42, 187, 43, 190, -1, -3, -1.892546881191539, 3.1622776601683795
75, 92, 139, 179, 141, 181, -2, -2, -2.356194490192345, 2.8284271247461903
75, 94, 556, 148, 554, 149, 2, -1, -0.4636476090008061, 2.23606797749979
75, 95, 415, 143, 415, 145, 0, -2, -1.5707963267948966, 2.0
75, 96, 92, 351, 96, 352, -4, -1, -2.896613990462929, 4.123105625617661
75, 99, 211, 150, 214, 152, -3, -2, -2.5535900500422257, 3.605551275463989
75, 100, 123, 156, 125, 159, -2, -3, -2.158798930342464, 3.605551275463989
75, 101, 422, 173, 426, 178, -4, -5, -2.2455372690184494, 6.4031242374328485
75, 102, 526, 271, 524, 275, 2, -4, -1.1071487177940904, 4.47213595499958
75, 103, 340, 180, 341, 182, -1, -2, -2.0344439357957027, 2.23606797749979
75, 104, 570, 254, 568, 255, 2, -1, -0.4636476090008061, 2.23606797749979
75, 106, 157, 163, 158, 165, -1, -2, -2.0344439357957027, 2.23606797749979
75, 107, 532, 365, 530, 365, 2, 0, 0.0, 2.0
75, 108, 454, 203, 454, 201, 0, 2, 1.5707963267948966, 2.0
75, 109, 588, 184, 588, 186, 0, -2, -1.5707963267948966, 2.0
75, 111, 561, 349, 563, 351, -2, -2, -2.356194490192345, 2.8284271247461903
75, 112, 41, 177, 45, 178, -4, -1, -2.896613990462929, 4.123105625617661
75, 113, 312, 292, 317, 293, -5, -1, -2.9441970937399127, 5.0990195135927845
75, 115, 398, 296, 404, 299, -6, -3, -2.677945044588987, 6.708203932499369
75, 116, 367, 174, 370, 178, -3, -4, -2.214297435588181, 5.0
75, 117, 137, 199, 138, 202, -1, -3, -1.892546881191539, 3.1622776601683795
75, 118, 277, 281, 281, 283, -4, -2, -2.677945044588987, 4.47213595499958
75, 120, 269, 248, 269, 250, 0, -2, -1.5707963267948966, 2.0
75, 123, 96, 180, 98, 180, -2, 0, 3.141592653589793, 2.0
75, 124, 484, 227, 484, 232, 0, -5, -1.5707963267948966, 5.0
75, 125, 288, 299, 290, 300, -2, -1, -2.677945044588987, 2.23606797749979
75, 129, 430, 331, 432, 332, -2, -1, -2.677945044588987, 2.23606797749979
75, 131, 68, 355, 70, 355, -2, 0, 3.141592653589793, 2.0
75, 132, 150, 215, 154, 219, -4, -4, -2.356194490192345, 5.656854249492381
75, 133, 233, 258, 236, 258, -3, 0, 3.141592653589793, 3.0
75, 134, 479, 264, 479, 267, 0, -3, -1.5707963267948966, 3.0
75, 135, 599, 243, 598, 245, 1, -2, -1.1071487177940904, 2.23606797749979
75, 138, 480, 177, 481, 176, -1, 1, 2.356194490192345, 1.4142135623730951
75, 139, 403, 138, 405, 142, -2, -4, -2.0344439357957027, 4.47213595499958
75, 140, 86, 330, 91, 331, -5, -1, -2.9441970937399127, 5.0990195135927845
75, 141, 59, 366, 62, 366, -3, 0, 3.141592653589793, 3.0
75, 142, 159, 286, 164, 288, -5, -2, -2.761086276477428, 5.385164807134504
75, 144, 398, 235, 403, 240, -5, -5, -2.356194490192345, 7.0710678118654755
75, 146, 449, 213, 450, 216, -1, -3, -1.892546881191539, 3.1622776601683795
75, 148, 345, 321, 347, 324, -2, -3, -2.158798930342464, 3.605551275463989
76, 0, 371, 222, 373, 222, -2, 0, 3.141592653589793, 2.0
76, 1, 297, 236, 299, 235, -2, 1, 2.677945044588987, 2.23606797749979
76, 2, 377, 281, 379, 282, -2, -1, -2.677945044588987, 2.23606797749979
76, 3, 290, 145, 292, 146, -2, -1, -2.677945044588987, 2.23606797749979
76, 5, 379, 318, 381, 318, -2, 0, 3.141592653589793, 2.0
76, 7, 272, 147, 274, 147, -2, 0, 3.141592653589793, 2.0
76, 8, 431, 210, 432, 212, -1, -2, -2.0344439357957027, 2.23606797749979
76, 12, 328, 224, 327, 225, 1, -1, -0.7853981633974483, 1.4142135623730951
76, 14, 446, 291, 448, 292, -2, -1, -2.677945044588987, 2.23606797749979
76, 15, 500, 153, 499, 154, 1, -1, -0.7853981633974483, 1.4142135623730951
76, 16, 475, 350, 477, 351, -2, -1, -2.677945044588987, 2.23606797749979
76, 17, 420, 344, 421, 343, -1, 1, 2.356194490192345, 1.4142135623730951
76, 18, 332, 240, 334, 241, -2, -1, -2.677945044588987, 2.23606797749979
76, 19, 488, 281, 488, 283, 0, -2, -1.5707963267948966, 2.0
76, 20, 420, 144, 422, 145, -2, -1, -2.677945044588987, 2.23606797749979
76, 24, 295, 212, 297, 212, -2, 0, 3.141592653589793, 2.0
76, 25, 561, 253, 562, 255, -1, -2, -2.0344439357957027, 2.23606797749979
76, 26, 435, 258, 436, 260, -1, -2, -2.0344439357957027, 2.23606797749979
76, 29, 532, 254, 533, 256, -1, -2, -2.0344439357957027, 2.23606797749979
76, 30, 219, 112, 221, 112, -2, 0, 3.141592653589793, 2.0
76, 32, 332, 334, 334, 335, -2, -1, -2.677945044588987, 2.23606797749979
76, 34, 69, 203, 71, 203, -2, 0, 3.141592653589793, 2.0
76, 37, 596, 210, 596, 212, 0, -2, -1.5707963267948966, 2.0
76, 40, 182, 112, 184, 112, -2, 0, 3.141592653589793, 2.0
76, 41, 76, 312, 75, 313, 1, -1, -0.7853981633974483, 1.4142135623730951
76, 43, 39, 312, 40, 311, -1, 1, 2.356194490192345, 1.4142135623730951
76, 44, 96, 214, 95, 213, 1, 1, 0.7853981633974483, 1.4142135623730951
76, 47, 322, 187, 324, 187, -2, 0, 3.141592653589793, 2.0
76, 48, 199, 364, 202, 364, -3, 0, 3.141592653589793, 3.0
76, 49, 301, 132, 303, 133, -2, -1, -2.677945044588987, 2.23606797749979
76, 53, 481, 128, 481, 130, 0, -2, -1.5707963267948966, 2.0
76, 56, 561, 135, 562, 137, -1, -2, -2.0344439357957027, 2.23606797749979
76, 57, 40, 187, 42, 187, -2, 0, 3.141592653589793, 2.0
76, 60, 415, 141, 415, 143, 0, -2, -1.5707963267948966, 2.0
76, 61, 90, 351, 92, 351, -2, 0, 3.141592653589793, 2.0
76, 62, 471, 203, 473, 204, -2, -1, -2.677945044588987, 2.23606797749979
76, 63, 499, 218, 500, 220, -1, -2, -2.0344439357957027, 2.23606797749979
76, 64, 209, 151, 211, 150, -2, 1, 2.677945044588987, 2.23606797749979
76, 66, 421, 171, 422, 173, -1, -2, -2.0344439357957027, 2.23606797749979
76, 67, 527, 270, 526, 271, 1, -1, -0.7853981633974483, 1.4142135623730951
76, 72, 453, 201, 454, 203, -1, -2, -2.0344439357957027, 2.23606797749979
76, 75, 310, 291, 312, 292, -2, -1, -2.677945044588987, 2.23606797749979
76, 77, 396, 294, 398, 296, -2, -2, -2.356194490192345, 2.8284271247461903
76, 78, 366, 172, 367, 174, -1, -2, -2.0344439357957027, 2.23606797749979
76, 80, 275, 279, 277, 281, -2, -2, -2.356194490192345, 2.8284271247461903
76, 84, 93, 179, 96, 180, -3, -1, -2.819842099193151, 3.1622776601683795
76, 85, 484, 225, 484, 227, 0, -2, -1.5707963267948966, 2.0
76, 86, 285, 299, 288, 299, -3, 0, 3.141592653589793, 3.0
76, 87, 338, 253, 339, 255, -1, -2, -2.0344439357957027, 2.23606797749979
76, 89, 427, 332, 430, 331, -3, 1, 2.819842099193151, 3.1622776601683795
76, 90, 231, 258, 233, 258, -2, 0, 3.141592653589793, 2.0
76, 95, 402, 136, 403, 138, -1, -2, -2.0344439357957027, 2.23606797749979
76, 96, 83, 329, 86, 330, -3, -1, -2.819842099193151, 3.1622776601683795
76, 97, 57, 366, 59, 366, -2, 0, 3.141592653589793, 2.0
76, 98, 157, 285, 159, 286, -2, -1, -2.677945044588987, 2.23606797749979
76, 99, 39, 333, 41, 334, -2, -1, -2.677945044588987, 2.23606797749979
76, 100, 394, 231, 398, 235, -4, -4, -2.356194490192345, 5.656854249492381
76, 102, 448, 211, 449, 213, -1, -2, -2.0344439357957027, 2.23606797749979
77, 0, 288, 144, 290, 145, -2, -1, -2.677945044588987, 2.23606797749979
77, 1, 377, 318, 379, 318, -2, 0, 3.141592653589793, 2.0
77, 2, 439, 147, 440, 149, -1, -2, -2.0344439357957027, 2.23606797749979
77, 3, 270, 146, 272, 147, -2, -1, -2.677945044588987, 2.23606797749979
77, 4, 229, 157, 231, 157, -2, 0, 3.141592653589793, 2.0
77, 5, 508, 290, 508, 292, 0, -2, -1.5707963267948966, 2.0
77, 6, 326, 223, 328, 224, -2, -1, -2.677945044588987, 2.23606797749979
77, 10, 597, 335, 596, 336, 1, -1, -0.7853981633974483, 1.4142135623730951
77, 11, 412, 363, 414, 363, -2, 0, 3.141592653589793, 2.0
77, 26, 94, 213, 96, 214, -2, -1, -2.677945044588987, 2.23606797749979
77, 27, 534, 221, 534, 223, 0, -2, -1.5707963267948966, 2.0
77, 29, 197, 364, 199, 364, -2, 0, 3.141592653589793, 2.0
77, 30, 384, 348, 386, 348, -2, 0, 3.141592653589793, 2.0
77, 31, 78, 120, 80, 121, -2, -1, -2.677945044588987, 2.23606797749979
77, 36, 38, 186, 40, 187, -2, -1, -2.677945044588987, 2.23606797749979
77, 37, 137, 178, 139, 179, -2, -1, -2.677945044588987, 2.23606797749979
77, 41, 120, 155, 122, 156, -2, -1, -2.677945044588987, 2.23606797749979
77, 43, 337, 179, 339, 180, -2, -1, -2.677945044588987, 2.23606797749979
77, 48, 308, 290, 310, 291, -2, -1, -2.677945044588987, 2.23606797749979
77, 50, 365, 170, 366, 172, -1, -2, -2.0344439357957027, 2.23606797749979
77, 52, 273, 279, 275, 279, -2, 0, 3.141592653589793, 2.0
77, 53, 113, 156, 115, 157, -2, -1, -2.677945044588987, 2.23606797749979
77, 54, 493, 192, 493, 194, 0, -2, -1.5707963267948966, 2.0
77, 55, 229, 257, 231, 258, -2, -1, -2.677945044588987, 2.23606797749979
78, 0, 286, 143, 288, 144, -2, -1, -2.677945044588987, 2.23606797749979
78, 1, 375, 317, 377, 318, -2, -1, -2.677945044588987, 2.23606797749979
78, 2, 438, 145, 439, 147, -1, -2, -2.0344439357957027, 2.23606797749979
78, 3, 268, 145, 270, 146, -2, -1, -2.677945044588987, 2.23606797749979
78, 4, 227, 155, 229, 157, -2, -2, -2.356194490192345, 2.8284271247461903
78, 5, 508, 288, 508, 290, 0, -2, -1.5707963267948966, 2.0
78, 6, 599, 294, 598, 296, 1, -2, -1.1071487177940904, 2.23606797749979
78, 7, 474, 352, 475, 351, -1, 1, 2.356194490192345, 1.4142135623730951
78, 8, 417, 344, 419, 344, -2, 0, 3.141592653589793, 2.0
78, 9, 598, 334, 597, 335, 1, -1, -0.7853981633974483, 1.4142135623730951
78, 10, 410, 363, 412, 363, -2, 0, 3.141592653589793, 2.0
78, 12, 433, 256, 434, 258, -1, -2, -2.0344439357957027, 2.23606797749979
78, 14, 532, 251, 532, 253, 0, -2, -1.5707963267948966, 2.0
78, 15, 572, 149, 572, 151, 0, -2, -1.5707963267948966, 2.0
78, 16, 329, 333, 331, 334, -2, -1, -2.677945044588987, 2.23606797749979
78, 18, 107, 291, 109, 292, -2, -1, -2.677945044588987, 2.23606797749979
78, 22, 73, 312, 75, 312, -2, 0, 3.141592653589793, 2.0
78, 23, 483, 276, 484, 278, -1, -2, -2.0344439357957027, 2.23606797749979
78, 24, 36, 312, 38, 312, -2, 0, 3.141592653589793, 2.0
78, 25, 92, 212, 94, 213, -2, -1, -2.677945044588987, 2.23606797749979
78, 26, 535, 220, 534, 221, 1, -1, -0.7853981633974483, 1.4142135623730951
78, 27, 255, 312, 257, 313, -2, -1, -2.677945044588987, 2.23606797749979
78, 28, 195, 364, 197, 364, -2, 0, 3.141592653589793, 2.0
78, 29, 382, 348, 384, 348, -2, 0, 3.141592653589793, 2.0
78, 31, 481, 125, 481, 127, 0, -2, -1.5707963267948966, 2.0
78, 32, 76, 370, 78, 370, -2, 0, 3.141592653589793, 2.0
78, 34, 561, 132, 561, 134, 0, -2, -1.5707963267948966, 2.0
78, 35, 87, 350, 89, 351, -2, -1, -2.677945044588987, 2.23606797749979
78, 37, 119, 156, 120, 155, -1, 1, 2.356194490192345, 1.4142135623730951
78, 39, 571, 250, 570, 252, 1, -2, -1.1071487177940904, 2.23606797749979
78, 42, 569, 205, 568, 206, 1, -1, -0.7853981633974483, 1.4142135623730951
78, 43, 306, 289, 308, 290, -2, -1, -2.677945044588987, 2.23606797749979
78, 44, 246, 281, 248, 282, -2, -1, -2.677945044588987, 2.23606797749979
78, 45, 133, 198, 135, 199, -2, -1, -2.677945044588987, 2.23606797749979
78, 46, 110, 155, 113, 156, -3, -1, -2.819842099193151, 3.1622776601683795
78, 47, 492, 190, 493, 192, -1, -2, -2.0344439357957027, 2.23606797749979
78, 48, 226, 257, 229, 257, -3, 0, 3.141592653589793, 3.0
78, 51, 479, 173, 480, 175, -1, -2, -2.0344439357957027, 2.23606797749979
78, 52, 341, 320, 343, 321, -2, -1, -2.677945044588987, 2.23606797749979
79, 0, 284, 142, 286, 143, -2, -1, -2.677945044588987, 2.23606797749979
79, 1, 374, 318, 375, 317, -1, 1, 2.356194490192345, 1.4142135623730951
79, 2, 265, 143, 268, 145, -3, -2, -2.5535900500422257, 3.605551275463989
79, 3, 508, 286, 508, 288, 0, -2, -1.5707963267948966, 2.0
79, 6, 415, 345, 417, 344, -2, 1, 2.677945044588987, 2.23606797749979
79, 7, 600, 334, 598, 334, 2, 0, 0.0, 2.0
79, 8, 408, 365, 410, 363, -2, 2, 2.356194490192345, 2.8284271247461903
79, 9, 562, 249, 561, 251, 1, -2, -1.1071487177940904, 2.23606797749979
79, 10, 433, 254, 433, 256, 0, -2, -1.5707963267948966, 2.0
79, 11, 498, 362, 497, 361, 1, 1, 0.7853981633974483, 1.4142135623730951
79, 15, 539, 158, 539, 160, 0, -2, -1.5707963267948966, 2.0
79, 16, 105, 290, 107, 291, -2, -1, -2.677945044588987, 2.23606797749979
79, 17, 597, 206, 596, 208, 1, -2, -1.1071487177940904, 2.23606797749979
79, 20, 70, 313, 73, 312, -3, 1, 2.819842099193151, 3.1622776601683795
79, 22, 90, 213, 92, 212, -2, 1, 2.677945044588987, 2.23606797749979
79, 24, 253, 312, 255, 312, -2, 0, 3.141592653589793, 2.0
79, 26, 380, 348, 382, 348, -2, 0, 3.141592653589793, 2.0
79, 27, 74, 118, 77, 120, -3, -2, -2.5535900500422257, 3.605551275463989
79, 28, 480, 123, 481, 125, -1, -2, -2.0344439357957027, 2.23606797749979
79, 32, 116, 154, 119, 156, -3, -2, -2.5535900500422257, 3.605551275463989
79, 34, 571, 248, 571, 250, 0, -2, -1.5707963267948966, 2.0
79, 37, 570, 203, 569, 205, 1, -2, -1.1071487177940904, 2.23606797749979
79, 38, 303, 286, 306, 289, -3, -3, -2.356194490192345, 4.242640687119285
79, 39, 244, 280, 246, 281, -2, -1, -2.677945044588987, 2.23606797749979
79, 40, 131, 197, 133, 198, -2, -1, -2.677945044588987, 2.23606797749979
79, 41, 107, 154, 110, 155, -3, -1, -2.819842099193151, 3.1622776601683795
79, 42, 492, 188, 492, 190, 0, -2, -1.5707963267948966, 2.0
79, 44, 479, 259, 479, 261, 0, -2, -1.5707963267948966, 2.0
79, 46, 479, 171, 479, 173, 0, -2, -1.5707963267948966, 2.0
80, 0, 37, 363, 41, 363, -4, 0, 3.141592653589793, 4.0
80, 1, 38, 114, 40, 115, -2, -1, -2.677945044588987, 2.23606797749979
80, 3, 586, 110, 586, 112, 0, -2, -1.5707963267948966, 2.0
80, 4, 601, 295, 599, 297, 2, -2, -0.7853981633974483, 2.8284271247461903
80, 5, 38, 235, 41, 237, -3, -2, -2.5535900500422257, 3.605551275463989
80, 6, 431, 301, 434, 303, -3, -2, -2.5535900500422257, 3.605551275463989
80, 7, 64, 358, 67, 358, -3, 0, 3.141592653589793, 3.0
80, 8, 468, 356, 469, 355, -1, 1, 2.356194490192345, 1.4142135623730951
80, 9, 301, 307, 303, 308, -2, -1, -2.677945044588987, 2.23606797749979
80, 10, 54, 365, 56, 365, -2, 0, 3.141592653589793, 2.0
80, 13, 227, 154, 230, 157, -3, -3, -2.356194490192345, 4.242640687119285
80, 14, 118, 175, 121, 177, -3, -2, -2.5535900500422257, 3.605551275463989
80, 15, 499, 364, 498, 362, 1, 2, 1.1071487177940904, 2.23606797749979
80, 16, 375, 317, 378, 318, -3, -1, -2.819842099193151, 3.1622776601683795
80, 17, 370, 285, 373, 285, -3, 0, 3.141592653589793, 3.0
80, 18, 577, 149, 576, 151, 1, -2, -1.1071487177940904, 2.23606797749979
80, 19, 411, 367, 413, 366, -2, 1, 2.677945044588987, 2.23606797749979
80, 21, 417, 140, 418, 142, -1, -2, -2.0344439357957027, 2.23606797749979
80, 22, 487, 273, 487, 276, 0, -3, -1.5707963267948966, 3.0
80, 24, 323, 220, 325, 220, -2, 0, 3.141592653589793, 2.0
80, 25, 535, 365, 533, 365, 2, 0, 0.0, 2.0
80, 26, 326, 237, 329, 239, -3, -2, -2.5535900500422257, 3.605551275463989
80, 27, 372, 365, 374, 365, -2, 0, 3.141592653589793, 2.0
80, 29, 74, 118, 77, 120, -3, -2, -2.5535900500422257, 3.605551275463989
80, 30, 38, 204, 40, 205, -2, -1, -2.677945044588987, 2.23606797749979
80, 31, 385, 168, 386, 170, -1, -2, -2.0344439357957027, 2.23606797749979
80, 32, 479, 155, 480, 157, -1, -2, -2.0344439357957027, 2.23606797749979
80, 33, 269, 144, 271, 144, -2, 0, 3.141592653589793, 2.0
80, 34, 218, 109, 220, 111, -2, -2, -2.356194490192345, 2.8284271247461903
80, 35, 388, 282, 391, 282, -3, 0, 3.141592653589793, 3.0
80, 36, 266, 298, 268, 298, -2, 0, 3.141592653589793, 2.0
80, 37, 36, 173, 39, 174, -3, -1, -2.819842099193151, 3.1622776601683795
80, 39, 310, 105, 312, 107, -2, -2, -2.356194490192345, 2.8284271247461903
80, 40, 446, 311, 449, 311, -3, 0, 3.141592653589793, 3.0
80, 42, 214, 215, 216, 216, -2, -1, -2.677945044588987, 2.23606797749979
80, 43, 111, 271, 113, 272, -2, -1, -2.677945044588987, 2.23606797749979
80, 44, 597, 165, 596, 167, 1, -2, -1.1071487177940904, 2.23606797749979
80, 46, 501, 148, 500, 152, 1, -4, -1.3258176636680326, 4.123105625617661
80, 47, 438, 143, 439, 146, -1, -3, -1.892546881191539, 3.1622776601683795
80, 48, 348, 105, 351, 107, -3, -2, -2.5535900500422257, 3.605551275463989
80, 49, 432, 104, 433, 106, -1, -2, -2.0344439357957027, 2.23606797749979
80, 50, 288, 140, 289, 142, -1, -2, -2.0344439357957027, 2.23606797749979
80, 51, 554, 116, 554, 118, 0, -2, -1.5707963267948966, 2.0
80, 52, 515, 290, 514, 292, 1, -2, -1.1071487177940904, 2.23606797749979
80, 53, 454, 104, 455, 106, -1, -2, -2.0344439357957027, 2.23606797749979
80, 54, 605, 336, 602, 336, 3, 0, 0.0, 3.0
80, 55, 256, 283, 258, 283, -2, 0, 3.141592653589793, 2.0
80, 56, 592, 182, 591, 183, 1, -1, -0.7853981633974483, 1.4142135623730951
80, 57, 109, 366, 111, 366, -2, 0, 3.141592653589793, 2.0
80, 58, 176, 109, 178, 111, -2, -2, -2.356194490192345, 2.8284271247461903
80, 59, 414, 348, 417, 347, -3, 1, 2.819842099193151, 3.1622776601683795
80, 60, 339, 269, 341, 270, -2, -1, -2.677945044588987, 2.23606797749979
80, 61, 424, 108, 426, 110, -2, -2, -2.356194490192345, 2.8284271247461903
80, 62, 569, 250, 568, 252, 1, -2, -1.1071487177940904, 2.23606797749979
80, 63, 35, 284, 38, 285, -3, -1, -2.819842099193151, 3.1622776601683795
80, 64, 74, 366, 76, 366, -2, 0, 3.141592653589793, 2.0
80, 66, 502, 169, 502, 171, 0, -2, -1.5707963267948966, 2.0
80, 67, 73, 314, 76, 315, -3, -1, -2.819842099193151, 3.1622776601683795
80, 69, 556, 144, 556, 146, 0, -2, -1.5707963267948966, 2.0
80, 70, 478, 367, 479, 366, -1, 1, 2.356194490192345, 1.4142135623730951
80, 71, 111, 316, 113, 316, -2, 0, 3.141592653589793, 2.0
80, 72, 34, 308, 36, 309, -2, -1, -2.677945044588987, 2.23606797749979
80, 73, 606, 316, 604, 316, 2, 0, 0.0, 2.0
80, 74, 133, 200, 134, 202, -1, -2, -2.0344439357957027, 2.23606797749979
80, 75, 109, 111, 111, 112, -2, -1, -2.677945044588987, 2.23606797749979
80, 76, 470, 199, 471, 201, -1, -2, -2.0344439357957027, 2.23606797749979
80, 78, 354, 226, 356, 227, -2, -1, -2.677945044588987, 2.23606797749979
80, 79, 140, 216, 142, 217, -2, -1, -2.677945044588987, 2.23606797749979
80, 80, 70, 231, 72, 232, -2, -1, -2.677945044588987, 2.23606797749979
80, 81, 198, 366, 201, 366, -3, 0, 3.141592653589793, 3.0
80, 82, 37, 330, 40, 331, -3, -1, -2.819842099193151, 3.1622776601683795
80, 83, 591, 209, 590, 210, 1, -1, -0.7853981633974483, 1.4142135623730951
80, 84, 563, 159, 563, 162, 0, -3, -1.5707963267948966, 3.0
80, 85, 603, 269, 601, 270, 2, -1, -0.4636476090008061, 2.23606797749979
80, 86, 207, 269, 209, 270, -2, -1, -2.677945044588987, 2.23606797749979
80, 87, 559, 368, 557, 367, 2, 1, 0.4636476090008061, 2.23606797749979
80, 89, 538, 251, 538, 253, 0, -2, -1.5707963267948966, 2.0
80, 90, 334, 198, 336, 198, -2, 0, 3.141592653589793, 2.0
80, 92, 110, 153, 112, 154, -2, -1, -2.677945044588987, 2.23606797749979
80, 94, 52, 249, 54, 250, -2, -1, -2.677945044588987, 2.23606797749979
80, 95, 53, 222, 56, 223, -3, -1, -2.819842099193151, 3.1622776601683795
80, 97, 86, 219, 88, 220, -2, -1, -2.677945044588987, 2.23606797749979
80, 98, 595, 333, 593, 333, 2, 0, 0.0, 2.0
80, 99, 538, 221, 537, 223, 1, -2, -1.1071487177940904, 2.23606797749979
80, 100, 335, 178, 337, 180, -2, -2, -2.356194490192345, 2.8284271247461903
80, 101, 446, 210, 447, 212, -1, -2, -2.0344439357957027, 2.23606797749979
80, 102, 51, 344, 53, 344, -2, 0, 3.141592653589793, 2.0
80, 103, 310, 290, 312, 291, -2, -1, -2.677945044588987, 2.23606797749979
80, 104, 57, 330, 60, 330, -3, 0, 3.141592653589793, 3.0
80, 105, 517, 307, 515, 309, 2, -2, -0.7853981633974483, 2.8284271247461903
80, 106, 330, 357, 332, 357, -2, 0, 3.141592653589793, 2.0
80, 107, 82, 142, 84, 143, -2, -1, -2.677945044588987, 2.23606797749979
80, 108, 484, 225, 484, 227, 0, -2, -1.5707963267948966, 2.0
80, 110, 329, 336, 331, 336, -2, 0, 3.141592653589793, 2.0
80, 111, 41, 306, 43, 307, -2, -1, -2.677945044588987, 2.23606797749979
80, 112, 312, 232, 314, 234, -2, -2, -2.356194490192345, 2.8284271247461903
80, 113, 94, 122, 97, 124, -3, -2, -2.5535900500422257, 3.605551275463989
80, 114, 105, 197, 105, 199, 0, -2, -1.5707963267948966, 2.0
80, 115, 332, 163, 334, 164, -2, -1, -2.677945044588987, 2.23606797749979
80, 116, 163, 254, 166, 255, -3, -1, -2.819842099193151, 3.1622776601683795
80, 117, 69, 297, 71, 298, -2, -1, -2.677945044588987, 2.23606797749979
80, 118, 525, 347, 523, 348, 2, -1, -0.4636476090008061, 2.23606797749979
80, 119, 277, 242, 279, 244, -2, -2, -2.356194490192345, 2.8284271247461903
80, 120, 72, 342, 75, 342, -3, 0, 3.141592653589793, 3.0
80, 121, 383, 351, 385, 350, -2, 1, 2.677945044588987, 2.23606797749979
80, 122, 92, 158, 94, 160, -2, -2, -2.356194490192345, 2.8284271247461903
80, 124, 474, 109, 475, 111, -1, -2, -2.0344439357957027, 2.23606797749979
80, 126, 34, 220, 37, 221, -3, -1, -2.819842099193151, 3.1622776601683795
80, 127, 292, 210, 294, 211, -2, -1, -2.677945044588987, 2.23606797749979
80, 128, 49, 194, 51, 192, -2, 2, 2.356194490192345, 2.8284271247461903
80, 129, 239, 259, 242, 259, -3, 0, 3.141592653589793, 3.0
80, 130, 85, 275, 86, 274, -1, 1, 2.356194490192345, 1.4142135623730951
80, 131, 544, 271, 543, 272, 1, -1, -0.7853981633974483, 1.4142135623730951
80, 132, 311, 364, 314, 363, -3, 1, 2.819842099193151, 3.1622776601683795
80, 133, 404, 110, 406, 111, -2, -1, -2.677945044588987, 2.23606797749979
80, 134, 73, 274, 73, 276, 0, -2, -1.5707963267948966, 2.0
81, 0, 32, 363, 37, 363, -5, 0, 3.141592653589793, 5.0
81, 1, 36, 113, 38, 114, -2, -1, -2.677945044588987, 2.23606797749979
81, 2, 369, 214, 370, 216, -1, -2, -2.0344439357957027, 2.23606797749979
81, 3, 586, 108, 586, 110, 0, -2, -1.5707963267948966, 2.0
81, 4, 603, 294, 601, 295, 2, -1, -0.4636476090008061, 2.23606797749979
81, 5, 34, 234, 38, 235, -4, -1, -2.896613990462929, 4.123105625617661
81, 6, 428, 299, 431, 301, -3, -2, -2.5535900500422257, 3.605551275463989
81, 7, 61, 358, 64, 358, -3, 0, 3.141592653589793, 3.0
81, 8, 467, 358, 468, 356, -1, 2, 2.0344439357957027, 2.23606797749979
81, 9, 298, 306, 301, 307, -3, -1, -2.819842099193151, 3.1622776601683795
81, 10, 51, 364, 54, 365, -3, -1, -2.819842099193151, 3.1622776601683795
81, 11, 132, 178, 135, 180, -3, -2, -2.5535900500422257, 3.605551275463989
81, 12, 253, 108, 256, 110, -3, -2, -2.5535900500422257, 3.605551275463989
81, 13, 224, 152, 227, 154, -3, -2, -2.5535900500422257, 3.605551275463989
81, 14, 115, 173, 118, 175, -3, -2, -2.5535900500422257, 3.605551275463989
81, 15, 500, 366, 499, 364, 1, 2, 1.1071487177940904, 2.23606797749979
81, 16, 371, 316, 375, 317, -4, -1, -2.896613990462929, 4.123105625617661
81, 17, 368, 284, 370, 285, -2, -1, -2.677945044588987, 2.23606797749979
81, 18, 579, 147, 577, 149, 2, -2, -0.7853981633974483, 2.8284271247461903
81, 19, 409, 367, 411, 367, -2, 0, 3.141592653589793, 2.0
81, 20, 545, 159, 544, 161, 1, -2, -1.1071487177940904, 2.23606797749979
81, 21, 416, 138, 417, 140, -1, -2, -2.0344439357957027, 2.23606797749979
81, 22, 487, 270, 487, 273, 0, -3, -1.5707963267948966, 3.0
81, 23, 599, 207, 598, 209, 1, -2, -1.1071487177940904, 2.23606797749979
81, 24, 321, 218, 323, 220, -2, -2, -2.356194490192345, 2.8284271247461903
81, 25, 537, 366, 535, 365, 2, 1, 0.4636476090008061, 2.23606797749979
81, 26, 323, 235, 326, 237, -3, -2, -2.5535900500422257, 3.605551275463989
81, 27, 369, 365, 372, 365, -3, 0, 3.141592653589793, 3.0
81, 28, 605, 363, 602, 362, 3, 1, 0.3217505543966422, 3.1622776601683795
81, 29, 70, 116, 74, 118, -4, -2, -2.677945044588987, 4.47213595499958
81, 30, 35, 202, 38, 204, -3, -2, -2.5535900500422257, 3.605551275463989
81, 31, 383, 165, 385, 168, -2, -3, -2.158798930342464, 3.605551275463989
81, 32, 479, 152, 479, 155, 0, -3, -1.5707963267948966, 3.0
81, 33, 267, 142, 269, 144, -2, -2, -2.356194490192345, 2.8284271247461903
81, 34, 216, 107, 218, 109, -2, -2, -2.356194490192345, 2.8284271247461903
81, 35, 264, 297, 266, 298, -2, -1, -2.677945044588987, 2.23606797749979
81, 36, 33, 172, 36, 173, -3, -1, -2.819842099193151, 3.1622776601683795
81, 37, 586, 315, 584, 316, 2, -1, -0.4636476090008061, 2.23606797749979
81, 38, 307, 104, 310, 105, -3, -1, -2.819842099193151, 3.1622776601683795
81, 39, 444, 309, 446, 311, -2, -2, -2.356194490192345, 2.8284271247461903
81, 40, 433, 202, 434, 205, -1, -3, -1.892546881191539, 3.1622776601683795
81, 41, 212, 214, 214, 215, -2, -1, -2.677945044588987, 2.23606797749979
81, 42, 108, 270, 111, 271, -3, -1, -2.819842099193151, 3.1622776601683795
81, 43, 597, 163, 597, 165, 0, -2, -1.5707963267948966, 2.0
81, 44, 592, 250, 591, 251, 1, -1, -0.7853981633974483, 1.4142135623730951
81, 45, 501, 146, 501, 148, 0, -2, -1.5707963267948966, 2.0
81, 46, 437, 140, 438, 143, -1, -3, -1.892546881191539, 3.1622776601683795
81, 47, 346, 105, 348, 105, -2, 0, 3.141592653589793, 2.0
81, 48, 286, 138, 288, 140, -2, -2, -2.356194490192345, 2.8284271247461903
81, 49, 555, 113, 554, 116, 1, -3, -1.2490457723982544, 3.1622776601683795
81, 50, 516, 288, 515, 290, 1, -2, -1.1071487177940904, 2.23606797749979
81, 52, 253, 282, 256, 283, -3, -1, -2.819842099193151, 3.1622776601683795
81, 53, 592, 180, 592, 182, 0, -2, -1.5707963267948966, 2.0
81, 54, 106, 366, 109, 366, -3, 0, 3.141592653589793, 3.0
81, 55, 173, 107, 176, 109, -3, -2, -2.5535900500422257, 3.605551275463989
81, 56, 412, 348, 414, 348, -2, 0, 3.141592653589793, 2.0
81, 57, 336, 268, 339, 269, -3, -1, -2.819842099193151, 3.1622776601683795
81, 59, 570, 249, 569, 250, 1, -1, -0.7853981633974483, 1.4142135623730951
81, 61, 71, 366, 74, 366, -3, 0, 3.141592653589793, 3.0
81, 62, 538, 159, 537, 161, 1, -2, -1.1071487177940904, 2.23606797749979
81, 63, 501, 167, 502, 169, -1, -2, -2.0344439357957027, 2.23606797749979
81, 64, 71, 313, 73, 314, -2, -1, -2.677945044588987, 2.23606797749979
81, 65, 122, 303, 124, 303, -2, 0, 3.141592653589793, 2.0
81, 66, 557, 142, 556, 144, 1, -2, -1.1071487177940904, 2.23606797749979
81, 67, 477, 368, 478, 367, -1, 1, 2.356194490192345, 1.4142135623730951
81, 68, 108, 315, 111, 316, -3, -1, -2.819842099193151, 3.1622776601683795
81, 69, 31, 308, 34, 308, -3, 0, 3.141592653589793, 3.0
81, 70, 607, 315, 606, 316, 1, -1, -0.7853981633974483, 1.4142135623730951
81, 71, 131, 199, 133, 200, -2, -1, -2.677945044588987, 2.23606797749979
81, 72, 106, 109, 109, 111, -3, -2, -2.5535900500422257, 3.605551275463989
81, 73, 469, 196, 470, 199, -1, -3, -1.892546881191539, 3.1622776601683795
81, 74, 190, 349, 192, 349, -2, 0, 3.141592653589793, 2.0
81, 75, 137, 215, 140, 216, -3, -1, -2.819842099193151, 3.1622776601683795
81, 76, 66, 230, 70, 231, -4, -1, -2.896613990462929, 4.123105625617661
81, 77, 195, 366, 198, 366, -3, 0, 3.141592653589793, 3.0
81, 79, 592, 207, 591, 209, 1, -2, -1.1071487177940904, 2.23606797749979
81, 80, 564, 156, 563, 159, 1, -3, -1.2490457723982544, 3.1622776601683795
81, 81, 605, 267, 603, 269, 2, -2, -0.7853981633974483, 2.8284271247461903
81, 82, 205, 268, 207, 269, -2, -1, -2.677945044588987, 2.23606797749979
81, 83, 561, 368, 559, 368, 2, 0, 0.0, 2.0
81, 84, 580, 332, 578, 332, 2, 0, 0.0, 2.0
81, 85, 540, 249, 538, 251, 2, -2, -0.7853981633974483, 2.8284271247461903
81, 86, 332, 197, 334, 198, -2, -1, -2.677945044588987, 2.23606797749979
81, 87, 142, 204, 144, 205, -2, -1, -2.677945044588987, 2.23606797749979
81, 88, 107, 152, 110, 153, -3, -1, -2.819842099193151, 3.1622776601683795
81, 89, 477, 258, 478, 261, -1, -3, -1.892546881191539, 3.1622776601683795
81, 90, 49, 247, 52, 249, -3, -2, -2.5535900500422257, 3.605551275463989
81, 91, 50, 221, 53, 222, -3, -1, -2.819842099193151, 3.1622776601683795
81, 92, 604, 239, 603, 241, 1, -2, -1.1071487177940904, 2.23606797749979
81, 93, 84, 219, 86, 219, -2, 0, 3.141592653589793, 2.0
81, 95, 538, 219, 538, 221, 0, -2, -1.5707963267948966, 2.0
81, 96, 333, 177, 335, 178, -2, -1, -2.677945044588987, 2.23606797749979
81, 97, 445, 208, 446, 210, -1, -2, -2.0344439357957027, 2.23606797749979
81, 98, 48, 344, 51, 344, -3, 0, 3.141592653589793, 3.0
81, 99, 307, 289, 310, 290, -3, -1, -2.819842099193151, 3.1622776601683795
81, 100, 54, 330, 57, 330, -3, 0, 3.141592653589793, 3.0
81, 101, 519, 305, 517, 307, 2, -2, -0.7853981633974483, 2.8284271247461903
81, 102, 328, 357, 330, 357, -2, 0, 3.141592653589793, 2.0
81, 103, 80, 141, 82, 142, -2, -1, -2.677945044588987, 2.23606797749979
81, 104, 484, 222, 484, 225, 0, -3, -1.5707963267948966, 3.0
81, 105, 184, 329, 187, 329, -3, 0, 3.141592653589793, 3.0
81, 106, 326, 336, 329, 336, -3, 0, 3.141592653589793, 3.0
81, 107, 38, 305, 41, 306, -3, -1, -2.819842099193151, 3.1622776601683795
81, 108, 310, 230, 312, 232, -2, -2, -2.356194490192345, 2.8284271247461903
81, 109, 92, 121, 94, 122, -2, -1, -2.677945044588987, 2.23606797749979
81, 110, 103, 197, 105, 197, -2, 0, 3.141592653589793, 2.0
81, 111, 330, 162, 332, 163, -2, -1, -2.677945044588987, 2.23606797749979
81, 112, 160, 253, 163, 254, -3, -1, -2.819842099193151, 3.1622776601683795
81, 113, 66, 297, 69, 297, -3, 0, 3.141592653589793, 3.0
81, 115, 274, 240, 277, 242, -3, -2, -2.5535900500422257, 3.605551275463989
81, 116, 69, 342, 72, 342, -3, 0, 3.141592653589793, 3.0
81, 117, 380, 352, 383, 351, -3, 1, 2.819842099193151, 3.1622776601683795
81, 118, 89, 157, 92, 158, -3, -1, -2.819842099193151, 3.1622776601683795
81, 119, 576, 113, 575, 114, 1, -1, -0.7853981633974483, 1.4142135623730951
81, 120, 473, 107, 474, 109, -1, -2, -2.0344439357957027, 2.23606797749979
81, 121, 510, 161, 510, 164, 0, -3, -1.5707963267948966, 3.0
81, 122, 32, 219, 34, 220, -2, -1, -2.677945044588987, 2.23606797749979
81, 123, 289, 209, 292, 210, -3, -1, -2.819842099193151, 3.1622776601683795
81, 124, 47, 194, 49, 194, -2, 0, 3.141592653589793, 2.0
81, 125, 236, 258, 239, 259, -3, -1, -2.819842099193151, 3.1622776601683795
81, 126, 83, 275, 85, 275, -2, 0, 3.141592653589793, 2.0
81, 127, 545, 269, 544, 271, 1, -2, -1.1071487177940904, 2.23606797749979
81, 129, 403, 108, 404, 110, -1, -2, -2.0344439357957027, 2.23606797749979
81, 130, 70, 274, 73, 274, -3, 0, 3.141592653589793, 3.0
82, 0, 28, 363, 32, 363, -4, 0, 3.141592653589793, 4.0
82, 1, 34, 112, 36, 113, -2, -1, -2.677945044588987, 2.23606797749979
82, 2, 367, 211, 369, 214, -2, -3, -2.158798930342464, 3.605551275463989
82, 3, 587, 106, 586, 108, 1, -2, -1.1071487177940904, 2.23606797749979
82, 4, 605, 292, 603, 294, 2, -2, -0.7853981633974483, 2.8284271247461903
82, 5, 31, 232, 34, 234, -3, -2, -2.5535900500422257, 3.605551275463989
82, 6, 425, 297, 428, 299, -3, -2, -2.5535900500422257, 3.605551275463989
82, 7, 56, 358, 61, 358, -5, 0, 3.141592653589793, 5.0
82, 8, 465, 360, 467, 358, -2, 2, 2.356194490192345, 2.8284271247461903
82, 9, 293, 304, 298, 306, -5, -2, -2.761086276477428, 5.385164807134504
82, 10, 48, 364, 51, 364, -3, 0, 3.141592653589793, 3.0
82, 11, 130, 176, 132, 178, -2, -2, -2.356194490192345, 2.8284271247461903
82, 12, 251, 105, 253, 108, -2, -3, -2.158798930342464, 3.605551275463989
82, 13, 220, 150, 224, 152, -4, -2, -2.677945044588987, 4.47213595499958
82, 14, 112, 171, 115, 173, -3, -2, -2.5535900500422257, 3.605551275463989
82, 15, 502, 369, 500, 366, 2, 3, 0.982793723247329, 3.605551275463989
82, 16, 367, 316, 371, 316, -4, 0, 3.141592653589793, 4.0
82, 17, 366, 283, 368, 284, -2, -1, -2.677945044588987, 2.23606797749979
82, 18, 582, 143, 579, 147, 3, -4, -0.9272952180016122, 5.0
82, 19, 406, 368, 409, 367, -3, 1, 2.819842099193151, 3.1622776601683795
82, 20, 547, 156, 545, 159, 2, -3, -0.982793723247329, 3.605551275463989
82, 21, 415, 136, 416, 138, -1, -2, -2.0344439357957027, 2.23606797749979
82, 22, 486, 267, 487, 270, -1, -3, -1.892546881191539, 3.1622776601683795
82, 23, 600, 205, 599, 207, 1, -2, -1.1071487177940904, 2.23606797749979
82, 24, 319, 217, 321, 218, -2, -1, -2.677945044588987, 2.23606797749979
82, 26, 321, 233, 323, 235, -2, -2, -2.356194490192345, 2.8284271247461903
82, 27, 366, 365, 369, 365, -3, 0, 3.141592653589793, 3.0
82, 28, 607, 363, 605, 363, 2, 0, 0.0, 2.0
82, 29, 67, 114, 70, 116, -3, -2, -2.5535900500422257, 3.605551275463989
82, 30, 382, 163, 383, 165, -1, -2, -2.0344439357957027, 2.23606797749979
82, 31, 479, 149, 479, 152, 0, -3, -1.5707963267948966, 3.0
82, 32, 265, 141, 267, 142, -2, -1, -2.677945044588987, 2.23606797749979
82, 33, 213, 105, 216, 107, -3, -2, -2.5535900500422257, 3.605551275463989
82, 34, 261, 297, 264, 297, -3, 0, 3.141592653589793, 3.0
82, 35, 32, 169, 33, 172, -1, -3, -1.892546881191539, 3.1622776601683795
82, 36, 589, 314, 586, 315, 3, -1, -0.3217505543966422, 3.1622776601683795
82, 37, 305, 103, 307, 104, -2, -1, -2.677945044588987, 2.23606797749979
82, 38, 441, 308, 444, 309, -3, -1, -2.819842099193151, 3.1622776601683795
82, 39, 431, 199, 433, 202, -2, -3, -2.158798930342464, 3.605551275463989
82, 40, 209, 212, 212, 214, -3, -2, -2.5535900500422257, 3.605551275463989
82, 41, 103, 268, 108, 270, -5, -2, -2.761086276477428, 5.385164807134504
82, 42, 597, 161, 597, 163, 0, -2, -1.5707963267948966, 2.0
82, 43, 593, 248, 592, 250, 1, -2, -1.1071487177940904, 2.23606797749979
82, 44, 501, 141, 501, 146, 0, -5, -1.5707963267948966, 5.0
82, 45, 435, 136, 437, 140, -2, -4, -2.0344439357957027, 4.47213595499958
82, 47, 284, 136, 286, 138, -2, -2, -2.356194490192345, 2.8284271247461903
82, 48, 556, 111, 555, 113, 1, -2, -1.1071487177940904, 2.23606797749979
82, 49, 518, 286, 516, 288, 2, -2, -0.7853981633974483, 2.8284271247461903
82, 51, 251, 281, 253, 282, -2, -1, -2.677945044588987, 2.23606797749979
82, 52, 593, 178, 592, 180, 1, -2, -1.1071487177940904, 2.23606797749979
82, 53, 103, 366, 106, 366, -3, 0, 3.141592653589793, 3.0
82, 54, 171, 106, 173, 107, -2, -1, -2.677945044588987, 2.23606797749979
82, 55, 408, 349, 412, 348, -4, 1, 2.896613990462929, 4.123105625617661
82, 56, 333, 267, 336, 268, -3, -1, -2.819842099193151, 3.1622776601683795
82, 58, 572, 247, 570, 249, 2, -2, -0.7853981633974483, 2.8284271247461903
82, 59, 67, 367, 71, 366, -4, 1, 2.896613990462929, 4.123105625617661
82, 60, 538, 157, 538, 159, 0, -2, -1.5707963267948966, 2.0
82, 61, 502, 164, 501, 167, 1, -3, -1.2490457723982544, 3.1622776601683795
82, 62, 68, 313, 71, 313, -3, 0, 3.141592653589793, 3.0
82, 63, 119, 302, 122, 303, -3, -1, -2.819842099193151, 3.1622776601683795
82, 64, 557, 139, 557, 142, 0, -3, -1.5707963267948966, 3.0
82, 66, 104, 315, 108, 315, -4, 0, 3.141592653589793, 4.0
82, 68, 608, 312, 607, 315, 1, -3, -1.2490457723982544, 3.1622776601683795
82, 69, 129, 198, 131, 199, -2, -1, -2.677945044588987, 2.23606797749979
82, 70, 103, 108, 106, 109, -3, -1, -2.819842099193151, 3.1622776601683795
82, 71, 468, 193, 469, 196, -1, -3, -1.892546881191539, 3.1622776601683795
82, 72, 187, 349, 190, 349, -3, 0, 3.141592653589793, 3.0
82, 73, 134, 214, 137, 215, -3, -1, -2.819842099193151, 3.1622776601683795
82, 74, 63, 229, 66, 230, -3, -1, -2.819842099193151, 3.1622776601683795
82, 75, 191, 366, 195, 366, -4, 0, 3.141592653589793, 4.0
82, 76, 593, 206, 592, 207, 1, -1, -0.7853981633974483, 1.4142135623730951
82, 77, 565, 154, 564, 156, 1, -2, -1.1071487177940904, 2.23606797749979
82, 78, 607, 265, 605, 267, 2, -2, -0.7853981633974483, 2.8284271247461903
82, 79, 201, 267, 205, 268, -4, -1, -2.896613990462929, 4.123105625617661
82, 80, 563, 368, 561, 368, 2, 0, 0.0, 2.0
82, 81, 583, 331, 580, 332, 3, -1, -0.3217505543966422, 3.1622776601683795
82, 82, 541, 247, 540, 249, 1, -2, -1.1071487177940904, 2.23606797749979
82, 83, 330, 196, 332, 197, -2, -1, -2.677945044588987, 2.23606797749979
82, 84, 139, 202, 142, 204, -3, -2, -2.5535900500422257, 3.605551275463989
82, 85, 104, 150, 107, 152, -3, -2, -2.5535900500422257, 3.605551275463989
82, 86, 476, 255, 477, 258, -1, -3, -1.892546881191539, 3.1622776601683795
82, 87, 47, 246, 49, 247, -2, -1, -2.677945044588987, 2.23606797749979
82, 88, 48, 219, 50, 221, -2, -2, -2.356194490192345, 2.8284271247461903
82, 89, 605, 237, 604, 239, 1, -2, -1.1071487177940904, 2.23606797749979
82, 90, 81, 218, 84, 219, -3, -1, -2.819842099193151, 3.1622776601683795
82, 92, 539, 216, 538, 219, 1, -3, -1.2490457723982544, 3.1622776601683795
82, 93, 330, 175, 333, 177, -3, -2, -2.5535900500422257, 3.605551275463989
82, 94, 443, 205, 445, 208, -2, -3, -2.158798930342464, 3.605551275463989
82, 95, 46, 344, 48, 344, -2, 0, 3.141592653589793, 2.0
82, 96, 303, 287, 307, 289, -4, -2, -2.677945044588987, 4.47213595499958
82, 97, 51, 330, 54, 330, -3, 0, 3.141592653589793, 3.0
82, 98, 520, 304, 519, 305, 1, -1, -0.7853981633974483, 1.4142135623730951
82, 99, 325, 357, 328, 357, -3, 0, 3.141592653589793, 3.0
82, 100, 78, 140, 80, 141, -2, -1, -2.677945044588987, 2.23606797749979
82, 101, 484, 219, 484, 222, 0, -3, -1.5707963267948966, 3.0
82, 102, 181, 329, 184, 329, -3, 0, 3.141592653589793, 3.0
82, 103, 324, 336, 326, 336, -2, 0, 3.141592653589793, 2.0
82, 104, 308, 229, 310, 230, -2, -1, -2.677945044588987, 2.23606797749979
82, 105, 88, 119, 92, 121, -4, -2, -2.677945044588987, 4.47213595499958
82, 106, 100, 196, 103, 197, -3, -1, -2.819842099193151, 3.1622776601683795
82, 107, 328, 160, 330, 162, -2, -2, -2.356194490192345, 2.8284271247461903
82, 108, 157, 252, 160, 253, -3, -1, -2.819842099193151, 3.1622776601683795
82, 109, 62, 297, 66, 297, -4, 0, 3.141592653589793, 4.0
82, 111, 272, 238, 274, 240, -2, -2, -2.356194490192345, 2.8284271247461903
82, 112, 65, 341, 69, 342, -4, -1, -2.896613990462929, 4.123105625617661
82, 113, 376, 353, 380, 352, -4, 1, 2.896613990462929, 4.123105625617661
82, 114, 86, 155, 89, 157, -3, -2, -2.5535900500422257, 3.605551275463989
82, 115, 576, 111, 576, 113, 0, -2, -1.5707963267948966, 2.0
82, 116, 510, 159, 510, 161, 0, -2, -1.5707963267948966, 2.0
82, 117, 31, 217, 32, 219, -1, -2, -2.0344439357957027, 2.23606797749979
82, 118, 287, 207, 289, 209, -2, -2, -2.356194490192345, 2.8284271247461903
82, 119, 45, 193, 47, 194, -2, -1, -2.677945044588987, 2.23606797749979
82, 120, 232, 256, 236, 258, -4, -2, -2.677945044588987, 4.47213595499958
82, 121, 80, 274, 83, 275, -3, -1, -2.819842099193151, 3.1622776601683795
82, 122, 546, 267, 545, 269, 1, -2, -1.1071487177940904, 2.23606797749979
82, 123, 308, 364, 310, 364, -2, 0, 3.141592653589793, 2.0
82, 125, 67, 273, 70, 274, -3, -1, -2.819842099193151, 3.1622776601683795
83, 0, 31, 111, 34, 112, -3, -1, -2.819842099193151, 3.1622776601683795
83, 1, 365, 209, 367, 211, -2, -2, -2.356194490192345, 2.8284271247461903
83, 2, 589, 105, 587, 106, 2, -1, -0.4636476090008061, 2.23606797749979
83, 3, 30, 229, 31, 232, -1, -3, -1.892546881191539, 3.1622776601683795
83, 4, 421, 295, 425, 297, -4, -2, -2.677945044588987, 4.47213595499958
83, 5, 53, 357, 56, 358, -3, -1, -2.819842099193151, 3.1622776601683795
83, 6, 463, 363, 465, 360, -2, 3, 2.158798930342464, 3.605551275463989
83, 7, 289, 302, 293, 304, -4, -2, -2.677945044588987, 4.47213595499958
83, 8, 46, 365, 48, 364, -2, 1, 2.677945044588987, 2.23606797749979
83, 9, 128, 175, 130, 176, -2, -1, -2.677945044588987, 2.23606797749979
83, 10, 248, 105, 251, 105, -3, 0, 3.141592653589793, 3.0
83, 11, 218, 147, 220, 150, -2, -3, -2.158798930342464, 3.605551275463989
83, 12, 110, 169, 112, 171, -2, -2, -2.356194490192345, 2.8284271247461903
83, 13, 503, 371, 502, 369, 1, 2, 1.1071487177940904, 2.23606797749979
83, 14, 364, 315, 367, 316, -3, -1, -2.819842099193151, 3.1622776601683795
83, 15, 363, 281, 366, 283, -3, -2, -2.5535900500422257, 3.605551275463989
83, 16, 582, 141, 582, 143, 0, -2, -1.5707963267948966, 2.0
83, 17, 403, 368, 406, 368, -3, 0, 3.141592653589793, 3.0
83, 18, 548, 153, 547, 156, 1, -3, -1.2490457723982544, 3.1622776601683795
83, 19, 414, 133, 415, 136, -1, -3, -1.892546881191539, 3.1622776601683795
83, 20, 487, 263, 486, 267, 1, -4, -1.3258176636680326, 4.123105625617661
83, 21, 601, 204, 600, 205, 1, -1, -0.7853981633974483, 1.4142135623730951
83, 22, 317, 215, 319, 217, -2, -2, -2.356194490192345, 2.8284271247461903
83, 24, 318, 231, 321, 233, -3, -2, -2.5535900500422257, 3.605551275463989
83, 25, 363, 365, 366, 365, -3, 0, 3.141592653589793, 3.0
83, 26, 608, 364, 607, 363, 1, 1, 0.7853981633974483, 1.4142135623730951
83, 27, 65, 113, 67, 114, -2, -1, -2.677945044588987, 2.23606797749979
83, 28, 380, 160, 382, 163, -2, -3, -2.158798930342464, 3.605551275463989
83, 29, 479, 146, 479, 149, 0, -3, -1.5707963267948966, 3.0
83, 30, 263, 139, 265, 141, -2, -2, -2.356194490192345, 2.8284271247461903
83, 31, 211, 104, 213, 105, -2, -1, -2.677945044588987, 2.23606797749979
83, 32, 258, 295, 261, 297, -3, -2, -2.5535900500422257, 3.605551275463989
83, 34, 591, 313, 589, 314, 2, -1, -0.4636476090008061, 2.23606797749979
83, 35, 303, 102, 305, 103, -2, -1, -2.677945044588987, 2.23606797749979
83, 36, 438, 307, 441, 308, -3, -1, -2.819842099193151, 3.1622776601683795
83, 37, 429, 198, 431, 199, -2, -1, -2.677945044588987, 2.23606797749979
83, 38, 207, 210, 209, 212, -2, -2, -2.356194490192345, 2.8284271247461903
83, 39, 100, 268, 103, 268, -3, 0, 3.141592653589793, 3.0
83, 40, 598, 159, 597, 161, 1, -2, -1.1071487177940904, 2.23606797749979
83, 41, 595, 246, 593, 248, 2, -2, -0.7853981633974483, 2.8284271247461903
83, 42, 501, 138, 501, 141, 0, -3, -1.5707963267948966, 3.0
83, 43, 433, 133, 435, 136, -2, -3, -2.158798930342464, 3.605551275463989
83, 44, 343, 104, 345, 105, -2, -1, -2.677945044588987, 2.23606797749979
83, 45, 282, 133, 284, 136, -2, -3, -2.158798930342464, 3.605551275463989
83, 46, 558, 109, 556, 111, 2, -2, -0.7853981633974483, 2.8284271247461903
83, 47, 520, 283, 518, 286, 2, -3, -0.982793723247329, 3.605551275463989
83, 49, 249, 279, 251, 281, -2, -2, -2.356194490192345, 2.8284271247461903
83, 50, 594, 175, 593, 178, 1, -3, -1.2490457723982544, 3.1622776601683795
83, 51, 100, 366, 103, 366, -3, 0, 3.141592653589793, 3.0
83, 52, 168, 105, 171, 106, -3, -1, -2.819842099193151, 3.1622776601683795
83, 53, 405, 350, 408, 349, -3, 1, 2.819842099193151, 3.1622776601683795
83, 54, 330, 265, 333, 267, -3, -2, -2.5535900500422257, 3.605551275463989
83, 56, 574, 245, 572, 247, 2, -2, -0.7853981633974483, 2.8284271247461903
83, 57, 63, 367, 67, 367, -4, 0, 3.141592653589793, 4.0
83, 58, 539, 155, 538, 157, 1, -2, -1.1071487177940904, 2.23606797749979
83, 59, 502, 161, 502, 164, 0, -3, -1.5707963267948966, 3.0
83, 60, 66, 311, 68, 313, -2, -2, -2.356194490192345, 2.8284271247461903
83, 61, 117, 301, 119, 302, -2, -1, -2.677945044588987, 2.23606797749979
83, 62, 558, 137, 557, 139, 1, -2, -1.1071487177940904, 2.23606797749979
83, 63, 100, 314, 104, 315, -4, -1, -2.896613990462929, 4.123105625617661
83, 64, 30, 305, 30, 308, 0, -3, -1.5707963267948966, 3.0
83, 65, 607, 313, 608, 312, -1, 1, 2.356194490192345, 1.4142135623730951
83, 66, 127, 197, 129, 198, -2, -1, -2.677945044588987, 2.23606797749979
83, 67, 100, 107, 103, 108, -3, -1, -2.819842099193151, 3.1622776601683795
83, 68, 467, 191, 468, 193, -1, -2, -2.0344439357957027, 2.23606797749979
83, 69, 184, 349, 187, 349, -3, 0, 3.141592653589793, 3.0
83, 70, 131, 212, 134, 214, -3, -2, -2.5535900500422257, 3.605551275463989
83, 71, 59, 228, 63, 229, -4, -1, -2.896613990462929, 4.123105625617661
83, 72, 189, 366, 191, 366, -2, 0, 3.141592653589793, 2.0
83, 73, 594, 204, 593, 206, 1, -2, -1.1071487177940904, 2.23606797749979
83, 74, 565, 152, 565, 154, 0, -2, -1.5707963267948966, 2.0
83, 76, 198, 266, 201, 267, -3, -1, -2.819842099193151, 3.1622776601683795
83, 77, 565, 369, 563, 368, 2, 1, 0.4636476090008061, 2.23606797749979
83, 78, 587, 331, 583, 331, 4, 0, 0.0, 4.0
83, 79, 542, 245, 541, 247, 1, -2, -1.1071487177940904, 2.23606797749979
83, 80, 328, 194, 330, 196, -2, -2, -2.356194490192345, 2.8284271247461903
83, 81, 137, 201, 139, 202, -2, -1, -2.677945044588987, 2.23606797749979
83, 82, 101, 148, 104, 150, -3, -2, -2.5535900500422257, 3.605551275463989
83, 83, 475, 252, 476, 255, -1, -3, -1.892546881191539, 3.1622776601683795
83, 84, 45, 244, 47, 246, -2, -2, -2.356194490192345, 2.8284271247461903
83, 85, 46, 218, 48, 219, -2, -1, -2.677945044588987, 2.23606797749979
83, 87, 78, 216, 81, 218, -3, -2, -2.5535900500422257, 3.605551275463989
83, 89, 540, 213, 539, 216, 1, -3, -1.2490457723982544, 3.1622776601683795
83, 90, 328, 172, 330, 175, -2, -3, -2.158798930342464, 3.605551275463989
83, 91, 441, 203, 443, 205, -2, -2, -2.356194490192345, 2.8284271247461903
83, 92, 44, 344, 46, 344, -2, 0, 3.141592653589793, 2.0
83, 93, 299, 286, 303, 287, -4, -1, -2.896613990462929, 4.123105625617661
83, 94, 49, 329, 51, 330, -2, -1, -2.677945044588987, 2.23606797749979
83, 95, 522, 302, 520, 304, 2, -2, -0.7853981633974483, 2.8284271247461903
83, 96, 323, 357, 325, 357, -2, 0, 3.141592653589793, 2.0
83, 97, 75, 138, 78, 140, -3, -2, -2.5535900500422257, 3.605551275463989
83, 98, 483, 216, 484, 219, -1, -3, -1.892546881191539, 3.1622776601683795
83, 99, 177, 329, 181, 329, -4, 0, 3.141592653589793, 4.0
83, 100, 321, 336, 324, 336, -3, 0, 3.141592653589793, 3.0
83, 101, 304, 228, 308, 229, -4, -1, -2.896613990462929, 4.123105625617661
83, 102, 86, 119, 88, 119, -2, 0, 3.141592653589793, 2.0
83, 103, 96, 195, 100, 196, -4, -1, -2.896613990462929, 4.123105625617661
83, 104, 325, 158, 328, 160, -3, -2, -2.5535900500422257, 3.605551275463989
83, 105, 154, 250, 157, 252, -3, -2, -2.5535900500422257, 3.605551275463989
83, 106, 59, 296, 62, 297, -3, -1, -2.819842099193151, 3.1622776601683795
83, 107, 529, 348, 527, 347, 2, 1, 0.4636476090008061, 2.23606797749979
83, 108, 269, 236, 272, 238, -3, -2, -2.5535900500422257, 3.605551275463989
83, 109, 62, 340, 65, 341, -3, -1, -2.819842099193151, 3.1622776601683795
83, 110, 373, 353, 376, 353, -3, 0, 3.141592653589793, 3.0
83, 111, 82, 153, 86, 155, -4, -2, -2.677945044588987, 4.47213595499958
83, 112, 577, 110, 576, 111, 1, -1, -0.7853981633974483, 1.4142135623730951
83, 113, 510, 157, 510, 159, 0, -2, -1.5707963267948966, 2.0
83, 115, 285, 206, 287, 207, -2, -1, -2.677945044588987, 2.23606797749979
83, 116, 43, 191, 45, 193, -2, -2, -2.356194490192345, 2.8284271247461903
83, 117, 228, 254, 232, 256, -4, -2, -2.677945044588987, 4.47213595499958
83, 118, 77, 273, 80, 274, -3, -1, -2.819842099193151, 3.1622776601683795
83, 119, 548, 264, 546, 267, 2, -3, -0.982793723247329, 3.605551275463989
83, 120, 305, 363, 308, 364, -3, -1, -2.819842099193151, 3.1622776601683795
83, 121, 401, 106, 403, 107, -2, -1, -2.677945044588987, 2.23606797749979
83, 122, 64, 272, 67, 273, -3, -1, -2.819842099193151, 3.1622776601683795
84, 0, 363, 207, 365, 209, -2, -2, -2.356194490192345, 2.8284271247461903
84, 3, 419, 294, 421, 295, -2, -1, -2.677945044588987, 2.23606797749979
84, 4, 51, 356, 53, 357, -2, -1, -2.677945044588987, 2.23606797749979
84, 5, 462, 365, 463, 363, -1, 2, 2.0344439357957027, 2.23606797749979
84, 6, 288, 299, 289, 302, -1, -3, -1.892546881191539, 3.1622776601683795
84, 7, 44, 365, 46, 365, -2, 0, 3.141592653589793, 2.0
84, 8, 126, 174, 128, 175, -2, -1, -2.677945044588987, 2.23606797749979
84, 10, 215, 145, 218, 147, -3, -2, -2.5535900500422257, 3.605551275463989
84, 11, 107, 167, 110, 169, -3, -2, -2.5535900500422257, 3.605551275463989
84, 12, 504, 372, 503, 371, 1, 1, 0.7853981633974483, 1.4142135623730951
84, 13, 362, 315, 364, 315, -2, 0, 3.141592653589793, 2.0
84, 14, 360, 280, 363, 281, -3, -1, -2.819842099193151, 3.1622776601683795
84, 15, 584, 138, 582, 141, 2, -3, -0.982793723247329, 3.605551275463989
84, 16, 400, 368, 403, 368, -3, 0, 3.141592653589793, 3.0
84, 17, 548, 151, 548, 153, 0, -2, -1.5707963267948966, 2.0
84, 18, 413, 130, 414, 133, -1, -3, -1.892546881191539, 3.1622776601683795
84, 20, 602, 201, 601, 204, 1, -3, -1.2490457723982544, 3.1622776601683795
84, 21, 315, 213, 317, 215, -2, -2, -2.356194490192345, 2.8284271247461903
84, 24, 361, 364, 363, 365, -2, -1, -2.677945044588987, 2.23606797749979
84, 26, 63, 112, 65, 113, -2, -1, -2.677945044588987, 2.23606797749979
84, 27, 378, 159, 380, 160, -2, -1, -2.677945044588987, 2.23606797749979
84, 28, 479, 143, 479, 146, 0, -3, -1.5707963267948966, 3.0
84, 29, 206, 103, 211, 104, -5, -1, -2.9441970937399127, 5.0990195135927845
84, 30, 257, 293, 258, 295, -1, -2, -2.0344439357957027, 2.23606797749979
84, 32, 593, 312, 591, 313, 2, -1, -0.4636476090008061, 2.23606797749979
84, 34, 428, 195, 429, 198, -1, -3, -1.892546881191539, 3.1622776601683795
84, 35, 205, 208, 207, 210, -2, -2, -2.356194490192345, 2.8284271247461903
84, 36, 98, 266, 100, 268, -2, -2, -2.356194490192345, 2.8284271247461903
84, 37, 596, 158, 598, 159, -2, -1, -2.677945044588987, 2.23606797749979
84, 38, 596, 244, 595, 246, 1, -2, -1.1071487177940904, 2.23606797749979
84, 39, 500, 136, 501, 138, -1, -2, -2.0344439357957027, 2.23606797749979
84, 40, 432, 130, 433, 133, -1, -3, -1.892546881191539, 3.1622776601683795
84, 41, 340, 103, 343, 104, -3, -1, -2.819842099193151, 3.1622776601683795
84, 42, 279, 131, 282, 133, -3, -2, -2.5535900500422257, 3.605551275463989
84, 43, 559, 106, 558, 109, 1, -3, -1.2490457723982544, 3.1622776601683795
84, 44, 521, 280, 520, 283, 1, -3, -1.2490457723982544, 3.1622776601683795
84, 46, 245, 277, 249, 279, -4, -2, -2.677945044588987, 4.47213595499958
84, 47, 594, 173, 594, 175, 0, -2, -1.5707963267948966, 2.0
84, 48, 97, 366, 100, 366, -3, 0, 3.141592653589793, 3.0
84, 49, 166, 105, 168, 105, -2, 0, 3.141592653589793, 2.0
84, 50, 401, 353, 405, 350, -4, 3, 2.498091544796509, 5.0
84, 51, 326, 263, 330, 265, -4, -2, -2.677945044588987, 4.47213595499958
84, 52, 575, 243, 574, 245, 1, -2, -1.1071487177940904, 2.23606797749979
84, 53, 61, 367, 63, 367, -2, 0, 3.141592653589793, 2.0
84, 54, 540, 152, 539, 155, 1, -3, -1.2490457723982544, 3.1622776601683795
84, 55, 501, 158, 502, 161, -1, -3, -1.892546881191539, 3.1622776601683795
84, 56, 64, 308, 66, 311, -2, -3, -2.158798930342464, 3.605551275463989
84, 57, 115, 301, 117, 301, -2, 0, 3.141592653589793, 2.0
84, 58, 559, 134, 558, 137, 1, -3, -1.2490457723982544, 3.1622776601683795
84, 59, 97, 312, 100, 314, -3, -2, -2.5535900500422257, 3.605551275463989
84, 61, 605, 311, 607, 313, -2, -2, -2.356194490192345, 2.8284271247461903
84, 62, 124, 196, 127, 197, -3, -1, -2.819842099193151, 3.1622776601683795
84, 63, 98, 106, 100, 107, -2, -1, -2.677945044588987, 2.23606797749979
84, 64, 466, 187, 467, 191, -1, -4, -1.8157749899217608, 4.123105625617661
84, 65, 182, 348, 184, 349, -2, -1, -2.677945044588987, 2.23606797749979
84, 66, 127, 209, 131, 212, -4, -3, -2.498091544796509, 5.0
84, 67, 55, 226, 59, 228, -4, -2, -2.677945044588987, 4.47213595499958
84, 68, 185, 367, 189, 366, -4, 1, 2.896613990462929, 4.123105625617661
84, 69, 595, 202, 594, 204, 1, -2, -1.1071487177940904, 2.23606797749979
84, 70, 565, 149, 565, 152, 0, -3, -1.5707963267948966, 3.0
84, 71, 607, 263, 607, 265, 0, -2, -1.5707963267948966, 2.0
84, 72, 195, 265, 198, 266, -3, -1, -2.819842099193151, 3.1622776601683795
84, 74, 587, 329, 587, 331, 0, -2, -1.5707963267948966, 2.0
84, 75, 542, 243, 542, 245, 0, -2, -1.5707963267948966, 2.0
84, 76, 325, 192, 328, 194, -3, -2, -2.5535900500422257, 3.605551275463989
84, 77, 134, 199, 137, 201, -3, -2, -2.5535900500422257, 3.605551275463989
84, 79, 44, 242, 45, 244, -1, -2, -2.0344439357957027, 2.23606797749979
84, 80, 43, 216, 46, 218, -3, -2, -2.5535900500422257, 3.605551275463989
84, 81, 74, 215, 78, 216, -4, -1, -2.896613990462929, 4.123105625617661
84, 83, 542, 210, 540, 213, 2, -3, -0.982793723247329, 3.605551275463989
84, 86, 42, 345, 44, 344, -2, 1, 2.677945044588987, 2.23606797749979
84, 87, 296, 284, 299, 286, -3, -2, -2.5535900500422257, 3.605551275463989
84, 88, 46, 327, 49, 329, -3, -2, -2.5535900500422257, 3.605551275463989
84, 89, 523, 300, 522, 302, 1, -2, -1.1071487177940904, 2.23606797749979
84, 90, 320, 357, 323, 357, -3, 0, 3.141592653589793, 3.0
84, 91, 73, 138, 75, 138, -2, 0, 3.141592653589793, 2.0
84, 92, 483, 214, 483, 216, 0, -2, -1.5707963267948966, 2.0
84, 93, 174, 328, 177, 329, -3, -1, -2.819842099193151, 3.1622776601683795
84, 94, 318, 336, 321, 336, -3, 0, 3.141592653589793, 3.0
84, 95, 300, 226, 304, 228, -4, -2, -2.677945044588987, 4.47213595499958
84, 96, 93, 196, 96, 195, -3, 1, 2.819842099193151, 3.1622776601683795
84, 97, 323, 155, 325, 158, -2, -3, -2.158798930342464, 3.605551275463989
84, 98, 150, 249, 154, 250, -4, -1, -2.896613990462929, 4.123105625617661
84, 99, 57, 295, 59, 296, -2, -1, -2.677945044588987, 2.23606797749979
84, 100, 530, 349, 529, 348, 1, 1, 0.7853981633974483, 1.4142135623730951
84, 103, 369, 353, 373, 353, -4, 0, 3.141592653589793, 4.0
84, 104, 80, 151, 82, 153, -2, -2, -2.356194490192345, 2.8284271247461903
84, 106, 510, 155, 510, 157, 0, -2, -1.5707963267948966, 2.0
84, 108, 283, 204, 285, 206, -2, -2, -2.356194490192345, 2.8284271247461903
84, 109, 224, 252, 228, 254, -4, -2, -2.677945044588987, 4.47213595499958
84, 110, 74, 272, 77, 273, -3, -1, -2.819842099193151, 3.1622776601683795
84, 111, 549, 262, 548, 264, 1, -2, -1.1071487177940904, 2.23606797749979
84, 112, 301, 361, 305, 363, -4, -2, -2.677945044588987, 4.47213595499958
84, 114, 61, 271, 64, 272, -3, -1, -2.819842099193151, 3.1622776601683795
85, 0, 364, 209, 367, 212, -3, -3, -2.356194490192345, 4.242640687119285
85, 1, 66, 112, 71, 114, -5, -2, -2.761086276477428, 5.385164807134504
85, 2, 292, 306, 296, 307, -4, -1, -2.896613990462929, 4.123105625617661
85, 3, 558, 107, 557, 112, 1, -5, -1.373400766945016, 5.0990195135927845
85, 4, 169, 218, 172, 219, -3, -1, -2.819842099193151, 3.1622776601683795
85, 5, 589, 311, 587, 312, 2, -1, -0.4636476090008061, 2.23606797749979
85, 6, 188, 332, 192, 332, -4, 0, 3.141592653589793, 4.0
85, 7, 507, 370, 505, 369, 2, 1, 0.4636476090008061, 2.23606797749979
85, 8, 34, 112, 36, 113, -2, -1, -2.677945044588987, 2.23606797749979
85, 9, 285, 223, 288, 226, -3, -3, -2.356194490192345, 4.242640687119285
85, 10, 438, 134, 439, 138, -1, -4, -1.8157749899217608, 4.123105625617661
85, 11, 468, 364, 470, 361, -2, 3, 2.158798930342464, 3.605551275463989
85, 12, 428, 198, 430, 201, -2, -3, -2.158798930342464, 3.605551275463989
85, 14, 365, 367, 368, 367, -3, 0, 3.141592653589793, 3.0
85, 15, 320, 213, 323, 216, -3, -3, -2.356194490192345, 4.242640687119285
85, 16, 102, 268, 106, 269, -4, -1, -2.896613990462929, 4.123105625617661
85, 17, 582, 142, 581, 145, 1, -3, -1.2490457723982544, 3.1622776601683795
85, 18, 221, 149, 224, 151, -3, -2, -2.5535900500422257, 3.605551275463989
85, 19, 56, 358, 61, 358, -5, 0, 3.141592653589793, 5.0
85, 20, 36, 363, 35, 365, 1, -2, -1.1071487177940904, 2.23606797749979
85, 21, 597, 247, 595, 249, 2, -2, -0.7853981633974483, 2.8284271247461903
85, 22, 319, 232, 323, 235, -4, -3, -2.498091544796509, 5.0
85, 23, 250, 276, 254, 278, -4, -2, -2.677945044588987, 4.47213595499958
85, 24, 180, 145, 183, 147, -3, -2, -2.5535900500422257, 3.605551275463989
85, 25, 252, 111, 254, 111, -2, 0, 3.141592653589793, 2.0
85, 26, 596, 177, 595, 180, 1, -3, -1.2490457723982544, 3.1622776601683795
85, 27, 365, 277, 369, 279, -4, -2, -2.677945044588987, 4.47213595499958
85, 28, 600, 294, 602, 295, -2, -1, -2.677945044588987, 2.23606797749979
85, 29, 130, 172, 133, 174, -3, -2, -2.5535900500422257, 3.605551275463989
85, 30, 280, 133, 284, 137, -4, -4, -2.356194490192345, 5.656854249492381
85, 32, 111, 170, 115, 173, -4, -3, -2.498091544796509, 5.0
85, 33, 598, 200, 596, 202, 2, -2, -0.7853981633974483, 2.8284271247461903
85, 34, 259, 295, 263, 296, -4, -1, -2.896613990462929, 4.123105625617661
85, 35, 40, 202, 39, 203, 1, -1, -0.7853981633974483, 1.4142135623730951
85, 36, 366, 317, 371, 318, -5, -1, -2.9441970937399127, 5.0990195135927845
85, 37, 50, 331, 54, 331, -4, 0, 3.141592653589793, 4.0
85, 38, 446, 219, 448, 222, -2, -3, -2.158798930342464, 3.605551275463989
85, 39, 469, 190, 470, 194, -1, -4, -1.8157749899217608, 4.123105625617661
85, 40, 548, 155, 547, 157, 1, -2, -1.1071487177940904, 2.23606797749979
85, 41, 208, 212, 211, 214, -3, -2, -2.5535900500422257, 3.605551275463989
85, 42, 96, 292, 99, 293, -3, -1, -2.819842099193151, 3.1622776601683795
85, 43, 65, 368, 69, 368, -4, 0, 3.141592653589793, 4.0
85, 44, 500, 141, 500, 145, 0, -4, -1.5707963267948966, 4.0
85, 45, 405, 368, 407, 369, -2, -1, -2.677945044588987, 2.23606797749979
85, 46, 101, 148, 106, 151, -5, -3, -2.601173153319209, 5.830951894845301
85, 47, 423, 299, 426, 301, -3, -2, -2.5535900500422257, 3.605551275463989
85, 48, 523, 302, 520, 304, 3, -2, -0.5880026035475675, 3.605551275463989
85, 49, 550, 111, 550, 114, 0, -3, -1.5707963267948966, 3.0
85, 51, 306, 109, 307, 108, -1, 1, 2.356194490192345, 1.4142135623730951
85, 52, 101, 367, 104, 367, -3, 0, 3.141592653589793, 3.0
85, 53, 47, 364, 50, 364, -3, 0, 3.141592653589793, 3.0
85, 54, 46, 218, 49, 220, -3, -2, -2.5535900500422257, 3.605551275463989
85, 55, 212, 109, 214, 109, -2, 0, 3.141592653589793, 2.0
85, 56, 567, 152, 566, 156, 1, -4, -1.3258176636680326, 4.123105625617661
85, 57, 541, 366, 540, 367, 1, -1, -0.7853981633974483, 1.4142135623730951
85, 58, 488, 267, 488, 271, 0, -4, -1.5707963267948966, 4.0
85, 59, 504, 204, 503, 208, 1, -4, -1.3258176636680326, 4.123105625617661
85, 60, 329, 191, 332, 194, -3, -3, -2.356194490192345, 4.242640687119285
85, 61, 320, 337, 324, 337, -4, 0, 3.141592653589793, 4.0
85, 62, 265, 142, 268, 144, -3, -2, -2.5535900500422257, 3.605551275463989
85, 64, 555, 133, 553, 138, 2, -5, -1.1902899496825317, 5.385164807134504
85, 65, 579, 248, 577, 251, 2, -3, -0.982793723247329, 3.605551275463989
85, 66, 380, 161, 383, 165, -3, -4, -2.214297435588181, 5.0
85, 67, 31, 234, 34, 235, -3, -1, -2.819842099193151, 3.1622776601683795
85, 68, 444, 307, 447, 309, -3, -2, -2.5535900500422257, 3.605551275463989
85, 70, 126, 338, 130, 338, -4, 0, 3.141592653589793, 4.0
85, 71, 382, 276, 385, 278, -3, -2, -2.5535900500422257, 3.605551275463989
85, 72, 515, 283, 513, 286, 2, -3, -0.982793723247329, 3.605551275463989
85, 73, 493, 185, 492, 187, 1, -2, -1.1071487177940904, 2.23606797749979
85, 74, 603, 204, 601, 207, 2, -3, -0.982793723247329, 3.605551275463989
85, 75, 365, 232, 367, 234, -2, -2, -2.356194490192345, 2.8284271247461903
85, 76, 410, 195, 413, 199, -3, -4, -2.214297435588181, 5.0
85, 79, 59, 229, 64, 230, -5, -1, -2.9441970937399127, 5.0990195135927845
85, 81, 99, 218, 101, 220, -2, -2, -2.356194490192345, 2.8284271247461903
85, 82, 242, 153, 245, 155, -3, -2, -2.5535900500422257, 3.605551275463989
85, 83, 584, 333, 582, 333, 2, 0, 0.0, 2.0
85, 84, 436, 144, 436, 147, 0, -3, -1.5707963267948966, 3.0
85, 85, 417, 130, 418, 133, -1, -3, -1.892546881191539, 3.1622776601683795
85, 87, 69, 257, 73, 258, -4, -1, -2.896613990462929, 4.123105625617661
85, 88, 417, 113, 418, 115, -1, -2, -2.0344439357957027, 2.23606797749979
85, 91, 577, 355, 575, 354, 2, 1, 0.4636476090008061, 2.23606797749979
85, 92, 351, 222, 353, 224, -2, -2, -2.356194490192345, 2.8284271247461903
85, 94, 59, 195, 63, 197, -4, -2, -2.677945044588987, 4.47213595499958
85, 95, 75, 138, 79, 140, -4, -2, -2.677945044588987, 4.47213595499958
85, 96, 443, 204, 445, 207, -2, -3, -2.158798930342464, 3.605551275463989
85, 97, 304, 229, 308, 231, -4, -2, -2.677945044588987, 4.47213595499958
85, 98, 484, 218, 484, 221, 0, -3, -1.5707963267948966, 3.0
85, 99, 66, 178, 69, 180, -3, -2, -2.5535900500422257, 3.605551275463989
85, 100, 85, 120, 89, 122, -4, -2, -2.677945044588987, 4.47213595499958
85, 101, 332, 265, 336, 267, -4, -2, -2.677945044588987, 4.47213595499958
85, 102, 573, 142, 571, 145, 2, -3, -0.982793723247329, 3.605551275463989
85, 103, 43, 248, 46, 249, -3, -1, -2.819842099193151, 3.1622776601683795
85, 104, 79, 214, 82, 216, -3, -2, -2.5535900500422257, 3.605551275463989
85, 105, 132, 215, 136, 217, -4, -2, -2.677945044588987, 4.47213595499958
85, 106, 400, 328, 403, 328, -3, 0, 3.141592653589793, 3.0
85, 107, 596, 312, 594, 314, 2, -2, -0.7853981633974483, 2.8284271247461903
85, 108, 193, 181, 196, 181, -3, 0, 3.141592653589793, 3.0
85, 109, 314, 178, 317, 180, -3, -2, -2.5535900500422257, 3.605551275463989
85, 110, 147, 269, 152, 270, -5, -1, -2.9441970937399127, 5.0990195135927845
85, 111, 177, 315, 180, 315, -3, 0, 3.141592653589793, 3.0
85, 112, 156, 253, 160, 255, -4, -2, -2.677945044588987, 4.47213595499958
85, 113, 538, 167, 538, 170, 0, -3, -1.5707963267948966, 3.0
85, 114, 355, 120, 357, 124, -2, -4, -2.0344439357957027, 4.47213595499958
85, 115, 191, 367, 194, 367, -3, 0, 3.141592653589793, 3.0
85, 117, 529, 180, 528, 185, 1, -5, -1.373400766945016, 5.0990195135927845
85, 118, 199, 266, 203, 268, -4, -2, -2.677945044588987, 4.47213595499958
85, 119, 57, 248, 61, 249, -4, -1, -2.896613990462929, 4.123105625617661
85, 120, 542, 246, 539, 249, 3, -3, -0.7853981633974483, 4.242640687119285
85, 121, 569, 121, 568, 125, 1, -4, -1.3258176636680326, 4.123105625617661
85, 122, 138, 203, 140, 204, -2, -1, -2.677945044588987, 2.23606797749979
85, 123, 302, 289, 305, 290, -3, -1, -2.819842099193151, 3.1622776601683795
85, 124, 295, 125, 297, 127, -2, -2, -2.356194490192345, 2.8284271247461903
85, 125, 43, 235, 46, 236, -3, -1, -2.819842099193151, 3.1622776601683795
85, 126, 116, 302, 120, 303, -4, -1, -2.896613990462929, 4.123105625617661
85, 127, 77, 274, 80, 275, -3, -1, -2.819842099193151, 3.1622776601683795
85, 128, 420, 163, 422, 167, -2, -4, -2.0344439357957027, 4.47213595499958
85, 129, 45, 344, 48, 344, -3, 0, 3.141592653589793, 3.0
85, 130, 172, 106, 174, 106, -2, 0, 3.141592653589793, 2.0
85, 131, 541, 215, 540, 218, 1, -3, -1.2490457723982544, 3.1622776601683795
85, 132, 348, 178, 350, 181, -2, -3, -2.158798930342464, 3.605551275463989
85, 133, 495, 150, 494, 152, 1, -2, -1.1071487177940904, 2.23606797749979
85, 134, 215, 179, 218, 180, -3, -1, -2.819842099193151, 3.1622776601683795
85, 135, 143, 347, 146, 347, -3, 0, 3.141592653589793, 3.0
85, 136, 398, 267, 401, 270, -3, -3, -2.356194490192345, 4.242640687119285
85, 137, 512, 154, 511, 156, 1, -2, -1.1071487177940904, 2.23606797749979
85, 138, 340, 144, 342, 147, -2, -3, -2.158798930342464, 3.605551275463989
85, 139, 102, 315, 106, 316, -4, -1, -2.896613990462929, 4.123105625617661
85, 140, 503, 162, 503, 165, 0, -3, -1.5707963267948966, 3.0
85, 141, 569, 245, 566, 248, 3, -3, -0.7853981633974483, 4.242640687119285
85, 142, 561, 315, 558, 316, 3, -1, -0.3217505543966422, 3.1622776601683795
85, 143, 154, 365, 158, 365, -4, 0, 3.141592653589793, 4.0
85, 144, 96, 196, 100, 198, -4, -2, -2.677945044588987, 4.47213595499958
85, 145, 484, 147, 484, 151, 0, -4, -1.5707963267948966, 4.0
85, 146, 320, 356, 324, 355, -4, 1, 2.896613990462929, 4.123105625617661
85, 147, 61, 297, 65, 298, -4, -1, -2.896613990462929, 4.123105625617661
85, 148, 532, 350, 529, 349, 3, 1, 0.3217505543966422, 3.1622776601683795
85, 149, 592, 203, 590, 206, 2, -3, -0.982793723247329, 3.605551275463989
85, 150, 343, 128, 345, 131, -2, -3, -2.158798930342464, 3.605551275463989
85, 151, 176, 186, 179, 188, -3, -2, -2.5535900500422257, 3.605551275463989
85, 152, 114, 285, 118, 286, -4, -1, -2.896613990462929, 4.123105625617661
85, 153, 364, 167, 365, 170, -1, -3, -1.892546881191539, 3.1622776601683795
85, 154, 83, 154, 88, 157, -5, -3, -2.601173153319209, 5.830951894845301
85, 155, 77, 197, 80, 198, -3, -1, -2.819842099193151, 3.1622776601683795
85, 156, 583, 196, 582, 199, 1, -3, -1.2490457723982544, 3.1622776601683795
85, 158, 398, 131, 400, 134, -2, -3, -2.158798930342464, 3.605551275463989
85, 159, 327, 158, 330, 161, -3, -3, -2.356194490192345, 4.242640687119285
85, 160, 477, 254, 478, 257, -1, -3, -1.892546881191539, 3.1622776601683795
85, 161, 539, 154, 538, 157, 1, -3, -1.2490457723982544, 3.1622776601683795
85, 162, 549, 186, 549, 189, 0, -3, -1.5707963267948966, 3.0
85, 163, 185, 349, 188, 349, -3, 0, 3.141592653589793, 3.0
85, 164, 94, 169, 98, 171, -4, -2, -2.677945044588987, 4.47213595499958
85, 166, 64, 272, 67, 273, -3, -1, -2.819842099193151, 3.1622776601683795
85, 167, 586, 158, 585, 161, 1, -3, -1.2490457723982544, 3.1622776601683795
85, 168, 224, 224, 227, 226, -3, -2, -2.5535900500422257, 3.605551275463989
85, 169, 269, 238, 273, 240, -4, -2, -2.677945044588987, 4.47213595499958
85, 170, 571, 178, 570, 181, 1, -3, -1.2490457723982544, 3.1622776601683795
85, 171, 374, 353, 378, 353, -4, 0, 3.141592653589793, 4.0
85, 172, 144, 161, 147, 163, -3, -2, -2.5535900500422257, 3.605551275463989
85, 173, 406, 352, 410, 351, -4, 1, 2.896613990462929, 4.123105625617661
85, 174, 287, 205, 290, 207, -3, -2, -2.5535900500422257, 3.605551275463989
85, 175, 374, 298, 378, 300, -4, -2, -2.677945044588987, 4.47213595499958
85, 177, 55, 256, 60, 257, -5, -1, -2.9441970937399127, 5.0990195135927845
85, 178, 555, 282, 553, 284, 2, -2, -0.7853981633974483, 2.8284271247461903
85, 179, 474, 147, 475, 152, -1, -5, -1.7681918866447774, 5.0990195135927845
85, 180, 192, 312, 196, 313, -4, -1, -2.896613990462929, 4.123105625617661
85, 181, 30, 371, 31, 373, -1, -2, -2.0344439357957027, 2.23606797749979
85, 182, 113, 113, 116, 115, -3, -2, -2.5535900500422257, 3.605551275463989
85, 184, 267, 277, 271, 278, -4, -1, -2.896613990462929, 4.123105625617661
86, 0, 361, 207, 364, 209, -3, -2, -2.5535900500422257, 3.605551275463989
86, 1, 62, 110, 66, 112, -4, -2, -2.677945044588987, 4.47213595499958
86, 2, 287, 304, 292, 306, -5, -2, -2.761086276477428, 5.385164807134504
86, 3, 558, 103, 558, 107, 0, -4, -1.5707963267948966, 4.0
86, 4, 165, 216, 169, 218, -4, -2, -2.677945044588987, 4.47213595499958
86, 5, 592, 309, 589, 311, 3, -2, -0.5880026035475675, 3.605551275463989
86, 6, 184, 332, 188, 332, -4, 0, 3.141592653589793, 4.0
86, 8, 33, 110, 34, 112, -1, -2, -2.0344439357957027, 2.23606797749979
86, 9, 282, 221, 285, 223, -3, -2, -2.5535900500422257, 3.605551275463989
86, 10, 436, 130, 438, 134, -2, -4, -2.0344439357957027, 4.47213595499958
86, 11, 466, 368, 468, 364, -2, 4, 2.0344439357957027, 4.47213595499958
86, 12, 426, 194, 428, 198, -2, -4, -2.0344439357957027, 4.47213595499958
86, 13, 586, 110, 587, 109, -1, 1, 2.356194490192345, 1.4142135623730951
86, 14, 362, 366, 365, 367, -3, -1, -2.819842099193151, 3.1622776601683795
86, 15, 316, 210, 320, 213, -4, -3, -2.498091544796509, 5.0
86, 16, 98, 267, 102, 268, -4, -1, -2.896613990462929, 4.123105625617661
86, 17, 583, 138, 582, 142, 1, -4, -1.3258176636680326, 4.123105625617661
86, 18, 218, 146, 221, 149, -3, -3, -2.356194490192345, 4.242640687119285
86, 19, 52, 358, 56, 358, -4, 0, 3.141592653589793, 4.0
86, 20, 37, 362, 36, 363, 1, -1, -0.7853981633974483, 1.4142135623730951
86, 21, 599, 245, 597, 247, 2, -2, -0.7853981633974483, 2.8284271247461903
86, 22, 315, 230, 319, 232, -4, -2, -2.677945044588987, 4.47213595499958
86, 23, 246, 274, 250, 276, -4, -2, -2.677945044588987, 4.47213595499958
86, 24, 176, 143, 180, 145, -4, -2, -2.677945044588987, 4.47213595499958
86, 26, 597, 174, 596, 177, 1, -3, -1.2490457723982544, 3.1622776601683795
86, 27, 362, 274, 365, 277, -3, -3, -2.356194490192345, 4.242640687119285
86, 28, 126, 170, 130, 172, -4, -2, -2.677945044588987, 4.47213595499958
86, 29, 276, 130, 280, 133, -4, -3, -2.498091544796509, 5.0
86, 31, 107, 169, 111, 170, -4, -1, -2.896613990462929, 4.123105625617661
86, 32, 599, 198, 598, 200, 1, -2, -1.1071487177940904, 2.23606797749979
86, 33, 255, 293, 259, 295, -4, -2, -2.677945044588987, 4.47213595499958
86, 35, 362, 316, 366, 317, -4, -1, -2.896613990462929, 4.123105625617661
86, 36, 46, 331, 50, 331, -4, 0, 3.141592653589793, 4.0
86, 37, 445, 216, 446, 219, -1, -3, -1.892546881191539, 3.1622776601683795
86, 38, 468, 187, 469, 190, -1, -3, -1.892546881191539, 3.1622776601683795
86, 39, 548, 152, 548, 155, 0, -3, -1.5707963267948966, 3.0
86, 40, 204, 210, 208, 212, -4, -2, -2.677945044588987, 4.47213595499958
86, 41, 91, 291, 96, 292, -5, -1, -2.9441970937399127, 5.0990195135927845
86, 42, 61, 368, 65, 368, -4, 0, 3.141592653589793, 4.0
86, 43, 500, 137, 500, 141, 0, -4, -1.5707963267948966, 4.0
86, 44, 403, 366, 405, 368, -2, -2, -2.356194490192345, 2.8284271247461903
86, 45, 97, 145, 101, 148, -4, -3, -2.498091544796509, 5.0
86, 46, 420, 296, 423, 299, -3, -3, -2.356194490192345, 4.242640687119285
86, 47, 526, 299, 523, 302, 3, -3, -0.7853981633974483, 4.242640687119285
86, 48, 549, 109, 550, 111, -1, -2, -2.0344439357957027, 2.23606797749979
86, 51, 97, 367, 101, 367, -4, 0, 3.141592653589793, 4.0
86, 52, 44, 363, 47, 364, -3, -1, -2.819842099193151, 3.1622776601683795
86, 53, 43, 216, 46, 218, -3, -2, -2.5535900500422257, 3.605551275463989
86, 54, 211, 110, 212, 109, -1, 1, 2.356194490192345, 1.4142135623730951
86, 55, 568, 148, 567, 152, 1, -4, -1.3258176636680326, 4.123105625617661
86, 57, 488, 264, 488, 267, 0, -3, -1.5707963267948966, 3.0
86, 58, 504, 200, 504, 204, 0, -4, -1.5707963267948966, 4.0
86, 59, 327, 189, 329, 191, -2, -2, -2.356194490192345, 2.8284271247461903
86, 60, 315, 337, 320, 337, -5, 0, 3.141592653589793, 5.0
86, 61, 262, 139, 265, 142, -3, -3, -2.356194490192345, 4.242640687119285
86, 62, 556, 129, 555, 133, 1, -4, -1.3258176636680326, 4.123105625617661
86, 63, 581, 245, 579, 248, 2, -3, -0.982793723247329, 3.605551275463989
86, 64, 378, 157, 380, 161, -2, -4, -2.0344439357957027, 4.47213595499958
86, 66, 440, 305, 444, 307, -4, -2, -2.677945044588987, 4.47213595499958
86, 68, 121, 338, 126, 338, -5, 0, 3.141592653589793, 5.0
86, 69, 379, 274, 382, 276, -3, -2, -2.5535900500422257, 3.605551275463989
86, 70, 517, 280, 515, 283, 2, -3, -0.982793723247329, 3.605551275463989
86, 71, 493, 182, 493, 185, 0, -3, -1.5707963267948966, 3.0
86, 72, 605, 202, 603, 204, 2, -2, -0.7853981633974483, 2.8284271247461903
86, 73, 363, 230, 365, 232, -2, -2, -2.356194490192345, 2.8284271247461903
86, 74, 408, 193, 410, 195, -2, -2, -2.356194490192345, 2.8284271247461903
86, 75, 602, 336, 604, 337, -2, -1, -2.677945044588987, 2.23606797749979
86, 76, 54, 227, 59, 229, -5, -2, -2.761086276477428, 5.385164807134504
86, 78, 96, 216, 99, 218, -3, -2, -2.5535900500422257, 3.605551275463989
86, 79, 239, 151, 242, 153, -3, -2, -2.5535900500422257, 3.605551275463989
86, 80, 587, 333, 584, 333, 3, 0, 0.0, 3.0
86, 81, 436, 140, 436, 144, 0, -4, -1.5707963267948966, 4.0
86, 82, 415, 126, 417, 130, -2, -4, -2.0344439357957027, 4.47213595499958
86, 83, 34, 306, 33, 307, 1, -1, -0.7853981633974483, 1.4142135623730951
86, 84, 66, 256, 69, 257, -3, -1, -2.819842099193151, 3.1622776601683795
86, 85, 416, 109, 417, 113, -1, -4, -1.8157749899217608, 4.123105625617661
86, 88, 580, 356, 577, 355, 3, 1, 0.3217505543966422, 3.1622776601683795
86, 89, 349, 220, 351, 222, -2, -2, -2.356194490192345, 2.8284271247461903
86, 91, 56, 193, 59, 195, -3, -2, -2.5535900500422257, 3.605551275463989
86, 92, 73, 136, 75, 138, -2, -2, -2.356194490192345, 2.8284271247461903
86, 93, 441, 201, 443, 204, -2, -3, -2.158798930342464, 3.605551275463989
86, 94, 302, 227, 304, 229, -2, -2, -2.356194490192345, 2.8284271247461903
86, 95, 484, 214, 484, 218, 0, -4, -1.5707963267948966, 4.0
86, 96, 63, 177, 66, 178, -3, -1, -2.819842099193151, 3.1622776601683795
86, 97, 81, 118, 85, 120, -4, -2, -2.677945044588987, 4.47213595499958
86, 98, 329, 264, 332, 265, -3, -1, -2.819842099193151, 3.1622776601683795
86, 99, 573, 140, 573, 142, 0, -2, -1.5707963267948966, 2.0
86, 100, 41, 247, 43, 248, -2, -1, -2.677945044588987, 2.23606797749979
86, 101, 76, 214, 79, 214, -3, 0, 3.141592653589793, 3.0
86, 102, 128, 214, 132, 215, -4, -1, -2.896613990462929, 4.123105625617661
86, 103, 396, 327, 400, 328, -4, -1, -2.896613990462929, 4.123105625617661
86, 104, 598, 310, 596, 312, 2, -2, -0.7853981633974483, 2.8284271247461903
86, 105, 191, 179, 193, 181, -2, -2, -2.356194490192345, 2.8284271247461903
86, 106, 311, 176, 314, 178, -3, -2, -2.5535900500422257, 3.605551275463989
86, 107, 144, 268, 147, 269, -3, -1, -2.819842099193151, 3.1622776601683795
86, 108, 173, 315, 177, 315, -4, 0, 3.141592653589793, 4.0
86, 109, 152, 251, 156, 253, -4, -2, -2.677945044588987, 4.47213595499958
86, 110, 540, 163, 538, 167, 2, -4, -1.1071487177940904, 4.47213595499958
86, 111, 353, 118, 355, 120, -2, -2, -2.356194490192345, 2.8284271247461903
86, 112, 187, 367, 191, 367, -4, 0, 3.141592653589793, 4.0
86, 114, 530, 177, 529, 180, 1, -3, -1.2490457723982544, 3.1622776601683795
86, 115, 196, 264, 199, 266, -3, -2, -2.5535900500422257, 3.605551275463989
86, 116, 53, 246, 57, 248, -4, -2, -2.677945044588987, 4.47213595499958
86, 117, 543, 243, 542, 246, 1, -3, -1.2490457723982544, 3.1622776601683795
86, 118, 570, 118, 569, 121, 1, -3, -1.2490457723982544, 3.1622776601683795
86, 119, 135, 202, 138, 203, -3, -1, -2.819842099193151, 3.1622776601683795
86, 120, 297, 287, 302, 289, -5, -2, -2.761086276477428, 5.385164807134504
86, 121, 293, 123, 295, 125, -2, -2, -2.356194490192345, 2.8284271247461903
86, 122, 43, 233, 43, 235, 0, -2, -1.5707963267948966, 2.0
86, 123, 113, 301, 116, 302, -3, -1, -2.819842099193151, 3.1622776601683795
86, 124, 74, 273, 77, 274, -3, -1, -2.819842099193151, 3.1622776601683795
86, 125, 418, 160, 420, 163, -2, -3, -2.158798930342464, 3.605551275463989
86, 126, 42, 344, 45, 344, -3, 0, 3.141592653589793, 3.0
86, 127, 170, 106, 172, 106, -2, 0, 3.141592653589793, 2.0
86, 128, 542, 211, 541, 215, 1, -4, -1.3258176636680326, 4.123105625617661
86, 129, 345, 175, 348, 178, -3, -3, -2.356194490192345, 4.242640687119285
86, 130, 496, 146, 495, 150, 1, -4, -1.3258176636680326, 4.123105625617661
86, 131, 212, 177, 215, 179, -3, -2, -2.5535900500422257, 3.605551275463989
86, 132, 139, 347, 143, 347, -4, 0, 3.141592653589793, 4.0
86, 133, 395, 265, 398, 267, -3, -2, -2.5535900500422257, 3.605551275463989
86, 134, 513, 151, 512, 154, 1, -3, -1.2490457723982544, 3.1622776601683795
86, 135, 338, 142, 340, 144, -2, -2, -2.356194490192345, 2.8284271247461903
86, 136, 98, 314, 102, 315, -4, -1, -2.896613990462929, 4.123105625617661
86, 137, 503, 160, 503, 162, 0, -2, -1.5707963267948966, 2.0
86, 138, 571, 242, 569, 245, 2, -3, -0.982793723247329, 3.605551275463989
86, 139, 565, 314, 561, 315, 4, -1, -0.24497866312686414, 4.123105625617661
86, 140, 151, 365, 154, 365, -3, 0, 3.141592653589793, 3.0
86, 141, 94, 195, 96, 196, -2, -1, -2.677945044588987, 2.23606797749979
86, 142, 484, 142, 484, 147, 0, -5, -1.5707963267948966, 5.0
86, 143, 317, 356, 320, 356, -3, 0, 3.141592653589793, 3.0
86, 144, 57, 296, 61, 297, -4, -1, -2.896613990462929, 4.123105625617661
86, 145, 535, 352, 532, 350, 3, 2, 0.5880026035475675, 3.605551275463989
86, 146, 594, 200, 592, 203, 2, -3, -0.982793723247329, 3.605551275463989
86, 147, 340, 125, 343, 128, -3, -3, -2.356194490192345, 4.242640687119285
86, 148, 173, 184, 176, 186, -3, -2, -2.5535900500422257, 3.605551275463989
86, 149, 109, 284, 114, 285, -5, -1, -2.9441970937399127, 5.0990195135927845
86, 150, 361, 163, 364, 167, -3, -4, -2.214297435588181, 5.0
86, 151, 80, 152, 83, 154, -3, -2, -2.5535900500422257, 3.605551275463989
86, 152, 75, 196, 77, 197, -2, -1, -2.677945044588987, 2.23606797749979
86, 153, 585, 193, 583, 196, 2, -3, -0.982793723247329, 3.605551275463989
86, 155, 397, 128, 398, 131, -1, -3, -1.892546881191539, 3.1622776601683795
86, 156, 325, 155, 327, 158, -2, -3, -2.158798930342464, 3.605551275463989
86, 157, 476, 250, 477, 254, -1, -4, -1.8157749899217608, 4.123105625617661
86, 158, 539, 152, 539, 154, 0, -2, -1.5707963267948966, 2.0
86, 159, 550, 182, 549, 186, 1, -4, -1.3258176636680326, 4.123105625617661
86, 160, 181, 349, 185, 349, -4, 0, 3.141592653589793, 4.0
86, 161, 90, 167, 94, 169, -4, -2, -2.677945044588987, 4.47213595499958
86, 162, 603, 315, 605, 315, -2, 0, 3.141592653589793, 2.0
86, 163, 61, 271, 64, 272, -3, -1, -2.819842099193151, 3.1622776601683795
86, 164, 588, 155, 586, 158, 2, -3, -0.982793723247329, 3.605551275463989
86, 165, 221, 222, 224, 224, -3, -2, -2.5535900500422257, 3.605551275463989
86, 166, 265, 235, 269, 238, -4, -3, -2.498091544796509, 5.0
86, 167, 571, 175, 571, 178, 0, -3, -1.5707963267948966, 3.0
86, 168, 371, 354, 374, 353, -3, 1, 2.819842099193151, 3.1622776601683795
86, 169, 141, 159, 144, 161, -3, -2, -2.5535900500422257, 3.605551275463989
86, 170, 402, 353, 406, 352, -4, 1, 2.896613990462929, 4.123105625617661
86, 171, 284, 203, 287, 205, -3, -2, -2.5535900500422257, 3.605551275463989
86, 172, 371, 296, 374, 298, -3, -2, -2.5535900500422257, 3.605551275463989
86, 174, 52, 255, 55, 256, -3, -1, -2.819842099193151, 3.1622776601683795
86, 175, 559, 279, 555, 282, 4, -3, -0.6435011087932844, 5.0
86, 176, 474, 144, 474, 147, 0, -3, -1.5707963267948966, 3.0
86, 177, 190, 311, 192, 312, -2, -1, -2.677945044588987, 2.23606797749979
86, 179, 111, 111, 113, 113, -2, -2, -2.356194490192345, 2.8284271247461903
86, 181, 263, 276, 267, 277, -4, -1, -2.896613990462929, 4.123105625617661
87, 0, 359, 205, 361, 207, -2, -2, -2.356194490192345, 2.8284271247461903
87, 1, 58, 108, 62, 110, -4, -2, -2.677945044588987, 4.47213595499958
87, 2, 284, 303, 287, 304, -3, -1, -2.819842099193151, 3.1622776601683795
87, 3, 162, 215, 165, 216, -3, -1, -2.819842099193151, 3.1622776601683795
87, 4, 594, 307, 592, 309, 2, -2, -0.7853981633974483, 2.8284271247461903
87, 5, 180, 332, 184, 332, -4, 0, 3.141592653589793, 4.0
87, 6, 506, 366, 507, 369, -1, -3, -1.892546881191539, 3.1622776601683795
87, 7, 278, 220, 282, 221, -4, -1, -2.896613990462929, 4.123105625617661
87, 8, 433, 125, 436, 130, -3, -5, -2.1112158270654806, 5.830951894845301
87, 9, 465, 372, 466, 368, -1, 4, 1.8157749899217608, 4.123105625617661
87, 10, 423, 191, 426, 194, -3, -3, -2.356194490192345, 4.242640687119285
87, 12, 360, 364, 362, 366, -2, -2, -2.356194490192345, 2.8284271247461903
87, 13, 314, 207, 316, 210, -2, -3, -2.158798930342464, 3.605551275463989
87, 14, 93, 266, 98, 267, -5, -1, -2.9441970937399127, 5.0990195135927845
87, 15, 585, 133, 583, 138, 2, -5, -1.1902899496825317, 5.385164807134504
87, 16, 214, 144, 218, 146, -4, -2, -2.677945044588987, 4.47213595499958
87, 17, 47, 359, 52, 358, -5, 1, 2.9441970937399127, 5.0990195135927845
87, 18, 37, 360, 37, 362, 0, -2, -1.5707963267948966, 2.0
87, 19, 601, 243, 599, 245, 2, -2, -0.7853981633974483, 2.8284271247461903
87, 20, 310, 226, 315, 230, -5, -4, -2.4668517113662407, 6.4031242374328485
87, 21, 241, 271, 246, 274, -5, -3, -2.601173153319209, 5.830951894845301
87, 22, 173, 142, 176, 143, -3, -1, -2.819842099193151, 3.1622776601683795
87, 23, 250, 112, 251, 111, -1, 1, 2.356194490192345, 1.4142135623730951
87, 24, 598, 171, 597, 174, 1, -3, -1.2490457723982544, 3.1622776601683795
87, 25, 358, 271, 362, 274, -4, -3, -2.498091544796509, 5.0
87, 26, 121, 169, 126, 170, -5, -1, -2.9441970937399127, 5.0990195135927845
87, 27, 273, 126, 276, 130, -3, -4, -2.214297435588181, 5.0
87, 29, 104, 167, 107, 169, -3, -2, -2.5535900500422257, 3.605551275463989
87, 30, 601, 197, 599, 198, 2, -1, -0.4636476090008061, 2.23606797749979
87, 31, 250, 292, 255, 293, -5, -1, -2.9441970937399127, 5.0990195135927845
87, 32, 359, 313, 362, 316, -3, -3, -2.356194490192345, 4.242640687119285
87, 33, 43, 330, 46, 331, -3, -1, -2.819842099193151, 3.1622776601683795
87, 34, 443, 213, 445, 216, -2, -3, -2.158798930342464, 3.605551275463989
87, 35, 467, 185, 468, 187, -1, -2, -2.0344439357957027, 2.23606797749979
87, 36, 549, 147, 548, 152, 1, -5, -1.373400766945016, 5.0990195135927845
87, 37, 200, 208, 204, 210, -4, -2, -2.677945044588987, 4.47213595499958
87, 38, 87, 291, 91, 291, -4, 0, 3.141592653589793, 4.0
87, 39, 57, 367, 61, 368, -4, -1, -2.896613990462929, 4.123105625617661
87, 40, 499, 132, 500, 137, -1, -5, -1.7681918866447774, 5.0990195135927845
87, 41, 94, 143, 97, 145, -3, -2, -2.5535900500422257, 3.605551275463989
87, 42, 416, 292, 420, 296, -4, -4, -2.356194490192345, 5.656854249492381
87, 43, 528, 297, 526, 299, 2, -2, -0.7853981633974483, 2.8284271247461903
87, 44, 547, 107, 549, 109, -2, -2, -2.356194490192345, 2.8284271247461903
87, 47, 94, 366, 97, 367, -3, -1, -2.819842099193151, 3.1622776601683795
87, 48, 42, 363, 44, 363, -2, 0, 3.141592653589793, 2.0
87, 49, 40, 215, 43, 216, -3, -1, -2.819842099193151, 3.1622776601683795
87, 51, 568, 144, 568, 148, 0, -4, -1.5707963267948966, 4.0
87, 53, 488, 261, 488, 264, 0, -3, -1.5707963267948966, 3.0
87, 55, 324, 187, 327, 189, -3, -2, -2.5535900500422257, 3.605551275463989
87, 56, 311, 337, 315, 337, -4, 0, 3.141592653589793, 4.0
87, 57, 259, 136, 262, 139, -3, -3, -2.356194490192345, 4.242640687119285
87, 58, 555, 125, 556, 129, -1, -4, -1.8157749899217608, 4.123105625617661
87, 59, 584, 243, 581, 245, 3, -2, -0.5880026035475675, 3.605551275463989
87, 60, 376, 154, 378, 157, -2, -3, -2.158798930342464, 3.605551275463989
87, 62, 437, 302, 440, 305, -3, -3, -2.356194490192345, 4.242640687119285
87, 64, 117, 338, 121, 338, -4, 0, 3.141592653589793, 4.0
87, 65, 375, 272, 379, 274, -4, -2, -2.677945044588987, 4.47213595499958
87, 66, 519, 277, 517, 280, 2, -3, -0.982793723247329, 3.605551275463989
87, 67, 494, 178, 493, 182, 1, -4, -1.3258176636680326, 4.123105625617661
87, 68, 607, 200, 605, 202, 2, -2, -0.7853981633974483, 2.8284271247461903
87, 69, 361, 228, 363, 230, -2, -2, -2.356194490192345, 2.8284271247461903
87, 70, 406, 190, 408, 193, -2, -3, -2.158798930342464, 3.605551275463989
87, 74, 92, 215, 96, 216, -4, -1, -2.896613990462929, 4.123105625617661
87, 75, 236, 149, 239, 151, -3, -2, -2.5535900500422257, 3.605551275463989
87, 76, 590, 333, 587, 333, 3, 0, 0.0, 3.0
87, 77, 434, 136, 436, 140, -2, -4, -2.0344439357957027, 4.47213595499958
87, 78, 415, 123, 415, 126, 0, -3, -1.5707963267948966, 3.0
87, 80, 61, 255, 66, 256, -5, -1, -2.9441970937399127, 5.0990195135927845
87, 81, 415, 106, 416, 109, -1, -3, -1.892546881191539, 3.1622776601683795
87, 84, 583, 357, 580, 356, 3, 1, 0.3217505543966422, 3.1622776601683795
87, 85, 347, 218, 349, 220, -2, -2, -2.356194490192345, 2.8284271247461903
87, 87, 53, 191, 56, 193, -3, -2, -2.5535900500422257, 3.605551275463989
87, 88, 69, 134, 73, 136, -4, -2, -2.677945044588987, 4.47213595499958
87, 89, 439, 197, 441, 201, -2, -4, -2.0344439357957027, 4.47213595499958
87, 90, 297, 225, 302, 227, -5, -2, -2.761086276477428, 5.385164807134504
87, 91, 484, 211, 484, 214, 0, -3, -1.5707963267948966, 3.0
87, 92, 60, 175, 63, 177, -3, -2, -2.5535900500422257, 3.605551275463989
87, 93, 78, 116, 81, 118, -3, -2, -2.5535900500422257, 3.605551275463989
87, 94, 326, 262, 329, 264, -3, -2, -2.5535900500422257, 3.605551275463989
87, 95, 574, 138, 573, 140, 1, -2, -1.1071487177940904, 2.23606797749979
87, 96, 39, 246, 41, 247, -2, -1, -2.677945044588987, 2.23606797749979
87, 97, 73, 213, 76, 214, -3, -1, -2.819842099193151, 3.1622776601683795
87, 98, 123, 212, 128, 214, -5, -2, -2.761086276477428, 5.385164807134504
87, 99, 391, 327, 396, 327, -5, 0, 3.141592653589793, 5.0
87, 100, 599, 308, 598, 310, 1, -2, -1.1071487177940904, 2.23606797749979
87, 101, 187, 176, 191, 179, -4, -3, -2.498091544796509, 5.0
87, 102, 309, 175, 311, 176, -2, -1, -2.677945044588987, 2.23606797749979
87, 103, 140, 266, 144, 268, -4, -2, -2.677945044588987, 4.47213595499958
87, 104, 169, 314, 173, 315, -4, -1, -2.896613990462929, 4.123105625617661
87, 105, 148, 249, 152, 251, -4, -2, -2.677945044588987, 4.47213595499958
87, 106, 541, 159, 540, 163, 1, -4, -1.3258176636680326, 4.123105625617661
87, 107, 351, 117, 353, 118, -2, -1, -2.677945044588987, 2.23606797749979
87, 108, 182, 367, 187, 367, -5, 0, 3.141592653589793, 5.0
87, 110, 532, 172, 530, 177, 2, -5, -1.1902899496825317, 5.385164807134504
87, 111, 191, 263, 196, 264, -5, -1, -2.9441970937399127, 5.0990195135927845
87, 112, 50, 244, 53, 246, -3, -2, -2.5535900500422257, 3.605551275463989
87, 113, 544, 241, 543, 243, 1, -2, -1.1071487177940904, 2.23606797749979
87, 114, 571, 115, 570, 118, 1, -3, -1.2490457723982544, 3.1622776601683795
87, 115, 132, 200, 135, 202, -3, -2, -2.5535900500422257, 3.605551275463989
87, 116, 293, 286, 297, 287, -4, -1, -2.896613990462929, 4.123105625617661
87, 117, 291, 121, 293, 123, -2, -2, -2.356194490192345, 2.8284271247461903
87, 119, 109, 300, 113, 301, -4, -1, -2.896613990462929, 4.123105625617661
87, 120, 70, 272, 74, 273, -4, -1, -2.896613990462929, 4.123105625617661
87, 121, 416, 157, 418, 160, -2, -3, -2.158798930342464, 3.605551275463989
87, 122, 40, 343, 42, 344, -2, -1, -2.677945044588987, 2.23606797749979
87, 123, 168, 106, 170, 106, -2, 0, 3.141592653589793, 2.0
87, 124, 543, 209, 542, 211, 1, -2, -1.1071487177940904, 2.23606797749979
87, 125, 343, 172, 345, 175, -2, -3, -2.158798930342464, 3.605551275463989
87, 126, 496, 142, 496, 146, 0, -4, -1.5707963267948966, 4.0
87, 127, 210, 175, 212, 177, -2, -2, -2.356194490192345, 2.8284271247461903
87, 128, 136, 347, 139, 347, -3, 0, 3.141592653589793, 3.0
87, 129, 392, 263, 395, 265, -3, -2, -2.5535900500422257, 3.605551275463989
87, 130, 514, 147, 513, 151, 1, -4, -1.3258176636680326, 4.123105625617661
87, 131, 335, 139, 338, 142, -3, -3, -2.356194490192345, 4.242640687119285
87, 132, 93, 314, 98, 314, -5, 0, 3.141592653589793, 5.0
87, 133, 503, 157, 503, 160, 0, -3, -1.5707963267948966, 3.0
87, 135, 567, 313, 565, 314, 2, -1, -0.4636476090008061, 2.23606797749979
87, 136, 147, 365, 151, 365, -4, 0, 3.141592653589793, 4.0
87, 137, 91, 193, 94, 195, -3, -2, -2.5535900500422257, 3.605551275463989
87, 138, 484, 139, 484, 142, 0, -3, -1.5707963267948966, 3.0
87, 139, 313, 356, 317, 356, -4, 0, 3.141592653589793, 4.0
87, 140, 55, 295, 57, 296, -2, -1, -2.677945044588987, 2.23606797749979
87, 141, 538, 353, 535, 352, 3, 1, 0.3217505543966422, 3.1622776601683795
87, 143, 338, 123, 340, 125, -2, -2, -2.356194490192345, 2.8284271247461903
87, 144, 169, 182, 173, 184, -4, -2, -2.677945044588987, 4.47213595499958
87, 145, 104, 283, 109, 284, -5, -1, -2.9441970937399127, 5.0990195135927845
87, 146, 359, 160, 361, 163, -2, -3, -2.158798930342464, 3.605551275463989
87, 147, 76, 150, 80, 152, -4, -2, -2.677945044588987, 4.47213595499958
87, 148, 71, 194, 75, 196, -4, -2, -2.677945044588987, 4.47213595499958
87, 149, 587, 189, 585, 193, 2, -4, -1.1071487177940904, 4.47213595499958
87, 151, 395, 126, 397, 128, -2, -2, -2.356194490192345, 2.8284271247461903
87, 152, 322, 153, 325, 155, -3, -2, -2.5535900500422257, 3.605551275463989
87, 153, 476, 246, 476, 250, 0, -4, -1.5707963267948966, 4.0
87, 154, 539, 150, 539, 152, 0, -2, -1.5707963267948966, 2.0
87, 155, 552, 179, 550, 182, 2, -3, -0.982793723247329, 3.605551275463989
87, 156, 177, 349, 181, 349, -4, 0, 3.141592653589793, 4.0
87, 157, 87, 166, 90, 167, -3, -1, -2.819842099193151, 3.1622776601683795
87, 159, 58, 269, 61, 271, -3, -2, -2.5535900500422257, 3.605551275463989
87, 160, 590, 151, 588, 155, 2, -4, -1.1071487177940904, 4.47213595499958
87, 161, 218, 220, 221, 222, -3, -2, -2.5535900500422257, 3.605551275463989
87, 162, 261, 233, 265, 235, -4, -2, -2.677945044588987, 4.47213595499958
87, 163, 570, 172, 571, 175, -1, -3, -1.892546881191539, 3.1622776601683795
87, 164, 366, 355, 371, 354, -5, 1, 2.9441970937399127, 5.0990195135927845
87, 165, 138, 157, 141, 159, -3, -2, -2.5535900500422257, 3.605551275463989
87, 166, 398, 353, 402, 353, -4, 0, 3.141592653589793, 4.0
87, 167, 282, 201, 284, 203, -2, -2, -2.356194490192345, 2.8284271247461903
87, 168, 367, 295, 371, 296, -4, -1, -2.896613990462929, 4.123105625617661
87, 170, 48, 253, 52, 255, -4, -2, -2.677945044588987, 4.47213595499958
87, 171, 562, 276, 559, 279, 3, -3, -0.7853981633974483, 4.242640687119285
87, 172, 474, 142, 474, 144, 0, -2, -1.5707963267948966, 2.0
87, 173, 186, 310, 190, 311, -4, -1, -2.896613990462929, 4.123105625617661
87, 175, 109, 110, 111, 111, -2, -1, -2.677945044588987, 2.23606797749979
87, 177, 259, 275, 263, 276, -4, -1, -2.896613990462929, 4.123105625617661
88, 0, 357, 202, 359, 205, -2, -3, -2.158798930342464, 3.605551275463989
88, 2, 282, 301, 284, 303, -2, -2, -2.356194490192345, 2.8284271247461903
88, 3, 160, 212, 162, 215, -2, -3, -2.158798930342464, 3.605551275463989
88, 4, 596, 306, 594, 307, 2, -1, -0.4636476090008061, 2.23606797749979
88, 5, 177, 331, 180, 332, -3, -1, -2.819842099193151, 3.1622776601683795
88, 6, 505, 364, 506, 366, -1, -2, -2.0344439357957027, 2.23606797749979
88, 7, 275, 218, 278, 220, -3, -2, -2.5535900500422257, 3.605551275463989
88, 8, 433, 123, 433, 125, 0, -2, -1.5707963267948966, 2.0
88, 9, 463, 376, 465, 372, -2, 4, 2.0344439357957027, 4.47213595499958
88, 10, 421, 189, 423, 191, -2, -2, -2.356194490192345, 2.8284271247461903
88, 12, 358, 362, 360, 364, -2, -2, -2.356194490192345, 2.8284271247461903
88, 13, 311, 204, 314, 207, -3, -3, -2.356194490192345, 4.242640687119285
88, 14, 88, 264, 93, 266, -5, -2, -2.761086276477428, 5.385164807134504
88, 15, 585, 128, 585, 133, 0, -5, -1.5707963267948966, 5.0
88, 16, 211, 141, 214, 144, -3, -3, -2.356194490192345, 4.242640687119285
88, 18, 602, 242, 601, 243, 1, -1, -0.7853981633974483, 1.4142135623730951
88, 19, 307, 225, 310, 226, -3, -1, -2.819842099193151, 3.1622776601683795
88, 20, 238, 270, 241, 271, -3, -1, -2.819842099193151, 3.1622776601683795
88, 21, 170, 139, 173, 142, -3, -3, -2.356194490192345, 4.242640687119285
88, 23, 598, 169, 598, 171, 0, -2, -1.5707963267948966, 2.0
88, 24, 355, 269, 358, 271, -3, -2, -2.5535900500422257, 3.605551275463989
88, 25, 116, 166, 121, 169, -5, -3, -2.601173153319209, 5.830951894845301
88, 26, 270, 124, 273, 126, -3, -2, -2.5535900500422257, 3.605551275463989
88, 28, 100, 165, 104, 167, -4, -2, -2.677945044588987, 4.47213595499958
88, 29, 599, 194, 601, 197, -2, -3, -2.158798930342464, 3.605551275463989
88, 30, 247, 291, 250, 292, -3, -1, -2.819842099193151, 3.1622776601683795
88, 31, 357, 311, 359, 313, -2, -2, -2.356194490192345, 2.8284271247461903
88, 32, 443, 211, 443, 213, 0, -2, -1.5707963267948966, 2.0
88, 33, 465, 183, 467, 185, -2, -2, -2.356194490192345, 2.8284271247461903
88, 34, 550, 143, 549, 147, 1, -4, -1.3258176636680326, 4.123105625617661
88, 35, 196, 206, 200, 208, -4, -2, -2.677945044588987, 4.47213595499958
88, 36, 83, 290, 87, 291, -4, -1, -2.896613990462929, 4.123105625617661
88, 37, 55, 367, 57, 367, -2, 0, 3.141592653589793, 2.0
88, 38, 496, 130, 499, 132, -3, -2, -2.5535900500422257, 3.605551275463989
88, 39, 91, 141, 94, 143, -3, -2, -2.5535900500422257, 3.605551275463989
88, 40, 412, 288, 416, 292, -4, -4, -2.356194490192345, 5.656854249492381
88, 41, 528, 295, 528, 297, 0, -2, -1.5707963267948966, 2.0
88, 42, 549, 107, 547, 107, 2, 0, 0.0, 2.0
88, 44, 91, 366, 94, 366, -3, 0, 3.141592653589793, 3.0
88, 45, 37, 213, 40, 215, -3, -2, -2.5535900500422257, 3.605551275463989
88, 46, 208, 110, 210, 110, -2, 0, 3.141592653589793, 2.0
88, 47, 542, 363, 541, 364, 1, -1, -0.7853981633974483, 1.4142135623730951
88, 48, 488, 258, 488, 261, 0, -3, -1.5707963267948966, 3.0
88, 49, 504, 197, 504, 200, 0, -3, -1.5707963267948966, 3.0
88, 50, 320, 186, 324, 187, -4, -1, -2.896613990462929, 4.123105625617661
88, 51, 308, 336, 311, 337, -3, -1, -2.819842099193151, 3.1622776601683795
88, 52, 256, 133, 259, 136, -3, -3, -2.356194490192345, 4.242640687119285
88, 53, 554, 123, 555, 125, -1, -2, -2.0344439357957027, 2.23606797749979
88, 54, 586, 241, 584, 243, 2, -2, -0.7853981633974483, 2.8284271247461903
88, 55, 31, 231, 31, 233, 0, -2, -1.5707963267948966, 2.0
88, 56, 432, 300, 437, 302, -5, -2, -2.761086276477428, 5.385164807134504
88, 57, 113, 338, 117, 338, -4, 0, 3.141592653589793, 4.0
88, 58, 373, 271, 375, 272, -2, -1, -2.677945044588987, 2.23606797749979
88, 59, 522, 274, 519, 277, 3, -3, -0.7853981633974483, 4.242640687119285
88, 60, 495, 174, 494, 178, 1, -4, -1.3258176636680326, 4.123105625617661
88, 61, 606, 197, 607, 200, -1, -3, -1.892546881191539, 3.1622776601683795
88, 62, 358, 226, 361, 228, -3, -2, -2.5535900500422257, 3.605551275463989
88, 63, 403, 188, 406, 190, -3, -2, -2.5535900500422257, 3.605551275463989
88, 65, 51, 224, 54, 226, -3, -2, -2.5535900500422257, 3.605551275463989
88, 67, 89, 213, 92, 215, -3, -2, -2.5535900500422257, 3.605551275463989
88, 68, 234, 147, 236, 149, -2, -2, -2.356194490192345, 2.8284271247461903
88, 69, 592, 333, 590, 333, 2, 0, 0.0, 2.0
88, 70, 432, 131, 434, 136, -2, -5, -1.9513027039072615, 5.385164807134504
88, 71, 414, 121, 415, 123, -1, -2, -2.0344439357957027, 2.23606797749979
88, 73, 57, 254, 61, 255, -4, -1, -2.896613990462929, 4.123105625617661
88, 76, 586, 358, 583, 357, 3, 1, 0.3217505543966422, 3.1622776601683795
88, 77, 345, 216, 347, 218, -2, -2, -2.356194490192345, 2.8284271247461903
88, 79, 50, 190, 53, 191, -3, -1, -2.819842099193151, 3.1622776601683795
88, 80, 67, 133, 69, 134, -2, -1, -2.677945044588987, 2.23606797749979
88, 81, 437, 195, 439, 197, -2, -2, -2.356194490192345, 2.8284271247461903
88, 82, 293, 223, 297, 225, -4, -2, -2.677945044588987, 4.47213595499958
88, 83, 484, 207, 484, 211, 0, -4, -1.5707963267948966, 4.0
88, 84, 58, 174, 60, 175, -2, -1, -2.677945044588987, 2.23606797749979
88, 86, 323, 260, 326, 262, -3, -2, -2.5535900500422257, 3.605551275463989
88, 87, 576, 135, 574, 138, 2, -3, -0.982793723247329, 3.605551275463989
88, 88, 37, 245, 39, 246, -2, -1, -2.677945044588987, 2.23606797749979
88, 89, 68, 211, 73, 213, -5, -2, -2.761086276477428, 5.385164807134504
88, 90, 120, 210, 123, 212, -3, -2, -2.5535900500422257, 3.605551275463989
88, 91, 387, 327, 391, 327, -4, 0, 3.141592653589793, 4.0
88, 92, 600, 307, 599, 308, 1, -1, -0.7853981633974483, 1.4142135623730951
88, 93, 185, 174, 187, 176, -2, -2, -2.356194490192345, 2.8284271247461903
88, 94, 307, 174, 309, 175, -2, -1, -2.677945044588987, 2.23606797749979
88, 95, 136, 265, 140, 266, -4, -1, -2.896613990462929, 4.123105625617661
88, 96, 166, 315, 169, 314, -3, 1, 2.819842099193151, 3.1622776601683795
88, 97, 144, 248, 148, 249, -4, -1, -2.896613990462929, 4.123105625617661
88, 98, 542, 155, 541, 159, 1, -4, -1.3258176636680326, 4.123105625617661
88, 99, 349, 115, 351, 117, -2, -2, -2.356194490192345, 2.8284271247461903
88, 100, 176, 366, 182, 367, -6, -1, -2.976443976175166, 6.082762530298219
88, 101, 34, 185, 33, 186, 1, -1, -0.7853981633974483, 1.4142135623730951
88, 102, 532, 170, 532, 172, 0, -2, -1.5707963267948966, 2.0
88, 103, 47, 243, 50, 244, -3, -1, -2.819842099193151, 3.1622776601683795
88, 104, 546, 238, 544, 241, 2, -3, -0.982793723247329, 3.605551275463989
88, 105, 571, 113, 571, 115, 0, -2, -1.5707963267948966, 2.0
88, 106, 129, 198, 132, 200, -3, -2, -2.5535900500422257, 3.605551275463989
88, 107, 289, 284, 293, 286, -4, -2, -2.677945044588987, 4.47213595499958
88, 108, 288, 120, 291, 121, -3, -1, -2.819842099193151, 3.1622776601683795
88, 109, 44, 234, 43, 233, 1, 1, 0.7853981633974483, 1.4142135623730951
88, 110, 105, 299, 109, 300, -4, -1, -2.896613990462929, 4.123105625617661
88, 111, 66, 271, 70, 272, -4, -1, -2.896613990462929, 4.123105625617661
88, 112, 415, 153, 416, 157, -1, -4, -1.8157749899217608, 4.123105625617661
88, 113, 38, 342, 40, 343, -2, -1, -2.677945044588987, 2.23606797749979
88, 115, 545, 206, 543, 209, 2, -3, -0.982793723247329, 3.605551275463989
88, 116, 341, 168, 343, 172, -2, -4, -2.0344439357957027, 4.47213595499958
88, 117, 497, 138, 496, 142, 1, -4, -1.3258176636680326, 4.123105625617661
88, 118, 207, 173, 210, 175, -3, -2, -2.5535900500422257, 3.605551275463989
88, 119, 132, 347, 136, 347, -4, 0, 3.141592653589793, 4.0
88, 120, 388, 262, 392, 263, -4, -1, -2.896613990462929, 4.123105625617661
88, 121, 515, 143, 514, 147, 1, -4, -1.3258176636680326, 4.123105625617661
88, 122, 332, 135, 335, 139, -3, -4, -2.214297435588181, 5.0
88, 123, 90, 313, 93, 314, -3, -1, -2.819842099193151, 3.1622776601683795
88, 124, 504, 153, 503, 157, 1, -4, -1.3258176636680326, 4.123105625617661
88, 125, 572, 239, 571, 241, 1, -2, -1.1071487177940904, 2.23606797749979
88, 126, 569, 312, 567, 313, 2, -1, -0.4636476090008061, 2.23606797749979
88, 127, 145, 364, 147, 365, -2, -1, -2.677945044588987, 2.23606797749979
88, 128, 88, 191, 91, 193, -3, -2, -2.5535900500422257, 3.605551275463989
88, 129, 484, 135, 484, 139, 0, -4, -1.5707963267948966, 4.0
88, 130, 309, 355, 313, 356, -4, -1, -2.896613990462929, 4.123105625617661
88, 131, 51, 294, 55, 295, -4, -1, -2.896613990462929, 4.123105625617661
88, 132, 541, 354, 538, 353, 3, 1, 0.3217505543966422, 3.1622776601683795
88, 134, 336, 121, 338, 123, -2, -2, -2.356194490192345, 2.8284271247461903
88, 135, 167, 180, 169, 182, -2, -2, -2.356194490192345, 2.8284271247461903
88, 136, 359, 157, 359, 160, 0, -3, -1.5707963267948966, 3.0
88, 137, 74, 148, 76, 150, -2, -2, -2.356194490192345, 2.8284271247461903
88, 138, 68, 193, 71, 194, -3, -1, -2.819842099193151, 3.1622776601683795
88, 139, 588, 186, 587, 189, 1, -3, -1.2490457723982544, 3.1622776601683795
88, 141, 393, 123, 395, 126, -2, -3, -2.158798930342464, 3.605551275463989
88, 142, 320, 151, 322, 153, -2, -2, -2.356194490192345, 2.8284271247461903
88, 144, 553, 175, 552, 179, 1, -4, -1.3258176636680326, 4.123105625617661
88, 145, 174, 348, 177, 349, -3, -1, -2.819842099193151, 3.1622776601683795
88, 146, 82, 164, 87, 166, -5, -2, -2.761086276477428, 5.385164807134504
88, 147, 604, 314, 603, 315, 1, -1, -0.7853981633974483, 1.4142135623730951
88, 149, 591, 148, 590, 151, 1, -3, -1.2490457723982544, 3.1622776601683795
88, 150, 215, 219, 218, 220, -3, -1, -2.819842099193151, 3.1622776601683795
88, 151, 257, 231, 261, 233, -4, -2, -2.677945044588987, 4.47213595499958
88, 152, 362, 355, 366, 355, -4, 0, 3.141592653589793, 4.0
88, 153, 136, 155, 138, 157, -2, -2, -2.356194490192345, 2.8284271247461903
88, 154, 395, 354, 398, 353, -3, 1, 2.819842099193151, 3.1622776601683795
88, 155, 278, 199, 282, 201, -4, -2, -2.677945044588987, 4.47213595499958
88, 156, 364, 293, 367, 295, -3, -2, -2.5535900500422257, 3.605551275463989
88, 157, 506, 261, 506, 263, 0, -2, -1.5707963267948966, 2.0
88, 158, 46, 252, 48, 253, -2, -1, -2.677945044588987, 2.23606797749979
88, 159, 566, 272, 562, 276, 4, -4, -0.7853981633974483, 5.656854249492381
88, 160, 474, 138, 474, 142, 0, -4, -1.5707963267948966, 4.0
88, 161, 183, 309, 186, 310, -3, -1, -2.819842099193151, 3.1622776601683795
88, 163, 107, 109, 109, 110, -2, -1, -2.677945044588987, 2.23606797749979
89, 0, 354, 198, 357, 202, -3, -4, -2.214297435588181, 5.0
89, 1, 54, 107, 57, 108, -3, -1, -2.819842099193151, 3.1622776601683795
89, 2, 280, 300, 282, 301, -2, -1, -2.677945044588987, 2.23606797749979
89, 3, 159, 210, 160, 212, -1, -2, -2.0344439357957027, 2.23606797749979
89, 4, 596, 304, 596, 306, 0, -2, -1.5707963267948966, 2.0
89, 5, 174, 330, 177, 331, -3, -1, -2.819842099193151, 3.1622776601683795
89, 6, 271, 215, 275, 218, -4, -3, -2.498091544796509, 5.0
89, 9, 419, 187, 421, 189, -2, -2, -2.356194490192345, 2.8284271247461903
89, 11, 355, 361, 358, 362, -3, -1, -2.819842099193151, 3.1622776601683795
89, 12, 310, 202, 311, 204, -1, -2, -2.0344439357957027, 2.23606797749979
89, 13, 86, 262, 88, 264, -2, -2, -2.356194490192345, 2.8284271247461903
89, 15, 208, 138, 211, 141, -3, -3, -2.356194490192345, 4.242640687119285
89, 16, 44, 358, 47, 358, -3, 0, 3.141592653589793, 3.0
89, 17, 602, 240, 602, 242, 0, -2, -1.5707963267948966, 2.0
89, 18, 304, 223, 307, 225, -3, -2, -2.5535900500422257, 3.605551275463989
89, 19, 235, 268, 238, 270, -3, -2, -2.5535900500422257, 3.605551275463989
89, 20, 166, 136, 170, 139, -4, -3, -2.498091544796509, 5.0
89, 21, 247, 112, 249, 112, -2, 0, 3.141592653589793, 2.0
89, 22, 598, 167, 598, 169, 0, -2, -1.5707963267948966, 2.0
89, 23, 353, 266, 355, 269, -2, -3, -2.158798930342464, 3.605551275463989
89, 24, 113, 166, 116, 166, -3, 0, 3.141592653589793, 3.0
89, 25, 266, 123, 270, 124, -4, -1, -2.896613990462929, 4.123105625617661
89, 26, 38, 169, 40, 171, -2, -2, -2.356194490192345, 2.8284271247461903
89, 27, 96, 163, 100, 165, -4, -2, -2.677945044588987, 4.47213595499958
89, 28, 598, 192, 599, 194, -1, -2, -2.0344439357957027, 2.23606797749979
89, 29, 356, 308, 357, 311, -1, -3, -1.892546881191539, 3.1622776601683795
89, 30, 442, 208, 443, 211, -1, -3, -1.892546881191539, 3.1622776601683795
89, 32, 550, 140, 550, 143, 0, -3, -1.5707963267948966, 3.0
89, 33, 193, 205, 196, 206, -3, -1, -2.819842099193151, 3.1622776601683795
89, 34, 79, 287, 83, 290, -4, -3, -2.498091544796509, 5.0
89, 35, 53, 366, 55, 367, -2, -1, -2.677945044588987, 2.23606797749979
89, 36, 496, 128, 496, 130, 0, -2, -1.5707963267948966, 2.0
89, 37, 87, 139, 91, 141, -4, -2, -2.677945044588987, 4.47213595499958
89, 38, 531, 293, 528, 295, 3, -2, -0.5880026035475675, 3.605551275463989
89, 40, 88, 365, 91, 366, -3, -1, -2.819842099193151, 3.1622776601683795
89, 41, 206, 110, 208, 110, -2, 0, 3.141592653589793, 2.0
89, 43, 488, 252, 488, 258, 0, -6, -1.5707963267948966, 6.0
89, 45, 315, 182, 320, 186, -5, -4, -2.4668517113662407, 6.4031242374328485
89, 47, 253, 130, 256, 133, -3, -3, -2.356194490192345, 4.242640687119285
89, 48, 553, 121, 554, 123, -1, -2, -2.0344439357957027, 2.23606797749979
89, 49, 586, 239, 586, 241, 0, -2, -1.5707963267948966, 2.0
89, 51, 430, 299, 432, 300, -2, -1, -2.677945044588987, 2.23606797749979
89, 52, 109, 338, 113, 338, -4, 0, 3.141592653589793, 4.0
89, 53, 371, 270, 373, 271, -2, -1, -2.677945044588987, 2.23606797749979
89, 54, 525, 270, 522, 274, 3, -4, -0.9272952180016122, 5.0
89, 55, 495, 171, 495, 174, 0, -3, -1.5707963267948966, 3.0
89, 57, 356, 225, 358, 226, -2, -1, -2.677945044588987, 2.23606797749979
89, 58, 401, 187, 403, 188, -2, -1, -2.677945044588987, 2.23606797749979
89, 60, 452, 104, 451, 105, 1, -1, -0.7853981633974483, 1.4142135623730951
89, 61, 85, 212, 89, 213, -4, -1, -2.896613990462929, 4.123105625617661
89, 62, 232, 143, 234, 147, -2, -4, -2.0344439357957027, 4.47213595499958
89, 63, 595, 333, 592, 333, 3, 0, 0.0, 3.0
89, 64, 430, 127, 432, 131, -2, -4, -2.0344439357957027, 4.47213595499958
89, 65, 413, 118, 414, 121, -1, -3, -1.892546881191539, 3.1622776601683795
89, 67, 52, 253, 57, 254, -5, -1, -2.9441970937399127, 5.0990195135927845
89, 68, 39, 333, 38, 334, 1, -1, -0.7853981633974483, 1.4142135623730951
89, 69, 589, 359, 586, 358, 3, 1, 0.3217505543966422, 3.1622776601683795
89, 70, 342, 214, 345, 216, -3, -2, -2.5535900500422257, 3.605551275463989
89, 72, 65, 131, 67, 133, -2, -2, -2.356194490192345, 2.8284271247461903
89, 73, 435, 194, 437, 195, -2, -1, -2.677945044588987, 2.23606797749979
89, 74, 291, 222, 293, 223, -2, -1, -2.677945044588987, 2.23606797749979
89, 75, 484, 203, 484, 207, 0, -4, -1.5707963267948966, 4.0
89, 76, 56, 173, 58, 174, -2, -1, -2.677945044588987, 2.23606797749979
89, 77, 74, 115, 77, 116, -3, -1, -2.819842099193151, 3.1622776601683795
89, 78, 321, 259, 323, 260, -2, -1, -2.677945044588987, 2.23606797749979
89, 79, 577, 131, 576, 135, 1, -4, -1.3258176636680326, 4.123105625617661
89, 80, 64, 210, 68, 211, -4, -1, -2.896613990462929, 4.123105625617661
89, 81, 117, 210, 120, 210, -3, 0, 3.141592653589793, 3.0
89, 82, 383, 328, 387, 327, -4, 1, 2.896613990462929, 4.123105625617661
89, 83, 601, 306, 600, 307, 1, -1, -0.7853981633974483, 1.4142135623730951
89, 84, 181, 172, 185, 174, -4, -2, -2.677945044588987, 4.47213595499958
89, 85, 305, 173, 307, 174, -2, -1, -2.677945044588987, 2.23606797749979
89, 86, 132, 264, 136, 265, -4, -1, -2.896613990462929, 4.123105625617661
89, 87, 164, 314, 166, 315, -2, -1, -2.677945044588987, 2.23606797749979
89, 88, 143, 246, 144, 248, -1, -2, -2.0344439357957027, 2.23606797749979
89, 89, 542, 151, 542, 155, 0, -4, -1.5707963267948966, 4.0
89, 90, 347, 114, 349, 115, -2, -1, -2.677945044588987, 2.23606797749979
89, 91, 172, 366, 176, 366, -4, 0, 3.141592653589793, 4.0
89, 93, 533, 168, 532, 170, 1, -2, -1.1071487177940904, 2.23606797749979
89, 94, 45, 242, 47, 243, -2, -1, -2.677945044588987, 2.23606797749979
89, 95, 546, 236, 546, 238, 0, -2, -1.5707963267948966, 2.0
89, 96, 572, 112, 571, 113, 1, -1, -0.7853981633974483, 1.4142135623730951
89, 97, 125, 197, 129, 198, -4, -1, -2.896613990462929, 4.123105625617661
89, 100, 62, 270, 66, 271, -4, -1, -2.896613990462929, 4.123105625617661
89, 101, 413, 153, 415, 153, -2, 0, 3.141592653589793, 2.0
89, 102, 37, 340, 38, 342, -1, -2, -2.0344439357957027, 2.23606797749979
89, 103, 165, 106, 167, 106, -2, 0, 3.141592653589793, 2.0
89, 104, 547, 202, 545, 206, 2, -4, -1.1071487177940904, 4.47213595499958
89, 105, 340, 166, 341, 168, -1, -2, -2.0344439357957027, 2.23606797749979
89, 106, 498, 133, 497, 138, 1, -5, -1.373400766945016, 5.0990195135927845
89, 107, 204, 171, 207, 173, -3, -2, -2.5535900500422257, 3.605551275463989
89, 108, 130, 346, 132, 347, -2, -1, -2.677945044588987, 2.23606797749979
89, 109, 386, 260, 388, 262, -2, -2, -2.356194490192345, 2.8284271247461903
89, 111, 329, 134, 332, 135, -3, -1, -2.819842099193151, 3.1622776601683795
89, 112, 87, 312, 90, 313, -3, -1, -2.819842099193151, 3.1622776601683795
89, 113, 504, 149, 504, 153, 0, -4, -1.5707963267948966, 4.0
89, 114, 574, 237, 572, 239, 2, -2, -0.7853981633974483, 2.8284271247461903
89, 115, 571, 311, 569, 312, 2, -1, -0.4636476090008061, 2.23606797749979
89, 116, 141, 364, 145, 364, -4, 0, 3.141592653589793, 4.0
89, 117, 85, 188, 88, 191, -3, -3, -2.356194490192345, 4.242640687119285
89, 118, 484, 131, 484, 135, 0, -4, -1.5707963267948966, 4.0
89, 119, 307, 354, 309, 355, -2, -1, -2.677945044588987, 2.23606797749979
89, 120, 47, 293, 51, 294, -4, -1, -2.896613990462929, 4.123105625617661
89, 121, 543, 354, 541, 354, 2, 0, 0.0, 2.0
89, 123, 337, 120, 336, 121, 1, -1, -0.7853981633974483, 1.4142135623730951
89, 124, 164, 177, 167, 180, -3, -3, -2.356194490192345, 4.242640687119285
89, 125, 358, 154, 359, 157, -1, -3, -1.892546881191539, 3.1622776601683795
89, 126, 71, 146, 74, 148, -3, -2, -2.5535900500422257, 3.605551275463989
89, 127, 64, 192, 68, 193, -4, -1, -2.896613990462929, 4.123105625617661
89, 128, 585, 183, 588, 186, -3, -3, -2.356194490192345, 4.242640687119285
89, 130, 390, 119, 393, 123, -3, -4, -2.214297435588181, 5.0
89, 131, 540, 147, 538, 150, 2, -3, -0.982793723247329, 3.605551275463989
89, 133, 172, 346, 174, 348, -2, -2, -2.356194490192345, 2.8284271247461903
89, 134, 81, 161, 82, 164, -1, -3, -1.892546881191539, 3.1622776601683795
89, 136, 590, 145, 591, 148, -1, -3, -1.892546881191539, 3.1622776601683795
89, 137, 213, 217, 215, 219, -2, -2, -2.356194490192345, 2.8284271247461903
89, 138, 250, 229, 257, 231, -7, -2, -2.8632929945846817, 7.280109889280518
89, 139, 361, 353, 362, 355, -1, -2, -2.0344439357957027, 2.23606797749979
89, 140, 133, 152, 136, 155, -3, -3, -2.356194490192345, 4.242640687119285
89, 141, 393, 354, 395, 354, -2, 0, 3.141592653589793, 2.0
89, 142, 361, 291, 364, 293, -3, -2, -2.5535900500422257, 3.605551275463989
89, 144, 569, 271, 566, 272, 3, -1, -0.3217505543966422, 3.1622776601683795
89, 145, 474, 133, 474, 138, 0, -5, -1.5707963267948966, 5.0
89, 146, 180, 309, 183, 309, -3, 0, 3.141592653589793, 3.0
89, 148, 104, 108, 107, 109, -3, -1, -2.819842099193151, 3.1622776601683795
90, 0, 357, 204, 361, 207, -4, -3, -2.498091544796509, 5.0
90, 1, 176, 331, 180, 331, -4, 0, 3.141592653589793, 4.0
90, 2, 423, 190, 426, 194, -3, -4, -2.214297435588181, 5.0
90, 4, 91, 268, 96, 269, -5, -1, -2.9441970937399127, 5.0990195135927845
90, 5, 34, 365, 36, 366, -2, -1, -2.677945044588987, 2.23606797749979
90, 6, 375, 155, 377, 159, -2, -4, -2.0344439357957027, 4.47213595499958
90, 7, 282, 305, 287, 306, -5, -1, -2.9441970937399127, 5.0990195135927845
90, 9, 45, 360, 50, 360, -5, 0, 3.141592653589793, 5.0
90, 10, 276, 220, 280, 223, -4, -3, -2.498091544796509, 5.0
90, 11, 212, 146, 216, 148, -4, -2, -2.677945044588987, 4.47213595499958
90, 12, 410, 127, 412, 130, -2, -3, -2.158798930342464, 3.605551275463989
90, 13, 442, 213, 444, 216, -2, -3, -2.158798930342464, 3.605551275463989
90, 14, 311, 209, 314, 212, -3, -3, -2.356194490192345, 4.242640687119285
90, 15, 596, 333, 593, 333, 3, 0, 0.0, 3.0
90, 16, 161, 216, 165, 218, -4, -2, -2.677945044588987, 4.47213595499958
90, 17, 578, 112, 578, 114, 0, -2, -1.5707963267948966, 2.0
90, 19, 60, 111, 63, 113, -3, -2, -2.5535900500422257, 3.605551275463989
90, 20, 357, 275, 362, 278, -5, -3, -2.601173153319209, 5.830951894845301
90, 21, 256, 135, 260, 138, -4, -3, -2.498091544796509, 5.0
90, 22, 85, 292, 90, 293, -5, -1, -2.9441970937399127, 5.0990195135927845
90, 23, 432, 127, 434, 131, -2, -4, -2.0344439357957027, 4.47213595499958
90, 24, 480, 139, 480, 144, 0, -5, -1.5707963267948966, 5.0
90, 25, 597, 199, 599, 200, -2, -1, -2.677945044588987, 2.23606797749979
90, 27, 272, 130, 276, 134, -4, -4, -2.356194490192345, 5.656854249492381
90, 28, 104, 169, 108, 172, -4, -3, -2.498091544796509, 5.0
90, 29, 35, 170, 37, 171, -2, -1, -2.677945044588987, 2.23606797749979
90, 30, 39, 245, 41, 246, -2, -1, -2.677945044588987, 2.23606797749979
90, 31, 491, 259, 490, 263, 1, -4, -1.3258176636680326, 4.123105625617661
90, 32, 121, 171, 124, 173, -3, -2, -2.5535900500422257, 3.605551275463989
90, 33, 169, 110, 171, 111, -2, -1, -2.677945044588987, 2.23606797749979
90, 34, 361, 366, 364, 367, -3, -1, -2.819842099193151, 3.1622776601683795
90, 35, 309, 230, 314, 233, -5, -3, -2.601173153319209, 5.830951894845301
90, 36, 434, 305, 437, 307, -3, -2, -2.5535900500422257, 3.605551275463989
90, 37, 415, 293, 418, 296, -3, -3, -2.356194490192345, 4.242640687119285
90, 38, 181, 366, 185, 367, -4, -1, -2.896613990462929, 4.123105625617661
90, 39, 561, 123, 559, 128, 2, -5, -1.1902899496825317, 5.385164807134504
90, 40, 589, 111, 589, 113, 0, -2, -1.5707963267948966, 2.0
90, 41, 591, 189, 590, 192, 1, -3, -1.2490457723982544, 3.1622776601683795
90, 42, 551, 145, 550, 149, 1, -4, -1.3258176636680326, 4.123105625617661
90, 43, 601, 245, 600, 246, 1, -1, -0.7853981633974483, 1.4142135623730951
90, 44, 501, 130, 501, 135, 0, -5, -1.5707963267948966, 5.0
90, 45, 581, 241, 579, 243, 2, -2, -0.7853981633974483, 2.8284271247461903
90, 46, 601, 171, 599, 174, 2, -3, -0.982793723247329, 3.605551275463989
90, 47, 569, 366, 567, 367, 2, -1, -0.4636476090008061, 2.23606797749979
90, 49, 587, 133, 586, 137, 1, -4, -1.3258176636680326, 4.123105625617661
90, 50, 402, 368, 404, 369, -2, -1, -2.677945044588987, 2.23606797749979
90, 51, 111, 112, 113, 114, -2, -2, -2.356194490192345, 2.8284271247461903
90, 52, 525, 274, 522, 277, 3, -3, -0.7853981633974483, 4.242640687119285
90, 53, 56, 367, 61, 368, -5, -1, -2.9441970937399127, 5.0990195135927845
90, 54, 35, 306, 35, 308, 0, -2, -1.5707963267948966, 2.0
90, 55, 357, 317, 362, 318, -5, -1, -2.9441970937399127, 5.0990195135927845
90, 56, 42, 330, 46, 331, -4, -1, -2.896613990462929, 4.123105625617661
90, 58, 352, 111, 355, 114, -3, -3, -2.356194490192345, 4.242640687119285
90, 59, 251, 295, 255, 296, -4, -1, -2.896613990462929, 4.123105625617661
90, 60, 592, 311, 591, 312, 1, -1, -0.7853981633974483, 1.4142135623730951
90, 61, 592, 150, 590, 154, 2, -4, -1.1071487177940904, 4.47213595499958
90, 62, 49, 224, 53, 225, -4, -1, -2.896613990462929, 4.123105625617661
90, 63, 171, 141, 175, 143, -4, -2, -2.677945044588987, 4.47213595499958
90, 64, 397, 356, 402, 355, -5, 1, 2.9441970937399127, 5.0990195135927845
90, 65, 92, 315, 97, 315, -5, 0, 3.141592653589793, 5.0
90, 66, 240, 276, 245, 278, -5, -2, -2.761086276477428, 5.385164807134504
90, 67, 200, 207, 204, 210, -4, -3, -2.498091544796509, 5.0
90, 68, 176, 350, 180, 350, -4, 0, 3.141592653589793, 4.0
90, 69, 291, 118, 294, 121, -3, -3, -2.356194490192345, 4.242640687119285
90, 70, 543, 366, 542, 367, 1, -1, -0.7853981633974483, 1.4142135623730951
90, 71, 587, 360, 584, 359, 3, 1, 0.3217505543966422, 3.1622776601683795
90, 72, 316, 320, 321, 321, -5, -1, -2.9441970937399127, 5.0990195135927845
90, 74, 323, 261, 328, 264, -5, -3, -2.601173153319209, 5.830951894845301
90, 75, 572, 145, 570, 149, 2, -4, -1.1071487177940904, 4.47213595499958
90, 76, 333, 137, 336, 140, -3, -3, -2.356194490192345, 4.242640687119285
90, 77, 485, 206, 485, 211, 0, -5, -1.5707963267948966, 5.0
90, 78, 358, 227, 361, 230, -3, -3, -2.356194490192345, 4.242640687119285
90, 79, 113, 172, 116, 173, -3, -1, -2.819842099193151, 3.1622776601683795
90, 80, 602, 265, 602, 267, 0, -2, -1.5707963267948966, 2.0
90, 81, 56, 315, 61, 315, -5, 0, 3.141592653589793, 5.0
90, 82, 121, 212, 126, 214, -5, -2, -2.761086276477428, 5.385164807134504
90, 83, 236, 147, 239, 150, -3, -3, -2.356194490192345, 4.242640687119285
90, 84, 51, 191, 55, 193, -4, -2, -2.677945044588987, 4.47213595499958
90, 85, 405, 189, 408, 193, -3, -4, -2.214297435588181, 5.0
90, 86, 72, 194, 76, 196, -4, -2, -2.677945044588987, 4.47213595499958
90, 87, 128, 173, 132, 174, -4, -1, -2.896613990462929, 4.123105625617661
90, 88, 468, 183, 469, 187, -1, -4, -1.8157749899217608, 4.123105625617661
90, 89, 437, 196, 439, 199, -2, -3, -2.158798930342464, 3.605551275463989
90, 90, 40, 216, 42, 217, -2, -1, -2.677945044588987, 2.23606797749979
90, 91, 71, 134, 74, 137, -3, -3, -2.356194490192345, 4.242640687119285
90, 92, 169, 180, 173, 183, -4, -3, -2.498091544796509, 5.0
90, 94, 217, 221, 220, 223, -3, -2, -2.5535900500422257, 3.605551275463989
90, 95, 146, 249, 150, 251, -4, -2, -2.677945044588987, 4.47213595499958
90, 96, 595, 161, 596, 163, -1, -2, -2.0344439357957027, 2.23606797749979
90, 100, 295, 222, 300, 225, -5, -3, -2.601173153319209, 5.830951894845301
90, 101, 102, 266, 106, 266, -4, 0, 3.141592653589793, 4.0
90, 102, 604, 236, 604, 238, 0, -2, -1.5707963267948966, 2.0
90, 103, 131, 113, 135, 116, -4, -3, -2.498091544796509, 5.0
90, 104, 344, 217, 347, 220, -3, -3, -2.356194490192345, 4.242640687119285
90, 105, 76, 212, 80, 215, -4, -3, -2.498091544796509, 5.0
90, 106, 191, 266, 195, 268, -4, -2, -2.677945044588987, 4.47213595499958
90, 107, 393, 186, 395, 190, -2, -4, -2.0344439357957027, 4.47213595499958
90, 108, 374, 272, 378, 274, -4, -2, -2.677945044588987, 4.47213595499958
90, 109, 117, 338, 120, 339, -3, -1, -2.819842099193151, 3.1622776601683795
90, 110, 504, 152, 504, 157, 0, -5, -1.5707963267948966, 5.0
90, 111, 46, 254, 51, 255, -5, -1, -2.9441970937399127, 5.0990195135927845
90, 112, 95, 289, 99, 289, -4, 0, 3.141592653589793, 4.0
90, 113, 92, 148, 97, 150, -5, -2, -2.761086276477428, 5.385164807134504
90, 114, 93, 366, 98, 367, -5, -1, -2.9441970937399127, 5.0990195135927845
90, 115, 54, 343, 59, 343, -5, 0, 3.141592653589793, 5.0
90, 116, 357, 159, 360, 162, -3, -3, -2.356194490192345, 4.242640687119285
90, 117, 78, 116, 81, 117, -3, -1, -2.819842099193151, 3.1622776601683795
90, 118, 60, 175, 64, 177, -4, -2, -2.677945044588987, 4.47213595499958
90, 119, 310, 337, 315, 338, -5, -1, -2.9441970937399127, 5.0990195135927845
90, 120, 425, 247, 428, 251, -3, -4, -2.214297435588181, 5.0
90, 121, 547, 207, 545, 210, 2, -3, -0.982793723247329, 3.605551275463989
90, 122, 365, 358, 369, 357, -4, 1, 2.896613990462929, 4.123105625617661
90, 123, 592, 264, 591, 266, 1, -2, -1.1071487177940904, 2.23606797749979
90, 124, 201, 316, 205, 316, -4, 0, 3.141592653589793, 4.0
90, 125, 149, 167, 154, 170, -5, -3, -2.601173153319209, 5.830951894845301
90, 126, 101, 148, 105, 150, -4, -2, -2.677945044588987, 4.47213595499958
90, 127, 518, 160, 518, 164, 0, -4, -1.5707963267948966, 4.0
90, 128, 564, 278, 562, 280, 2, -2, -0.7853981633974483, 2.8284271247461903
90, 129, 185, 330, 188, 329, -3, 1, 2.819842099193151, 3.1622776601683795
90, 130, 55, 272, 59, 273, -4, -1, -2.896613990462929, 4.123105625617661
90, 131, 136, 157, 140, 159, -4, -2, -2.677945044588987, 4.47213595499958
90, 132, 339, 120, 341, 123, -2, -3, -2.158798930342464, 3.605551275463989
90, 133, 108, 301, 112, 302, -4, -1, -2.896613990462929, 4.123105625617661
90, 134, 53, 295, 57, 296, -4, -1, -2.896613990462929, 4.123105625617661
90, 135, 416, 158, 418, 161, -2, -3, -2.158798930342464, 3.605551275463989
90, 136, 548, 238, 546, 242, 2, -4, -1.1071487177940904, 4.47213595499958
90, 137, 261, 234, 265, 236, -4, -2, -2.677945044588987, 4.47213595499958
90, 138, 533, 173, 532, 177, 1, -4, -1.3258176636680326, 4.123105625617661
90, 139, 453, 136, 454, 142, -1, -6, -1.7359450042095235, 6.082762530298219
90, 142, 260, 275, 264, 276, -4, -1, -2.896613990462929, 4.123105625617661
90, 143, 508, 196, 507, 201, 1, -5, -1.373400766945016, 5.0990195135927845
90, 144, 545, 358, 543, 358, 2, 0, 0.0, 2.0
90, 145, 324, 186, 327, 189, -3, -3, -2.356194490192345, 4.242640687119285
90, 146, 179, 146, 182, 148, -3, -2, -2.5535900500422257, 3.605551275463989
90, 147, 134, 348, 138, 348, -4, 0, 3.141592653589793, 4.0
90, 148, 197, 294, 201, 295, -4, -1, -2.896613990462929, 4.123105625617661
90, 149, 538, 257, 537, 261, 1, -4, -1.3258176636680326, 4.123105625617661
90, 150, 387, 327, 393, 327, -6, 0, 3.141592653589793, 6.0
90, 151, 426, 231, 428, 236, -2, -5, -1.9513027039072615, 5.385164807134504
90, 152, 314, 358, 317, 358, -3, 0, 3.141592653589793, 3.0
90, 153, 542, 298, 540, 300, 2, -2, -0.7853981633974483, 2.8284271247461903
90, 154, 68, 253, 73, 255, -5, -2, -2.761086276477428, 5.385164807134504
90, 155, 89, 191, 93, 194, -4, -3, -2.498091544796509, 5.0
90, 156, 117, 127, 121, 130, -4, -3, -2.498091544796509, 5.0
90, 157, 123, 139, 127, 142, -4, -3, -2.498091544796509, 5.0
90, 158, 183, 126, 186, 128, -3, -2, -2.5535900500422257, 3.605551275463989
90, 159, 76, 178, 80, 180, -4, -2, -2.677945044588987, 4.47213595499958
90, 160, 223, 169, 228, 172, -5, -3, -2.601173153319209, 5.830951894845301
90, 161, 85, 164, 90, 167, -5, -3, -2.601173153319209, 5.830951894845301
90, 162, 153, 285, 157, 285, -4, 0, 3.141592653589793, 4.0
90, 163, 335, 246, 340, 248, -5, -2, -2.761086276477428, 5.385164807134504
90, 164, 97, 111, 100, 111, -3, 0, 3.141592653589793, 3.0
90, 165, 578, 317, 574, 318, 4, -1, -0.24497866312686414, 4.123105625617661
90, 166, 387, 222, 390, 225, -3, -3, -2.356194490192345, 4.242640687119285
90, 167, 382, 110, 383, 112, -1, -2, -2.0344439357957027, 2.23606797749979
90, 168, 137, 323, 142, 324, -5, -1, -2.9441970937399127, 5.0990195135927845
90, 169, 538, 354, 536, 354, 2, 0, 0.0, 2.0
90, 170, 118, 194, 122, 197, -4, -3, -2.498091544796509, 5.0
90, 171, 68, 115, 71, 116, -3, -1, -2.819842099193151, 3.1622776601683795
90, 172, 129, 211, 133, 213, -4, -2, -2.677945044588987, 4.47213595499958
90, 173, 46, 234, 45, 235, 1, -1, -0.7853981633974483, 1.4142135623730951
90, 174, 401, 224, 405, 227, -4, -3, -2.498091544796509, 5.0
90, 175, 389, 264, 393, 267, -4, -3, -2.498091544796509, 5.0
90, 176, 341, 170, 344, 174, -3, -4, -2.214297435588181, 5.0
90, 177, 76, 150, 80, 153, -4, -3, -2.498091544796509, 5.0
90, 178, 569, 115, 568, 117, 1, -2, -1.1071487177940904, 2.23606797749979
90, 179, 366, 295, 371, 297, -5, -2, -2.761086276477428, 5.385164807134504
90, 180, 144, 330, 148, 330, -4, 0, 3.141592653589793, 4.0
90, 181, 274, 336, 280, 337, -6, -1, -2.976443976175166, 6.082762530298219
90, 182, 328, 169, 331, 173, -3, -4, -2.214297435588181, 5.0
90, 183, 544, 160, 543, 164, 1, -4, -1.3258176636680326, 4.123105625617661
90, 184, 478, 245, 478, 249, 0, -4, -1.5707963267948966, 4.0
90, 185, 573, 342, 570, 341, 3, 1, 0.3217505543966422, 3.1622776601683795
90, 186, 436, 280, 440, 283, -4, -3, -2.498091544796509, 5.0
90, 187, 584, 188, 582, 192, 2, -4, -1.1071487177940904, 4.47213595499958
90, 188, 391, 248, 394, 251, -3, -3, -2.356194490192345, 4.242640687119285
90, 189, 555, 177, 554, 181, 1, -4, -1.3258176636680326, 4.123105625617661
90, 191, 206, 174, 209, 176, -3, -2, -2.5535900500422257, 3.605551275463989
90, 192, 221, 274, 226, 275, -5, -1, -2.9441970937399127, 5.0990195135927845
91, 0, 354, 201, 357, 204, -3, -3, -2.356194490192345, 4.242640687119285
91, 1, 172, 331, 176, 331, -4, 0, 3.141592653589793, 4.0
91, 2, 420, 185, 423, 190, -3, -5, -2.1112158270654806, 5.830951894845301
91, 3, 598, 310, 598, 312, 0, -2, -1.5707963267948966, 2.0
91, 4, 87, 266, 91, 268, -4, -2, -2.677945044588987, 4.47213595499958
91, 5, 373, 151, 375, 155, -2, -4, -2.0344439357957027, 4.47213595499958
91, 6, 278, 303, 282, 305, -4, -2, -2.677945044588987, 4.47213595499958
91, 7, 42, 360, 45, 360, -3, 0, 3.141592653589793, 3.0
91, 8, 272, 217, 276, 220, -4, -3, -2.498091544796509, 5.0
91, 9, 208, 143, 212, 146, -4, -3, -2.498091544796509, 5.0
91, 10, 409, 123, 410, 127, -1, -4, -1.8157749899217608, 4.123105625617661
91, 11, 440, 209, 442, 213, -2, -4, -2.0344439357957027, 4.47213595499958
91, 12, 307, 206, 311, 209, -4, -3, -2.498091544796509, 5.0
91, 13, 598, 334, 596, 333, 2, 1, 0.4636476090008061, 2.23606797749979
91, 14, 156, 214, 161, 216, -5, -2, -2.761086276477428, 5.385164807134504
91, 15, 579, 110, 578, 112, 1, -2, -1.1071487177940904, 2.23606797749979
91, 16, 465, 368, 465, 370, 0, -2, -1.5707963267948966, 2.0
91, 17, 58, 110, 60, 111, -2, -1, -2.677945044588987, 2.23606797749979
91, 18, 353, 273, 357, 275, -4, -2, -2.677945044588987, 4.47213595499958
91, 19, 253, 132, 256, 135, -3, -3, -2.356194490192345, 4.242640687119285
91, 20, 80, 290, 85, 292, -5, -2, -2.761086276477428, 5.385164807134504
91, 21, 430, 123, 432, 127, -2, -4, -2.0344439357957027, 4.47213595499958
91, 22, 480, 134, 480, 139, 0, -5, -1.5707963267948966, 5.0
91, 23, 594, 199, 597, 199, -3, 0, 3.141592653589793, 3.0
91, 25, 268, 127, 272, 130, -4, -3, -2.498091544796509, 5.0
91, 26, 99, 166, 104, 169, -5, -3, -2.601173153319209, 5.830951894845301
91, 27, 33, 169, 35, 170, -2, -1, -2.677945044588987, 2.23606797749979
91, 28, 37, 244, 39, 245, -2, -1, -2.677945044588987, 2.23606797749979
91, 29, 491, 255, 491, 259, 0, -4, -1.5707963267948966, 4.0
91, 30, 117, 169, 121, 171, -4, -2, -2.677945044588987, 4.47213595499958
91, 31, 167, 109, 169, 110, -2, -1, -2.677945044588987, 2.23606797749979
91, 32, 357, 365, 361, 366, -4, -1, -2.896613990462929, 4.123105625617661
91, 33, 305, 227, 309, 230, -4, -3, -2.498091544796509, 5.0
91, 34, 430, 303, 434, 305, -4, -2, -2.677945044588987, 4.47213595499958
91, 35, 412, 291, 415, 293, -3, -2, -2.5535900500422257, 3.605551275463989
91, 36, 177, 366, 181, 366, -4, 0, 3.141592653589793, 4.0
91, 37, 563, 118, 561, 123, 2, -5, -1.1902899496825317, 5.385164807134504
91, 38, 589, 109, 589, 111, 0, -2, -1.5707963267948966, 2.0
91, 39, 593, 185, 591, 189, 2, -4, -1.1071487177940904, 4.47213595499958
91, 40, 553, 140, 551, 145, 2, -5, -1.1902899496825317, 5.385164807134504
91, 41, 602, 244, 601, 245, 1, -1, -0.7853981633974483, 1.4142135623730951
91, 42, 502, 125, 501, 130, 1, -5, -1.373400766945016, 5.0990195135927845
91, 43, 583, 238, 581, 241, 2, -3, -0.982793723247329, 3.605551275463989
91, 44, 603, 168, 601, 171, 2, -3, -0.982793723247329, 3.605551275463989
91, 45, 571, 366, 569, 366, 2, 0, 0.0, 2.0
91, 47, 588, 129, 587, 133, 1, -4, -1.3258176636680326, 4.123105625617661
91, 48, 400, 367, 402, 368, -2, -1, -2.677945044588987, 2.23606797749979
91, 49, 108, 111, 111, 112, -3, -1, -2.819842099193151, 3.1622776601683795
91, 50, 527, 271, 525, 274, 2, -3, -0.982793723247329, 3.605551275463989
91, 51, 51, 366, 56, 367, -5, -1, -2.9441970937399127, 5.0990195135927845
91, 53, 351, 317, 357, 317, -6, 0, 3.141592653589793, 6.0
91, 54, 39, 330, 42, 330, -3, 0, 3.141592653589793, 3.0
91, 56, 351, 109, 352, 111, -1, -2, -2.0344439357957027, 2.23606797749979
91, 57, 246, 294, 251, 295, -5, -1, -2.9441970937399127, 5.0990195135927845
91, 59, 593, 147, 592, 150, 1, -3, -1.2490457723982544, 3.1622776601683795
91, 60, 46, 223, 49, 224, -3, -1, -2.819842099193151, 3.1622776601683795
91, 61, 167, 139, 171, 141, -4, -2, -2.677945044588987, 4.47213595499958
91, 62, 391, 358, 397, 356, -6, 2, 2.819842099193151, 6.324555320336759
91, 63, 86, 314, 92, 315, -6, -1, -2.976443976175166, 6.082762530298219
91, 64, 236, 275, 240, 276, -4, -1, -2.896613990462929, 4.123105625617661
91, 65, 196, 205, 200, 207, -4, -2, -2.677945044588987, 4.47213595499958
91, 66, 171, 350, 176, 350, -5, 0, 3.141592653589793, 5.0
91, 67, 289, 116, 291, 118, -2, -2, -2.356194490192345, 2.8284271247461903
91, 68, 544, 365, 543, 366, 1, -1, -0.7853981633974483, 1.4142135623730951
91, 69, 590, 361, 587, 360, 3, 1, 0.3217505543966422, 3.1622776601683795
91, 70, 310, 319, 316, 320, -6, -1, -2.976443976175166, 6.082762530298219
91, 72, 319, 259, 323, 261, -4, -2, -2.677945044588987, 4.47213595499958
91, 73, 573, 142, 572, 145, 1, -3, -1.2490457723982544, 3.1622776601683795
91, 74, 330, 133, 333, 137, -3, -4, -2.214297435588181, 5.0
91, 75, 485, 202, 485, 206, 0, -4, -1.5707963267948966, 4.0
91, 76, 356, 224, 358, 227, -2, -3, -2.158798930342464, 3.605551275463989
91, 77, 109, 171, 113, 172, -4, -1, -2.896613990462929, 4.123105625617661
91, 78, 602, 263, 602, 265, 0, -2, -1.5707963267948966, 2.0
91, 79, 52, 315, 56, 315, -4, 0, 3.141592653589793, 4.0
91, 80, 116, 209, 121, 212, -5, -3, -2.601173153319209, 5.830951894845301
91, 81, 233, 145, 236, 147, -3, -2, -2.5535900500422257, 3.605551275463989
91, 82, 49, 190, 51, 191, -2, -1, -2.677945044588987, 2.23606797749979
91, 83, 403, 185, 405, 189, -2, -4, -2.0344439357957027, 4.47213595499958
91, 84, 68, 192, 72, 194, -4, -2, -2.677945044588987, 4.47213595499958
91, 85, 124, 172, 128, 173, -4, -1, -2.896613990462929, 4.123105625617661
91, 86, 467, 179, 468, 183, -1, -4, -1.8157749899217608, 4.123105625617661
91, 87, 435, 194, 437, 196, -2, -2, -2.356194490192345, 2.8284271247461903
91, 88, 39, 214, 40, 216, -1, -2, -2.0344439357957027, 2.23606797749979
91, 89, 67, 132, 71, 134, -4, -2, -2.677945044588987, 4.47213595499958
91, 90, 164, 178, 169, 180, -5, -2, -2.761086276477428, 5.385164807134504
91, 92, 213, 218, 217, 221, -4, -3, -2.498091544796509, 5.0
91, 93, 142, 247, 146, 249, -4, -2, -2.677945044588987, 4.47213595499958
91, 94, 595, 158, 595, 161, 0, -3, -1.5707963267948966, 3.0
91, 95, 541, 149, 540, 152, 1, -3, -1.2490457723982544, 3.1622776601683795
91, 97, 603, 336, 602, 337, 1, -1, -0.7853981633974483, 1.4142135623730951
91, 98, 290, 219, 295, 222, -5, -3, -2.601173153319209, 5.830951894845301
91, 99, 99, 266, 102, 266, -3, 0, 3.141592653589793, 3.0
91, 100, 604, 234, 604, 236, 0, -2, -1.5707963267948966, 2.0
91, 101, 128, 111, 131, 113, -3, -2, -2.5535900500422257, 3.605551275463989
91, 102, 341, 214, 344, 217, -3, -3, -2.356194490192345, 4.242640687119285
91, 103, 70, 210, 76, 212, -6, -2, -2.819842099193151, 6.324555320336759
91, 104, 187, 265, 191, 266, -4, -1, -2.896613990462929, 4.123105625617661
91, 105, 391, 183, 393, 186, -2, -3, -2.158798930342464, 3.605551275463989
91, 106, 369, 269, 374, 272, -5, -3, -2.601173153319209, 5.830951894845301
91, 107, 114, 337, 117, 338, -3, -1, -2.819842099193151, 3.1622776601683795
91, 108, 505, 148, 504, 152, 1, -4, -1.3258176636680326, 4.123105625617661
91, 109, 43, 253, 46, 254, -3, -1, -2.819842099193151, 3.1622776601683795
91, 110, 92, 289, 95, 289, -3, 0, 3.141592653589793, 3.0
91, 111, 87, 145, 92, 148, -5, -3, -2.601173153319209, 5.830951894845301
91, 112, 89, 365, 93, 366, -4, -1, -2.896613990462929, 4.123105625617661
91, 113, 49, 343, 54, 343, -5, 0, 3.141592653589793, 5.0
91, 114, 354, 155, 357, 159, -3, -4, -2.214297435588181, 5.0
91, 115, 75, 115, 78, 116, -3, -1, -2.819842099193151, 3.1622776601683795
91, 116, 56, 174, 60, 175, -4, -1, -2.896613990462929, 4.123105625617661
91, 117, 306, 336, 310, 337, -4, -1, -2.896613990462929, 4.123105625617661
91, 118, 422, 244, 425, 247, -3, -3, -2.356194490192345, 4.242640687119285
91, 119, 549, 203, 547, 207, 2, -4, -1.1071487177940904, 4.47213595499958
91, 120, 362, 359, 365, 358, -3, 1, 2.819842099193151, 3.1622776601683795
91, 121, 593, 262, 592, 264, 1, -2, -1.1071487177940904, 2.23606797749979
91, 122, 196, 315, 201, 316, -5, -1, -2.9441970937399127, 5.0990195135927845
91, 123, 145, 164, 149, 167, -4, -3, -2.498091544796509, 5.0
91, 124, 96, 145, 101, 148, -5, -3, -2.601173153319209, 5.830951894845301
91, 125, 519, 157, 518, 160, 1, -3, -1.2490457723982544, 3.1622776601683795
91, 126, 566, 276, 564, 278, 2, -2, -0.7853981633974483, 2.8284271247461903
91, 127, 181, 329, 185, 330, -4, -1, -2.896613990462929, 4.123105625617661
91, 128, 51, 271, 55, 272, -4, -1, -2.896613990462929, 4.123105625617661
91, 129, 133, 155, 136, 157, -3, -2, -2.5535900500422257, 3.605551275463989
91, 130, 336, 118, 339, 120, -3, -2, -2.5535900500422257, 3.605551275463989
91, 131, 104, 300, 108, 301, -4, -1, -2.896613990462929, 4.123105625617661
91, 132, 49, 293, 53, 295, -4, -2, -2.677945044588987, 4.47213595499958
91, 133, 414, 154, 416, 158, -2, -4, -2.0344439357957027, 4.47213595499958
91, 134, 551, 234, 548, 238, 3, -4, -0.9272952180016122, 5.0
91, 135, 256, 231, 261, 234, -5, -3, -2.601173153319209, 5.830951894845301
91, 136, 534, 169, 533, 173, 1, -4, -1.3258176636680326, 4.123105625617661
91, 137, 451, 132, 453, 136, -2, -4, -2.0344439357957027, 4.47213595499958
91, 140, 256, 274, 260, 275, -4, -1, -2.896613990462929, 4.123105625617661
91, 141, 509, 193, 508, 196, 1, -3, -1.2490457723982544, 3.1622776601683795
91, 142, 547, 358, 545, 358, 2, 0, 0.0, 2.0
91, 143, 321, 183, 324, 186, -3, -3, -2.356194490192345, 4.242640687119285
91, 144, 176, 144, 179, 146, -3, -2, -2.5535900500422257, 3.605551275463989
91, 145, 129, 347, 134, 348, -5, -1, -2.9441970937399127, 5.0990195135927845
91, 146, 193, 293, 197, 294, -4, -1, -2.896613990462929, 4.123105625617661
91, 147, 541, 253, 538, 257, 3, -4, -0.9272952180016122, 5.0
91, 148, 382, 328, 387, 327, -5, 1, 2.9441970937399127, 5.0990195135927845
91, 149, 423, 228, 426, 231, -3, -3, -2.356194490192345, 4.242640687119285
91, 150, 309, 358, 314, 358, -5, 0, 3.141592653589793, 5.0
91, 151, 545, 296, 542, 298, 3, -2, -0.5880026035475675, 3.605551275463989
91, 152, 61, 252, 68, 253, -7, -1, -2.999695598985629, 7.0710678118654755
91, 153, 85, 189, 89, 191, -4, -2, -2.677945044588987, 4.47213595499958
91, 154, 113, 124, 117, 127, -4, -3, -2.498091544796509, 5.0
91, 155, 120, 136, 123, 139, -3, -3, -2.356194490192345, 4.242640687119285
91, 156, 179, 124, 183, 126, -4, -2, -2.677945044588987, 4.47213595499958
91, 157, 70, 176, 76, 178, -6, -2, -2.819842099193151, 6.324555320336759
91, 158, 221, 167, 223, 169, -2, -2, -2.356194490192345, 2.8284271247461903
91, 159, 79, 161, 85, 164, -6, -3, -2.677945044588987, 6.708203932499369
91, 160, 149, 284, 153, 285, -4, -1, -2.896613990462929, 4.123105625617661
91, 161, 331, 244, 335, 246, -4, -2, -2.677945044588987, 4.47213595499958
91, 162, 94, 111, 97, 111, -3, 0, 3.141592653589793, 3.0
91, 163, 581, 316, 578, 317, 3, -1, -0.3217505543966422, 3.1622776601683795
91, 164, 384, 218, 387, 222, -3, -4, -2.214297435588181, 5.0
91, 165, 133, 322, 137, 323, -4, -1, -2.896613990462929, 4.123105625617661
91, 166, 540, 355, 538, 354, 2, 1, 0.4636476090008061, 2.23606797749979
91, 167, 115, 192, 118, 194, -3, -2, -2.5535900500422257, 3.605551275463989
91, 168, 66, 114, 68, 115, -2, -1, -2.677945044588987, 2.23606797749979
91, 169, 124, 209, 129, 211, -5, -2, -2.761086276477428, 5.385164807134504
91, 170, 399, 222, 401, 224, -2, -2, -2.356194490192345, 2.8284271247461903
91, 171, 385, 261, 389, 264, -4, -3, -2.498091544796509, 5.0
91, 172, 337, 166, 341, 170, -4, -4, -2.356194490192345, 5.656854249492381
91, 173, 72, 148, 76, 150, -4, -2, -2.677945044588987, 4.47213595499958
91, 174, 570, 113, 569, 115, 1, -2, -1.1071487177940904, 2.23606797749979
91, 175, 362, 293, 366, 295, -4, -2, -2.677945044588987, 4.47213595499958
91, 176, 139, 330, 144, 330, -5, 0, 3.141592653589793, 5.0
91, 177, 269, 335, 274, 336, -5, -1, -2.9441970937399127, 5.0990195135927845
91, 178, 325, 165, 328, 169, -3, -4, -2.214297435588181, 5.0
91, 179, 546, 156, 544, 160, 2, -4, -1.1071487177940904, 4.47213595499958
91, 180, 478, 240, 478, 245, 0, -5, -1.5707963267948966, 5.0
91, 181, 577, 343, 573, 342, 4, 1, 0.24497866312686414, 4.123105625617661
91, 182, 432, 277, 436, 280, -4, -3, -2.498091544796509, 5.0
91, 183, 586, 184, 584, 188, 2, -4, -1.1071487177940904, 4.47213595499958
91, 184, 388, 245, 391, 248, -3, -3, -2.356194490192345, 4.242640687119285
91, 185, 557, 173, 555, 177, 2, -4, -1.1071487177940904, 4.47213595499958
91, 187, 203, 172, 206, 174, -3, -2, -2.5535900500422257, 3.605551275463989
91, 188, 216, 273, 221, 274, -5, -1, -2.9441970937399127, 5.0990195135927845
92, 0, 352, 198, 354, 201, -2, -3, -2.158798930342464, 3.605551275463989
92, 2, 419, 182, 420, 185, -1, -3, -1.892546881191539, 3.1622776601683795
92, 4, 83, 264, 87, 266, -4, -2, -2.677945044588987, 4.47213595499958
92, 5, 370, 147, 373, 151, -3, -4, -2.214297435588181, 5.0
92, 6, 273, 302, 278, 303, -5, -1, -2.9441970937399127, 5.0990195135927845
92, 7, 40, 360, 42, 360, -2, 0, 3.141592653589793, 2.0
92, 8, 269, 215, 272, 217, -3, -2, -2.5535900500422257, 3.605551275463989
92, 9, 205, 140, 208, 143, -3, -3, -2.356194490192345, 4.242640687119285
92, 10, 407, 119, 409, 123, -2, -4, -2.0344439357957027, 4.47213595499958
92, 11, 437, 206, 440, 209, -3, -3, -2.356194490192345, 4.242640687119285
92, 12, 305, 205, 307, 206, -2, -1, -2.677945044588987, 2.23606797749979
92, 13, 601, 333, 598, 334, 3, -1, -0.3217505543966422, 3.1622776601683795
92, 14, 153, 212, 156, 214, -3, -2, -2.5535900500422257, 3.605551275463989
92, 16, 465, 366, 465, 368, 0, -2, -1.5707963267948966, 2.0
92, 17, 56, 109, 58, 110, -2, -1, -2.677945044588987, 2.23606797749979
92, 18, 350, 271, 353, 273, -3, -2, -2.5535900500422257, 3.605551275463989
92, 19, 251, 129, 253, 132, -2, -3, -2.158798930342464, 3.605551275463989
92, 20, 77, 289, 80, 290, -3, -1, -2.819842099193151, 3.1622776601683795
92, 21, 429, 118, 430, 123, -1, -5, -1.7681918866447774, 5.0990195135927845
92, 22, 480, 130, 480, 134, 0, -4, -1.5707963267948966, 4.0
92, 23, 592, 199, 594, 199, -2, 0, 3.141592653589793, 2.0
92, 25, 265, 125, 268, 127, -3, -2, -2.5535900500422257, 3.605551275463989
92, 26, 95, 164, 99, 166, -4, -2, -2.677945044588987, 4.47213595499958
92, 27, 491, 251, 491, 255, 0, -4, -1.5707963267948966, 4.0
92, 28, 112, 166, 117, 169, -5, -3, -2.601173153319209, 5.830951894845301
92, 29, 164, 108, 167, 109, -3, -1, -2.819842099193151, 3.1622776601683795
92, 30, 354, 365, 357, 365, -3, 0, 3.141592653589793, 3.0
92, 31, 302, 226, 305, 227, -3, -1, -2.819842099193151, 3.1622776601683795
92, 32, 426, 301, 430, 303, -4, -2, -2.677945044588987, 4.47213595499958
92, 33, 408, 289, 412, 291, -4, -2, -2.677945044588987, 4.47213595499958
92, 34, 173, 366, 177, 366, -4, 0, 3.141592653589793, 4.0
92, 35, 564, 117, 563, 118, 1, -1, -0.7853981633974483, 1.4142135623730951
92, 37, 594, 182, 593, 185, 1, -3, -1.2490457723982544, 3.1622776601683795
92, 38, 554, 137, 553, 140, 1, -3, -1.2490457723982544, 3.1622776601683795
92, 39, 603, 243, 602, 244, 1, -1, -0.7853981633974483, 1.4142135623730951
92, 40, 502, 121, 502, 125, 0, -4, -1.5707963267948966, 4.0
92, 41, 585, 235, 583, 238, 2, -3, -0.982793723247329, 3.605551275463989
92, 42, 606, 163, 603, 168, 3, -5, -1.0303768265243125, 5.830951894845301
92, 43, 573, 366, 571, 366, 2, 0, 0.0, 2.0
92, 45, 590, 125, 588, 129, 2, -4, -1.1071487177940904, 4.47213595499958
92, 46, 397, 367, 400, 367, -3, 0, 3.141592653589793, 3.0
92, 47, 105, 108, 108, 111, -3, -3, -2.356194490192345, 4.242640687119285
92, 48, 530, 267, 527, 271, 3, -4, -0.9272952180016122, 5.0
92, 49, 49, 364, 51, 366, -2, -2, -2.356194490192345, 2.8284271247461903
92, 51, 348, 316, 351, 317, -3, -1, -2.819842099193151, 3.1622776601683795
92, 52, 37, 329, 39, 330, -2, -1, -2.677945044588987, 2.23606797749979
92, 54, 350, 107, 351, 109, -1, -2, -2.0344439357957027, 2.23606797749979
92, 55, 241, 293, 246, 294, -5, -1, -2.9441970937399127, 5.0990195135927845
92, 56, 592, 308, 592, 310, 0, -2, -1.5707963267948966, 2.0
92, 57, 594, 143, 593, 147, 1, -4, -1.3258176636680326, 4.123105625617661
92, 58, 43, 222, 46, 223, -3, -1, -2.819842099193151, 3.1622776601683795
92, 59, 164, 138, 167, 139, -3, -1, -2.819842099193151, 3.1622776601683795
92, 60, 386, 359, 391, 358, -5, 1, 2.9441970937399127, 5.0990195135927845
92, 61, 82, 313, 86, 314, -4, -1, -2.896613990462929, 4.123105625617661
92, 62, 231, 273, 236, 275, -5, -2, -2.761086276477428, 5.385164807134504
92, 63, 191, 204, 196, 205, -5, -1, -2.9441970937399127, 5.0990195135927845
92, 64, 166, 350, 171, 350, -5, 0, 3.141592653589793, 5.0
92, 65, 287, 114, 289, 116, -2, -2, -2.356194490192345, 2.8284271247461903
92, 66, 546, 365, 544, 365, 2, 0, 0.0, 2.0
92, 67, 593, 362, 590, 361, 3, 1, 0.3217505543966422, 3.1622776601683795
92, 68, 308, 318, 310, 319, -2, -1, -2.677945044588987, 2.23606797749979
92, 69, 315, 257, 319, 259, -4, -2, -2.677945044588987, 4.47213595499958
92, 70, 573, 137, 573, 142, 0, -5, -1.5707963267948966, 5.0
92, 71, 326, 129, 330, 133, -4, -4, -2.356194490192345, 5.656854249492381
92, 72, 484, 198, 485, 202, -1, -4, -1.8157749899217608, 4.123105625617661
92, 73, 352, 221, 356, 224, -4, -3, -2.498091544796509, 5.0
92, 74, 105, 169, 109, 171, -4, -2, -2.677945044588987, 4.47213595499958
92, 75, 603, 261, 602, 263, 1, -2, -1.1071487177940904, 2.23606797749979
92, 76, 50, 314, 52, 315, -2, -1, -2.677945044588987, 2.23606797749979
92, 77, 113, 208, 116, 209, -3, -1, -2.819842099193151, 3.1622776601683795
92, 78, 230, 143, 233, 145, -3, -2, -2.5535900500422257, 3.605551275463989
92, 79, 46, 188, 49, 190, -3, -2, -2.5535900500422257, 3.605551275463989
92, 80, 399, 180, 403, 185, -4, -5, -2.2455372690184494, 6.4031242374328485
92, 81, 65, 190, 68, 192, -3, -2, -2.5535900500422257, 3.605551275463989
92, 82, 120, 170, 124, 172, -4, -2, -2.677945044588987, 4.47213595499958
92, 83, 466, 175, 467, 179, -1, -4, -1.8157749899217608, 4.123105625617661
92, 84, 431, 192, 435, 194, -4, -2, -2.677945044588987, 4.47213595499958
92, 85, 38, 212, 39, 214, -1, -2, -2.0344439357957027, 2.23606797749979
92, 86, 63, 130, 67, 132, -4, -2, -2.677945044588987, 4.47213595499958
92, 87, 160, 176, 164, 178, -4, -2, -2.677945044588987, 4.47213595499958
92, 89, 209, 216, 213, 218, -4, -2, -2.677945044588987, 4.47213595499958
92, 90, 137, 245, 142, 247, -5, -2, -2.761086276477428, 5.385164807134504
92, 91, 594, 155, 595, 158, -1, -3, -1.892546881191539, 3.1622776601683795
92, 92, 542, 147, 541, 149, 1, -2, -1.1071487177940904, 2.23606797749979
92, 95, 288, 214, 290, 219, -2, -5, -1.9513027039072615, 5.385164807134504
92, 96, 95, 265, 99, 266, -4, -1, -2.896613990462929, 4.123105625617661
92, 97, 603, 232, 604, 234, -1, -2, -2.0344439357957027, 2.23606797749979
92, 98, 126, 109, 128, 111, -2, -2, -2.356194490192345, 2.8284271247461903
92, 99, 337, 211, 341, 214, -4, -3, -2.498091544796509, 5.0
92, 100, 67, 209, 70, 210, -3, -1, -2.819842099193151, 3.1622776601683795
92, 101, 183, 264, 187, 265, -4, -1, -2.896613990462929, 4.123105625617661
92, 102, 387, 180, 391, 183, -4, -3, -2.498091544796509, 5.0
92, 103, 365, 267, 369, 269, -4, -2, -2.677945044588987, 4.47213595499958
92, 104, 113, 335, 114, 337, -1, -2, -2.0344439357957027, 2.23606797749979
92, 105, 501, 144, 505, 148, -4, -4, -2.356194490192345, 5.656854249492381
92, 106, 39, 252, 43, 253, -4, -1, -2.896613990462929, 4.123105625617661
92, 107, 88, 288, 92, 289, -4, -1, -2.896613990462929, 4.123105625617661
92, 108, 84, 143, 87, 145, -3, -2, -2.5535900500422257, 3.605551275463989
92, 109, 87, 363, 89, 365, -2, -2, -2.356194490192345, 2.8284271247461903
92, 110, 47, 343, 49, 343, -2, 0, 3.141592653589793, 2.0
92, 111, 351, 150, 354, 155, -3, -5, -2.1112158270654806, 5.830951894845301
92, 112, 72, 114, 75, 115, -3, -1, -2.819842099193151, 3.1622776601683795
92, 113, 52, 172, 56, 174, -4, -2, -2.677945044588987, 4.47213595499958
92, 114, 304, 331, 306, 336, -2, -5, -1.9513027039072615, 5.385164807134504
92, 115, 420, 240, 422, 244, -2, -4, -2.0344439357957027, 4.47213595499958
92, 116, 551, 199, 549, 203, 2, -4, -1.1071487177940904, 4.47213595499958
92, 117, 358, 359, 362, 359, -4, 0, 3.141592653589793, 4.0
92, 118, 593, 260, 593, 262, 0, -2, -1.5707963267948966, 2.0
92, 119, 194, 314, 196, 315, -2, -1, -2.677945044588987, 2.23606797749979
92, 120, 141, 162, 145, 164, -4, -2, -2.677945044588987, 4.47213595499958
92, 121, 92, 143, 96, 145, -4, -2, -2.677945044588987, 4.47213595499958
92, 122, 519, 153, 519, 157, 0, -4, -1.5707963267948966, 4.0
92, 123, 567, 274, 566, 276, 1, -2, -1.1071487177940904, 2.23606797749979
92, 124, 176, 329, 181, 329, -5, 0, 3.141592653589793, 5.0
92, 125, 48, 270, 51, 271, -3, -1, -2.819842099193151, 3.1622776601683795
92, 126, 131, 154, 133, 155, -2, -1, -2.677945044588987, 2.23606797749979
92, 127, 334, 115, 336, 118, -2, -3, -2.158798930342464, 3.605551275463989
92, 128, 99, 299, 104, 300, -5, -1, -2.9441970937399127, 5.0990195135927845
92, 129, 47, 294, 49, 293, -2, 1, 2.677945044588987, 2.23606797749979
92, 130, 412, 149, 414, 154, -2, -5, -1.9513027039072615, 5.385164807134504
92, 131, 552, 230, 551, 234, 1, -4, -1.3258176636680326, 4.123105625617661
92, 132, 251, 228, 256, 231, -5, -3, -2.601173153319209, 5.830951894845301
92, 133, 535, 165, 534, 169, 1, -4, -1.3258176636680326, 4.123105625617661
92, 134, 449, 127, 451, 132, -2, -5, -1.9513027039072615, 5.385164807134504
92, 137, 251, 273, 256, 274, -5, -1, -2.9441970937399127, 5.0990195135927845
92, 138, 509, 190, 509, 193, 0, -3, -1.5707963267948966, 3.0
92, 139, 549, 358, 547, 358, 2, 0, 0.0, 2.0
92, 140, 318, 180, 321, 183, -3, -3, -2.356194490192345, 4.242640687119285
92, 141, 173, 142, 176, 144, -3, -2, -2.5535900500422257, 3.605551275463989
92, 142, 126, 347, 129, 347, -3, 0, 3.141592653589793, 3.0
92, 143, 189, 292, 193, 293, -4, -1, -2.896613990462929, 4.123105625617661
92, 144, 543, 249, 541, 253, 2, -4, -1.1071487177940904, 4.47213595499958
92, 145, 377, 328, 382, 328, -5, 0, 3.141592653589793, 5.0
92, 146, 420, 224, 423, 228, -3, -4, -2.214297435588181, 5.0
92, 147, 305, 359, 309, 358, -4, 1, 2.896613990462929, 4.123105625617661
92, 148, 548, 294, 545, 296, 3, -2, -0.5880026035475675, 3.605551275463989
92, 149, 58, 251, 61, 252, -3, -1, -2.819842099193151, 3.1622776601683795
92, 150, 79, 186, 85, 189, -6, -3, -2.677945044588987, 6.708203932499369
92, 151, 109, 121, 113, 124, -4, -3, -2.498091544796509, 5.0
92, 152, 119, 133, 120, 136, -1, -3, -1.892546881191539, 3.1622776601683795
92, 153, 177, 124, 179, 124, -2, 0, 3.141592653589793, 2.0
92, 154, 66, 174, 70, 176, -4, -2, -2.677945044588987, 4.47213595499958
92, 155, 220, 165, 221, 167, -1, -2, -2.0344439357957027, 2.23606797749979
92, 156, 74, 159, 79, 161, -5, -2, -2.761086276477428, 5.385164807134504
92, 157, 146, 283, 149, 284, -3, -1, -2.819842099193151, 3.1622776601683795
92, 158, 326, 242, 331, 244, -5, -2, -2.761086276477428, 5.385164807134504
92, 159, 91, 110, 94, 111, -3, -1, -2.819842099193151, 3.1622776601683795
92, 160, 584, 315, 581, 316, 3, -1, -0.3217505543966422, 3.1622776601683795
92, 161, 381, 214, 384, 218, -3, -4, -2.214297435588181, 5.0
92, 162, 128, 321, 133, 322, -5, -1, -2.9441970937399127, 5.0990195135927845
92, 163, 542, 355, 540, 355, 2, 0, 0.0, 2.0
92, 164, 112, 190, 115, 192, -3, -2, -2.5535900500422257, 3.605551275463989
92, 165, 64, 112, 66, 114, -2, -2, -2.356194490192345, 2.8284271247461903
92, 166, 119, 207, 124, 209, -5, -2, -2.761086276477428, 5.385164807134504
92, 167, 396, 219, 399, 222, -3, -3, -2.356194490192345, 4.242640687119285
92, 168, 382, 258, 385, 261, -3, -3, -2.356194490192345, 4.242640687119285
92, 169, 334, 162, 337, 166, -3, -4, -2.214297435588181, 5.0
92, 170, 68, 146, 72, 148, -4, -2, -2.677945044588987, 4.47213595499958
92, 171, 571, 111, 570, 113, 1, -2, -1.1071487177940904, 2.23606797749979
92, 172, 359, 291, 362, 293, -3, -2, -2.5535900500422257, 3.605551275463989
92, 173, 135, 329, 139, 330, -4, -1, -2.896613990462929, 4.123105625617661
92, 174, 264, 336, 269, 335, -5, 1, 2.9441970937399127, 5.0990195135927845
92, 175, 320, 162, 325, 165, -5, -3, -2.601173153319209, 5.830951894845301
92, 176, 548, 151, 546, 156, 2, -5, -1.1902899496825317, 5.385164807134504
92, 177, 477, 234, 478, 240, -1, -6, -1.7359450042095235, 6.082762530298219
92, 178, 582, 344, 577, 343, 5, 1, 0.19739555984988075, 5.0990195135927845
92, 179, 430, 274, 432, 277, -2, -3, -2.158798930342464, 3.605551275463989
92, 180, 587, 181, 586, 184, 1, -3, -1.2490457723982544, 3.1622776601683795
92, 181, 385, 242, 388, 245, -3, -3, -2.356194490192345, 4.242640687119285
92, 182, 558, 171, 557, 173, 1, -2, -1.1071487177940904, 2.23606797749979
92, 183, 400, 113, 402, 114, -2, -1, -2.677945044588987, 2.23606797749979
92, 184, 199, 169, 203, 172, -4, -3, -2.498091544796509, 5.0
92, 185, 212, 272, 216, 273, -4, -1, -2.896613990462929, 4.123105625617661
93, 0, 350, 196, 352, 198, -2, -2, -2.356194490192345, 2.8284271247461903
93, 1, 167, 330, 171, 331, -4, -1, -2.896613990462929, 4.123105625617661
93, 2, 418, 180, 419, 182, -1, -2, -2.0344439357957027, 2.23606797749979
93, 4, 79, 262, 83, 264, -4, -2, -2.677945044588987, 4.47213595499958
93, 5, 367, 144, 370, 147, -3, -3, -2.356194490192345, 4.242640687119285
93, 6, 269, 301, 273, 302, -4, -1, -2.896613990462929, 4.123105625617661
93, 7, 37, 359, 40, 360, -3, -1, -2.819842099193151, 3.1622776601683795
93, 8, 266, 213, 269, 215, -3, -2, -2.5535900500422257, 3.605551275463989
93, 9, 202, 137, 205, 140, -3, -3, -2.356194490192345, 4.242640687119285
93, 10, 405, 116, 407, 119, -2, -3, -2.158798930342464, 3.605551275463989
93, 11, 435, 203, 437, 206, -2, -3, -2.158798930342464, 3.605551275463989
93, 12, 301, 203, 305, 205, -4, -2, -2.677945044588987, 4.47213595499958
93, 14, 149, 211, 153, 212, -4, -1, -2.896613990462929, 4.123105625617661
93, 16, 54, 107, 56, 109, -2, -2, -2.356194490192345, 2.8284271247461903
93, 17, 348, 271, 350, 271, -2, 0, 3.141592653589793, 2.0
93, 18, 249, 127, 251, 129, -2, -2, -2.356194490192345, 2.8284271247461903
93, 19, 72, 289, 77, 289, -5, 0, 3.141592653589793, 5.0
93, 20, 427, 116, 429, 118, -2, -2, -2.356194490192345, 2.8284271247461903
93, 21, 479, 126, 480, 130, -1, -4, -1.8157749899217608, 4.123105625617661
93, 22, 591, 197, 592, 199, -1, -2, -2.0344439357957027, 2.23606797749979
93, 24, 263, 123, 265, 125, -2, -2, -2.356194490192345, 2.8284271247461903
93, 25, 92, 162, 95, 164, -3, -2, -2.5535900500422257, 3.605551275463989
93, 26, 490, 247, 491, 251, -1, -4, -1.8157749899217608, 4.123105625617661
93, 27, 108, 164, 112, 166, -4, -2, -2.677945044588987, 4.47213595499958
93, 28, 162, 107, 164, 108, -2, -1, -2.677945044588987, 2.23606797749979
93, 29, 351, 365, 354, 365, -3, 0, 3.141592653589793, 3.0
93, 30, 298, 225, 302, 226, -4, -1, -2.896613990462929, 4.123105625617661
93, 31, 423, 300, 426, 301, -3, -1, -2.819842099193151, 3.1622776601683795
93, 32, 404, 287, 408, 289, -4, -2, -2.677945044588987, 4.47213595499958
93, 33, 169, 365, 173, 366, -4, -1, -2.896613990462929, 4.123105625617661
93, 34, 565, 114, 564, 117, 1, -3, -1.2490457723982544, 3.1622776601683795
93, 35, 590, 107, 589, 108, 1, -1, -0.7853981633974483, 1.4142135623730951
93, 36, 594, 178, 594, 182, 0, -4, -1.5707963267948966, 4.0
93, 37, 555, 133, 554, 137, 1, -4, -1.3258176636680326, 4.123105625617661
93, 38, 604, 242, 603, 243, 1, -1, -0.7853981633974483, 1.4142135623730951
93, 39, 502, 118, 502, 121, 0, -3, -1.5707963267948966, 3.0
93, 40, 587, 231, 585, 235, 2, -4, -1.1071487177940904, 4.47213595499958
93, 41, 606, 161, 606, 163, 0, -2, -1.5707963267948966, 2.0
93, 42, 574, 365, 573, 366, 1, -1, -0.7853981633974483, 1.4142135623730951
93, 44, 592, 123, 590, 125, 2, -2, -0.7853981633974483, 2.8284271247461903
93, 45, 393, 366, 397, 367, -4, -1, -2.896613990462929, 4.123105625617661
93, 46, 102, 106, 105, 108, -3, -2, -2.5535900500422257, 3.605551275463989
93, 47, 532, 262, 530, 267, 2, -5, -1.1902899496825317, 5.385164807134504
93, 48, 47, 363, 49, 364, -2, -1, -2.677945044588987, 2.23606797749979
93, 49, 346, 318, 348, 316, -2, 2, 2.356194490192345, 2.8284271247461903
93, 51, 348, 106, 350, 107, -2, -1, -2.677945044588987, 2.23606797749979
93, 52, 238, 293, 241, 293, -3, 0, 3.141592653589793, 3.0
93, 53, 595, 139, 594, 143, 1, -4, -1.3258176636680326, 4.123105625617661
93, 54, 41, 220, 43, 222, -2, -2, -2.356194490192345, 2.8284271247461903
93, 55, 161, 136, 164, 138, -3, -2, -2.5535900500422257, 3.605551275463989
93, 56, 383, 359, 386, 359, -3, 0, 3.141592653589793, 3.0
93, 57, 79, 312, 82, 313, -3, -1, -2.819842099193151, 3.1622776601683795
93, 58, 228, 271, 231, 273, -3, -2, -2.5535900500422257, 3.605551275463989
93, 59, 189, 202, 191, 204, -2, -2, -2.356194490192345, 2.8284271247461903
93, 60, 164, 349, 166, 350, -2, -1, -2.677945044588987, 2.23606797749979
93, 61, 285, 113, 287, 114, -2, -1, -2.677945044588987, 2.23606797749979
93, 62, 548, 365, 546, 365, 2, 0, 0.0, 2.0
93, 63, 595, 362, 593, 362, 2, 0, 0.0, 2.0
93, 64, 306, 318, 308, 318, -2, 0, 3.141592653589793, 2.0
93, 65, 312, 254, 315, 257, -3, -3, -2.356194490192345, 4.242640687119285
93, 66, 574, 134, 573, 137, 1, -3, -1.2490457723982544, 3.1622776601683795
93, 67, 324, 128, 326, 129, -2, -1, -2.677945044588987, 2.23606797749979
93, 68, 482, 194, 484, 198, -2, -4, -2.0344439357957027, 4.47213595499958
93, 69, 351, 219, 352, 221, -1, -2, -2.0344439357957027, 2.23606797749979
93, 70, 101, 166, 105, 169, -4, -3, -2.498091544796509, 5.0
93, 71, 603, 259, 603, 261, 0, -2, -1.5707963267948966, 2.0
93, 72, 47, 314, 50, 314, -3, 0, 3.141592653589793, 3.0
93, 73, 110, 207, 113, 208, -3, -1, -2.819842099193151, 3.1622776601683795
93, 74, 228, 142, 230, 143, -2, -1, -2.677945044588987, 2.23606797749979
93, 75, 44, 186, 46, 188, -2, -2, -2.356194490192345, 2.8284271247461903
93, 76, 397, 179, 399, 180, -2, -1, -2.677945044588987, 2.23606797749979
93, 77, 63, 188, 65, 190, -2, -2, -2.356194490192345, 2.8284271247461903
93, 78, 116, 167, 120, 170, -4, -3, -2.498091544796509, 5.0
93, 79, 467, 171, 466, 175, 1, -4, -1.3258176636680326, 4.123105625617661
93, 80, 429, 189, 431, 192, -2, -3, -2.158798930342464, 3.605551275463989
93, 81, 38, 210, 38, 212, 0, -2, -1.5707963267948966, 2.0
93, 82, 60, 128, 63, 130, -3, -2, -2.5535900500422257, 3.605551275463989
93, 83, 157, 174, 160, 176, -3, -2, -2.5535900500422257, 3.605551275463989
93, 85, 206, 215, 209, 216, -3, -1, -2.819842099193151, 3.1622776601683795
93, 86, 133, 244, 137, 245, -4, -1, -2.896613990462929, 4.123105625617661
93, 87, 592, 153, 594, 155, -2, -2, -2.356194490192345, 2.8284271247461903
93, 88, 543, 142, 542, 147, 1, -5, -1.373400766945016, 5.0990195135927845
93, 91, 90, 263, 95, 265, -5, -2, -2.761086276477428, 5.385164807134504
93, 92, 603, 230, 603, 232, 0, -2, -1.5707963267948966, 2.0
93, 93, 124, 108, 126, 109, -2, -1, -2.677945044588987, 2.23606797749979
93, 94, 333, 207, 337, 211, -4, -4, -2.356194490192345, 5.656854249492381
93, 95, 63, 207, 67, 209, -4, -2, -2.677945044588987, 4.47213595499958
93, 96, 178, 263, 183, 264, -5, -1, -2.9441970937399127, 5.0990195135927845
93, 97, 384, 176, 387, 180, -3, -4, -2.214297435588181, 5.0
93, 98, 360, 264, 365, 267, -5, -3, -2.601173153319209, 5.830951894845301
93, 99, 107, 335, 113, 335, -6, 0, 3.141592653589793, 6.0
93, 100, 500, 142, 501, 144, -1, -2, -2.0344439357957027, 2.23606797749979
93, 101, 38, 249, 39, 252, -1, -3, -1.892546881191539, 3.1622776601683795
93, 102, 83, 287, 88, 288, -5, -1, -2.9441970937399127, 5.0990195135927845
93, 103, 82, 141, 84, 143, -2, -2, -2.356194490192345, 2.8284271247461903
93, 104, 83, 362, 87, 363, -4, -1, -2.896613990462929, 4.123105625617661
93, 105, 45, 343, 47, 343, -2, 0, 3.141592653589793, 2.0
93, 106, 349, 148, 351, 150, -2, -2, -2.356194490192345, 2.8284271247461903
93, 107, 70, 113, 72, 114, -2, -1, -2.677945044588987, 2.23606797749979
93, 108, 49, 171, 52, 172, -3, -1, -2.819842099193151, 3.1622776601683795
93, 109, 300, 330, 304, 331, -4, -1, -2.896613990462929, 4.123105625617661
93, 110, 418, 237, 420, 240, -2, -3, -2.158798930342464, 3.605551275463989
93, 111, 552, 195, 551, 199, 1, -4, -1.3258176636680326, 4.123105625617661
93, 112, 354, 359, 358, 359, -4, 0, 3.141592653589793, 4.0
93, 114, 189, 313, 194, 314, -5, -1, -2.9441970937399127, 5.0990195135927845
93, 115, 138, 159, 141, 162, -3, -3, -2.356194490192345, 4.242640687119285
93, 116, 86, 140, 92, 143, -6, -3, -2.677945044588987, 6.708203932499369
93, 117, 519, 150, 519, 153, 0, -3, -1.5707963267948966, 3.0
93, 118, 569, 272, 567, 274, 2, -2, -0.7853981633974483, 2.8284271247461903
93, 119, 172, 328, 176, 329, -4, -1, -2.896613990462929, 4.123105625617661
93, 120, 46, 269, 48, 270, -2, -1, -2.677945044588987, 2.23606797749979
93, 121, 127, 152, 131, 154, -4, -2, -2.677945044588987, 4.47213595499958
93, 122, 332, 114, 334, 115, -2, -1, -2.677945044588987, 2.23606797749979
93, 123, 95, 298, 99, 299, -4, -1, -2.896613990462929, 4.123105625617661
93, 124, 44, 293, 47, 294, -3, -1, -2.819842099193151, 3.1622776601683795
93, 125, 409, 145, 412, 149, -3, -4, -2.214297435588181, 5.0
93, 126, 550, 228, 552, 230, -2, -2, -2.356194490192345, 2.8284271247461903
93, 127, 249, 226, 251, 228, -2, -2, -2.356194490192345, 2.8284271247461903
93, 128, 534, 162, 535, 165, -1, -3, -1.892546881191539, 3.1622776601683795
93, 129, 448, 122, 449, 127, -1, -5, -1.7681918866447774, 5.0990195135927845
93, 132, 247, 272, 251, 273, -4, -1, -2.896613990462929, 4.123105625617661
93, 133, 508, 187, 509, 190, -1, -3, -1.892546881191539, 3.1622776601683795
93, 134, 551, 358, 549, 358, 2, 0, 0.0, 2.0
93, 135, 316, 176, 318, 180, -2, -4, -2.0344439357957027, 4.47213595499958
93, 136, 169, 140, 173, 142, -4, -2, -2.677945044588987, 4.47213595499958
93, 137, 122, 347, 126, 347, -4, 0, 3.141592653589793, 4.0
93, 138, 184, 290, 189, 292, -5, -2, -2.761086276477428, 5.385164807134504
93, 139, 542, 247, 543, 249, -1, -2, -2.0344439357957027, 2.23606797749979
93, 140, 373, 328, 377, 328, -4, 0, 3.141592653589793, 4.0
93, 141, 418, 220, 420, 224, -2, -4, -2.0344439357957027, 4.47213595499958
93, 142, 302, 360, 305, 359, -3, 1, 2.819842099193151, 3.1622776601683795
93, 143, 551, 292, 548, 294, 3, -2, -0.5880026035475675, 3.605551275463989
93, 144, 55, 250, 58, 251, -3, -1, -2.819842099193151, 3.1622776601683795
93, 145, 77, 185, 79, 186, -2, -1, -2.677945044588987, 2.23606797749979
93, 146, 115, 130, 119, 133, -4, -3, -2.498091544796509, 5.0
93, 147, 174, 123, 177, 124, -3, -1, -2.819842099193151, 3.1622776601683795
93, 148, 62, 172, 66, 174, -4, -2, -2.677945044588987, 4.47213595499958
93, 149, 218, 164, 220, 165, -2, -1, -2.677945044588987, 2.23606797749979
93, 150, 70, 158, 74, 159, -4, -1, -2.896613990462929, 4.123105625617661
93, 151, 143, 282, 146, 283, -3, -1, -2.819842099193151, 3.1622776601683795
93, 152, 323, 240, 326, 242, -3, -2, -2.5535900500422257, 3.605551275463989
93, 153, 88, 110, 91, 110, -3, 0, 3.141592653589793, 3.0
93, 154, 586, 314, 584, 315, 2, -1, -0.4636476090008061, 2.23606797749979
93, 155, 381, 209, 381, 214, 0, -5, -1.5707963267948966, 5.0
93, 156, 124, 320, 128, 321, -4, -1, -2.896613990462929, 4.123105625617661
93, 157, 544, 355, 542, 355, 2, 0, 0.0, 2.0
93, 158, 108, 188, 112, 190, -4, -2, -2.677945044588987, 4.47213595499958
93, 159, 61, 111, 64, 112, -3, -1, -2.819842099193151, 3.1622776601683795
93, 160, 113, 205, 119, 207, -6, -2, -2.819842099193151, 6.324555320336759
93, 161, 391, 218, 396, 219, -5, -1, -2.9441970937399127, 5.0990195135927845
93, 162, 381, 255, 382, 258, -1, -3, -1.892546881191539, 3.1622776601683795
93, 163, 334, 160, 334, 162, 0, -2, -1.5707963267948966, 2.0
93, 164, 63, 143, 68, 146, -5, -3, -2.601173153319209, 5.830951894845301
93, 166, 358, 289, 359, 291, -1, -2, -2.0344439357957027, 2.23606797749979
93, 167, 131, 327, 135, 329, -4, -2, -2.677945044588987, 4.47213595499958
93, 168, 260, 336, 264, 336, -4, 0, 3.141592653589793, 4.0
93, 169, 317, 159, 320, 162, -3, -3, -2.356194490192345, 4.242640687119285
93, 170, 549, 147, 548, 151, 1, -4, -1.3258176636680326, 4.123105625617661
93, 171, 476, 232, 477, 234, -1, -2, -2.0344439357957027, 2.23606797749979
93, 172, 586, 345, 582, 344, 4, 1, 0.24497866312686414, 4.123105625617661
93, 173, 427, 272, 430, 274, -3, -2, -2.5535900500422257, 3.605551275463989
93, 174, 588, 178, 587, 181, 1, -3, -1.2490457723982544, 3.1622776601683795
93, 175, 381, 239, 385, 242, -4, -3, -2.498091544796509, 5.0
93, 176, 559, 167, 558, 171, 1, -4, -1.3258176636680326, 4.123105625617661
93, 178, 195, 167, 199, 169, -4, -2, -2.677945044588987, 4.47213595499958
93, 179, 207, 271, 212, 272, -5, -1, -2.9441970937399127, 5.0990195135927845
94, 0, 348, 194, 350, 196, -2, -2, -2.356194490192345, 2.8284271247461903
94, 1, 164, 330, 167, 330, -3, 0, 3.141592653589793, 3.0
94, 4, 366, 142, 367, 144, -1, -2, -2.0344439357957027, 2.23606797749979
94, 7, 263, 213, 266, 213, -3, 0, 3.141592653589793, 3.0
94, 8, 200, 136, 202, 137, -2, -1, -2.677945044588987, 2.23606797749979
94, 9, 404, 114, 405, 116, -1, -2, -2.0344439357957027, 2.23606797749979
94, 10, 433, 200, 435, 203, -2, -3, -2.158798930342464, 3.605551275463989
94, 11, 297, 202, 301, 203, -4, -1, -2.896613990462929, 4.123105625617661
94, 12, 146, 211, 149, 211, -3, 0, 3.141592653589793, 3.0
94, 14, 52, 106, 54, 107, -2, -1, -2.677945044588987, 2.23606797749979
94, 16, 246, 124, 249, 127, -3, -3, -2.356194490192345, 4.242640687119285
94, 17, 70, 288, 72, 289, -2, -1, -2.677945044588987, 2.23606797749979
94, 19, 479, 124, 479, 126, 0, -2, -1.5707963267948966, 2.0
94, 20, 590, 195, 591, 197, -1, -2, -2.0344439357957027, 2.23606797749979
94, 21, 587, 102, 586, 103, 1, -1, -0.7853981633974483, 1.4142135623730951
94, 22, 260, 121, 263, 123, -3, -2, -2.5535900500422257, 3.605551275463989
94, 23, 89, 159, 92, 162, -3, -3, -2.356194490192345, 4.242640687119285
94, 24, 488, 245, 490, 247, -2, -2, -2.356194490192345, 2.8284271247461903
94, 25, 104, 164, 108, 164, -4, 0, 3.141592653589793, 4.0
94, 26, 160, 106, 162, 107, -2, -1, -2.677945044588987, 2.23606797749979
94, 27, 348, 365, 351, 365, -3, 0, 3.141592653589793, 3.0
94, 28, 295, 224, 298, 225, -3, -1, -2.819842099193151, 3.1622776601683795
94, 29, 420, 300, 423, 300, -3, 0, 3.141592653589793, 3.0
94, 30, 401, 288, 404, 287, -3, 1, 2.819842099193151, 3.1622776601683795
94, 31, 166, 364, 169, 365, -3, -1, -2.819842099193151, 3.1622776601683795
94, 35, 556, 131, 555, 133, 1, -2, -1.1071487177940904, 2.23606797749979
94, 36, 605, 240, 604, 242, 1, -2, -1.1071487177940904, 2.23606797749979
94, 37, 503, 116, 502, 118, 1, -2, -1.1071487177940904, 2.23606797749979
94, 38, 587, 227, 587, 231, 0, -4, -1.5707963267948966, 4.0
94, 39, 606, 158, 606, 161, 0, -3, -1.5707963267948966, 3.0
94, 40, 575, 364, 574, 365, 1, -1, -0.7853981633974483, 1.4142135623730951
94, 42, 593, 121, 592, 123, 1, -2, -1.1071487177940904, 2.23606797749979
94, 43, 389, 366, 393, 366, -4, 0, 3.141592653589793, 4.0
94, 44, 99, 105, 102, 106, -3, -1, -2.819842099193151, 3.1622776601683795
94, 45, 532, 260, 532, 262, 0, -2, -1.5707963267948966, 2.0
94, 46, 44, 361, 47, 363, -3, -2, -2.5535900500422257, 3.605551275463989
94, 47, 344, 317, 346, 318, -2, -1, -2.677945044588987, 2.23606797749979
94, 49, 346, 105, 348, 106, -2, -1, -2.677945044588987, 2.23606797749979
94, 50, 234, 293, 238, 293, -4, 0, 3.141592653589793, 4.0
94, 51, 594, 136, 595, 139, -1, -3, -1.892546881191539, 3.1622776601683795
94, 53, 158, 134, 161, 136, -3, -2, -2.5535900500422257, 3.605551275463989
94, 54, 379, 359, 383, 359, -4, 0, 3.141592653589793, 4.0
94, 55, 77, 312, 79, 312, -2, 0, 3.141592653589793, 2.0
94, 56, 226, 270, 228, 271, -2, -1, -2.677945044588987, 2.23606797749979
94, 57, 187, 200, 189, 202, -2, -2, -2.356194490192345, 2.8284271247461903
94, 58, 162, 348, 164, 349, -2, -1, -2.677945044588987, 2.23606797749979
94, 59, 283, 112, 285, 113, -2, -1, -2.677945044588987, 2.23606797749979
94, 60, 550, 365, 548, 365, 2, 0, 0.0, 2.0
94, 62, 302, 318, 306, 318, -4, 0, 3.141592653589793, 4.0
94, 63, 314, 253, 312, 254, 2, -1, -0.4636476090008061, 2.23606797749979
94, 64, 574, 131, 574, 134, 0, -3, -1.5707963267948966, 3.0
94, 65, 481, 190, 482, 194, -1, -4, -1.8157749899217608, 4.123105625617661
94, 66, 348, 216, 351, 219, -3, -3, -2.356194490192345, 4.242640687119285
94, 67, 96, 163, 101, 166, -5, -3, -2.601173153319209, 5.830951894845301
94, 69, 44, 314, 47, 314, -3, 0, 3.141592653589793, 3.0
94, 70, 107, 205, 110, 207, -3, -2, -2.5535900500422257, 3.605551275463989
94, 71, 226, 141, 228, 142, -2, -1, -2.677945044588987, 2.23606797749979
94, 72, 43, 184, 44, 186, -1, -2, -2.0344439357957027, 2.23606797749979
94, 73, 59, 187, 63, 188, -4, -1, -2.896613990462929, 4.123105625617661
94, 74, 111, 165, 116, 167, -5, -2, -2.761086276477428, 5.385164807134504
94, 75, 469, 169, 467, 171, 2, -2, -0.7853981633974483, 2.8284271247461903
94, 76, 426, 185, 429, 189, -3, -4, -2.214297435588181, 5.0
94, 78, 57, 126, 60, 128, -3, -2, -2.5535900500422257, 3.605551275463989
94, 79, 154, 172, 157, 174, -3, -2, -2.5535900500422257, 3.605551275463989
94, 81, 204, 214, 206, 215, -2, -1, -2.677945044588987, 2.23606797749979
94, 82, 130, 242, 133, 244, -3, -2, -2.5535900500422257, 3.605551275463989
94, 83, 590, 151, 592, 153, -2, -2, -2.356194490192345, 2.8284271247461903
94, 84, 543, 139, 543, 142, 0, -3, -1.5707963267948966, 3.0
94, 87, 85, 262, 90, 263, -5, -1, -2.9441970937399127, 5.0990195135927845
94, 88, 122, 108, 124, 108, -2, 0, 3.141592653589793, 2.0
94, 89, 331, 203, 333, 207, -2, -4, -2.0344439357957027, 4.47213595499958
94, 90, 59, 206, 63, 207, -4, -1, -2.896613990462929, 4.123105625617661
94, 91, 381, 173, 384, 176, -3, -3, -2.356194490192345, 4.242640687119285
94, 92, 355, 260, 360, 264, -5, -4, -2.4668517113662407, 6.4031242374328485
94, 93, 105, 334, 107, 335, -2, -1, -2.677945044588987, 2.23606797749979
94, 94, 39, 248, 38, 249, 1, -1, -0.7853981633974483, 1.4142135623730951
94, 95, 78, 286, 83, 287, -5, -1, -2.9441970937399127, 5.0990195135927845
94, 96, 79, 139, 82, 141, -3, -2, -2.5535900500422257, 3.605551275463989
94, 97, 81, 360, 83, 362, -2, -2, -2.356194490192345, 2.8284271247461903
94, 99, 347, 146, 349, 148, -2, -2, -2.356194490192345, 2.8284271247461903
94, 100, 67, 113, 70, 113, -3, 0, 3.141592653589793, 3.0
94, 103, 416, 236, 418, 237, -2, -1, -2.677945044588987, 2.23606797749979
94, 104, 552, 192, 552, 195, 0, -3, -1.5707963267948966, 3.0
94, 105, 352, 358, 354, 359, -2, -1, -2.677945044588987, 2.23606797749979
94, 106, 593, 257, 593, 259, 0, -2, -1.5707963267948966, 2.0
94, 107, 185, 312, 189, 313, -4, -1, -2.896613990462929, 4.123105625617661
94, 108, 134, 156, 138, 159, -4, -3, -2.498091544796509, 5.0
94, 109, 81, 137, 86, 140, -5, -3, -2.601173153319209, 5.830951894845301
94, 110, 518, 146, 519, 150, -1, -4, -1.8157749899217608, 4.123105625617661
94, 111, 571, 271, 569, 272, 2, -1, -0.4636476090008061, 2.23606797749979
94, 112, 168, 327, 172, 328, -4, -1, -2.896613990462929, 4.123105625617661
94, 113, 44, 268, 46, 269, -2, -1, -2.677945044588987, 2.23606797749979
94, 114, 123, 149, 127, 152, -4, -3, -2.498091544796509, 5.0
94, 115, 330, 113, 332, 114, -2, -1, -2.677945044588987, 2.23606797749979
94, 116, 92, 297, 95, 298, -3, -1, -2.819842099193151, 3.1622776601683795
94, 118, 407, 143, 409, 145, -2, -2, -2.356194490192345, 2.8284271247461903
94, 119, 552, 227, 550, 228, 2, -1, -0.4636476090008061, 2.23606797749979
94, 120, 246, 224, 249, 226, -3, -2, -2.5535900500422257, 3.605551275463989
94, 121, 535, 160, 534, 162, 1, -2, -1.1071487177940904, 2.23606797749979
94, 122, 448, 119, 448, 122, 0, -3, -1.5707963267948966, 3.0
94, 124, 245, 272, 247, 272, -2, 0, 3.141592653589793, 2.0
94, 125, 508, 183, 508, 187, 0, -4, -1.5707963267948966, 4.0
94, 126, 553, 358, 551, 358, 2, 0, 0.0, 2.0
94, 127, 315, 174, 316, 176, -1, -2, -2.0344439357957027, 2.23606797749979
94, 128, 165, 137, 169, 140, -4, -3, -2.498091544796509, 5.0
94, 129, 118, 345, 122, 347, -4, -2, -2.677945044588987, 4.47213595499958
94, 130, 180, 290, 184, 290, -4, 0, 3.141592653589793, 4.0
94, 131, 542, 245, 542, 247, 0, -2, -1.5707963267948966, 2.0
94, 132, 370, 327, 373, 328, -3, -1, -2.819842099193151, 3.1622776601683795
94, 133, 416, 217, 418, 220, -2, -3, -2.158798930342464, 3.605551275463989
94, 134, 299, 360, 302, 360, -3, 0, 3.141592653589793, 3.0
94, 135, 554, 289, 551, 292, 3, -3, -0.7853981633974483, 4.242640687119285
94, 136, 52, 249, 55, 250, -3, -1, -2.819842099193151, 3.1622776601683795
94, 137, 113, 127, 115, 130, -2, -3, -2.158798930342464, 3.605551275463989
94, 138, 172, 121, 174, 123, -2, -2, -2.356194490192345, 2.8284271247461903
94, 139, 57, 168, 62, 172, -5, -4, -2.4668517113662407, 6.4031242374328485
94, 140, 216, 163, 218, 164, -2, -1, -2.677945044588987, 2.23606797749979
94, 141, 68, 158, 70, 158, -2, 0, 3.141592653589793, 2.0
94, 142, 139, 281, 143, 282, -4, -1, -2.896613990462929, 4.123105625617661
94, 143, 319, 237, 323, 240, -4, -3, -2.498091544796509, 5.0
94, 144, 85, 109, 88, 110, -3, -1, -2.819842099193151, 3.1622776601683795
94, 145, 587, 312, 586, 314, 1, -2, -1.1071487177940904, 2.23606797749979
94, 146, 381, 207, 381, 209, 0, -2, -1.5707963267948966, 2.0
94, 147, 118, 317, 124, 320, -6, -3, -2.677945044588987, 6.708203932499369
94, 148, 546, 355, 544, 355, 2, 0, 0.0, 2.0
94, 149, 104, 186, 108, 188, -4, -2, -2.677945044588987, 4.47213595499958
94, 150, 59, 109, 61, 111, -2, -2, -2.356194490192345, 2.8284271247461903
94, 151, 108, 202, 113, 205, -5, -3, -2.601173153319209, 5.830951894845301
94, 152, 387, 215, 391, 218, -4, -3, -2.498091544796509, 5.0
94, 153, 379, 254, 381, 255, -2, -1, -2.677945044588987, 2.23606797749979
94, 154, 333, 158, 334, 160, -1, -2, -2.0344439357957027, 2.23606797749979
94, 156, 572, 109, 571, 110, 1, -1, -0.7853981633974483, 1.4142135623730951
94, 157, 354, 288, 358, 289, -4, -1, -2.896613990462929, 4.123105625617661
94, 158, 128, 326, 131, 327, -3, -1, -2.819842099193151, 3.1622776601683795
94, 159, 258, 337, 260, 336, -2, 1, 2.677945044588987, 2.23606797749979
94, 160, 313, 156, 317, 159, -4, -3, -2.498091544796509, 5.0
94, 161, 550, 142, 549, 147, 1, -5, -1.373400766945016, 5.0990195135927845
94, 162, 475, 230, 476, 232, -1, -2, -2.0344439357957027, 2.23606797749979
94, 163, 590, 345, 586, 345, 4, 0, 0.0, 4.0
94, 164, 426, 273, 427, 272, -1, 1, 2.356194490192345, 1.4142135623730951
94, 166, 378, 237, 381, 239, -3, -2, -2.5535900500422257, 3.605551275463989
94, 167, 558, 164, 559, 167, -1, -3, -1.892546881191539, 3.1622776601683795
94, 168, 204, 269, 207, 271, -3, -2, -2.5535900500422257, 3.605551275463989
95, 0, 270, 302, 276, 304, -6, -2, -2.819842099193151, 6.324555320336759
95, 1, 108, 165, 113, 168, -5, -3, -2.601173153319209, 5.830951894845301
95, 3, 267, 214, 271, 217, -4, -3, -2.498091544796509, 5.0
95, 4, 596, 182, 595, 184, 1, -2, -1.1071487177940904, 2.23606797749979
95, 6, 167, 332, 172, 333, -5, -1, -2.9441970937399127, 5.0990195135927845
95, 7, 45, 270, 48, 272, -3, -2, -2.5535900500422257, 3.605551275463989
95, 8, 201, 138, 205, 141, -4, -3, -2.498091544796509, 5.0
95, 9, 74, 290, 79, 291, -5, -1, -2.9441970937399127, 5.0990195135927845
95, 10, 42, 357, 45, 357, -3, 0, 3.141592653589793, 3.0
95, 11, 419, 182, 422, 186, -3, -4, -2.214297435588181, 5.0
95, 12, 54, 109, 56, 110, -2, -1, -2.677945044588987, 2.23606797749979
95, 13, 350, 196, 354, 200, -4, -4, -2.356194490192345, 5.656854249492381
95, 14, 83, 264, 87, 266, -4, -2, -2.677945044588987, 4.47213595499958
95, 15, 149, 211, 154, 214, -5, -3, -2.601173153319209, 5.830951894845301
95, 16, 423, 299, 427, 300, -4, -1, -2.896613990462929, 4.123105625617661
95, 17, 90, 164, 95, 166, -5, -2, -2.761086276477428, 5.385164807134504
95, 18, 345, 316, 351, 316, -6, 0, 3.141592653589793, 6.0
95, 19, 403, 285, 407, 287, -4, -2, -2.677945044588987, 4.47213595499958
95, 20, 347, 270, 353, 271, -6, -1, -2.976443976175166, 6.082762530298219
95, 21, 246, 111, 248, 112, -2, -1, -2.677945044588987, 2.23606797749979
95, 22, 36, 253, 39, 254, -3, -1, -2.819842099193151, 3.1622776601683795
95, 23, 352, 366, 355, 365, -3, 1, 2.819842099193151, 3.1622776601683795
95, 24, 50, 315, 52, 315, -2, 0, 3.141592653589793, 2.0
95, 25, 161, 137, 165, 140, -4, -3, -2.498091544796509, 5.0
95, 27, 39, 241, 39, 243, 0, -2, -1.5707963267948966, 2.0
95, 28, 430, 119, 431, 123, -1, -4, -1.8157749899217608, 4.123105625617661
95, 29, 565, 113, 564, 117, 1, -4, -1.3258176636680326, 4.123105625617661
95, 30, 335, 115, 337, 115, -2, 0, 3.141592653589793, 2.0
95, 31, 505, 120, 505, 125, 0, -5, -1.5707963267948966, 5.0
95, 32, 405, 118, 408, 120, -3, -2, -2.5535900500422257, 3.605551275463989
95, 34, 577, 133, 576, 138, 1, -5, -1.373400766945016, 5.0990195135927845
95, 35, 588, 125, 586, 129, 2, -4, -1.1071487177940904, 4.47213595499958
95, 36, 300, 201, 306, 204, -6, -3, -2.677945044588987, 6.708203932499369
95, 37, 562, 109, 561, 110, 1, -1, -0.7853981633974483, 1.4142135623730951
95, 38, 367, 146, 371, 149, -4, -3, -2.498091544796509, 5.0
95, 40, 300, 221, 305, 223, -5, -2, -2.761086276477428, 5.385164807134504
95, 41, 47, 366, 51, 367, -4, -1, -2.896613990462929, 4.123105625617661
95, 42, 594, 197, 595, 199, -1, -2, -2.0344439357957027, 2.23606797749979
95, 43, 260, 123, 265, 126, -5, -3, -2.601173153319209, 5.830951894845301
95, 44, 82, 365, 87, 366, -5, -1, -2.9441970937399127, 5.0990195135927845
95, 45, 288, 117, 290, 117, -2, 0, 3.141592653589793, 2.0
95, 46, 437, 203, 439, 208, -2, -5, -1.9513027039072615, 5.385164807134504
95, 47, 239, 293, 244, 293, -5, 0, 3.141592653589793, 5.0
95, 48, 44, 186, 46, 188, -2, -2, -2.356194490192345, 2.8284271247461903
95, 49, 42, 224, 46, 225, -4, -1, -2.896613990462929, 4.123105625617661
95, 50, 394, 368, 398, 368, -4, 0, 3.141592653589793, 4.0
95, 51, 597, 140, 596, 143, 1, -3, -1.2490457723982544, 3.1622776601683795
95, 52, 556, 135, 554, 140, 2, -5, -1.1902899496825317, 5.385164807134504
95, 54, 247, 127, 252, 129, -5, -2, -2.761086276477428, 5.385164807134504
95, 55, 301, 106, 303, 106, -2, 0, 3.141592653589793, 2.0
95, 56, 593, 363, 592, 362, 1, 1, 0.7853981633974483, 1.4142135623730951
95, 58, 40, 364, 43, 364, -3, 0, 3.141592653589793, 3.0
95, 59, 537, 264, 535, 270, 2, -6, -1.2490457723982544, 6.324555320336759
95, 60, 74, 114, 77, 114, -3, 0, 3.141592653589793, 3.0
95, 61, 384, 359, 389, 358, -5, 1, 2.9441970937399127, 5.0990195135927845
95, 63, 229, 273, 234, 274, -5, -1, -2.9441970937399127, 5.0990195135927845
95, 64, 596, 154, 597, 157, -1, -3, -1.892546881191539, 3.1622776601683795
95, 65, 126, 113, 128, 114, -2, -1, -2.677945044588987, 2.23606797749979
95, 67, 163, 105, 166, 106, -3, -1, -2.819842099193151, 3.1622776601683795
95, 68, 189, 204, 194, 206, -5, -2, -2.761086276477428, 5.385164807134504
95, 71, 43, 294, 46, 294, -3, 0, 3.141592653589793, 3.0
95, 72, 554, 228, 552, 232, 2, -4, -1.1071487177940904, 4.47213595499958
95, 73, 79, 314, 84, 315, -5, -1, -2.9441970937399127, 5.0990195135927845
95, 74, 204, 105, 207, 106, -3, -1, -2.819842099193151, 3.1622776601683795
95, 76, 592, 234, 591, 239, 1, -5, -1.373400766945016, 5.0990195135927845
95, 77, 484, 126, 486, 131, -2, -5, -1.9513027039072615, 5.385164807134504
95, 78, 57, 129, 61, 132, -4, -3, -2.498091544796509, 5.0
95, 79, 58, 209, 63, 210, -5, -1, -2.9441970937399127, 5.0990195135927845
95, 80, 46, 206, 49, 208, -3, -2, -2.5535900500422257, 3.605551275463989
95, 81, 574, 367, 572, 367, 2, 0, 0.0, 2.0
95, 83, 33, 184, 35, 185, -2, -1, -2.677945044588987, 2.23606797749979
95, 84, 494, 246, 494, 251, 0, -5, -1.5707963267948966, 5.0
95, 85, 498, 120, 498, 123, 0, -3, -1.5707963267948966, 3.0
95, 86, 80, 140, 86, 141, -6, -1, -2.976443976175166, 6.082762530298219
95, 87, 46, 240, 47, 242, -1, -2, -2.0344439357957027, 2.23606797749979
95, 88, 147, 227, 150, 228, -3, -1, -2.819842099193151, 3.1622776601683795
95, 89, 586, 233, 584, 237, 2, -4, -1.1071487177940904, 4.47213595499958
95, 90, 133, 244, 138, 246, -5, -2, -2.761086276477428, 5.385164807134504
95, 91, 122, 197, 124, 198, -2, -1, -2.677945044588987, 2.23606797749979
95, 92, 79, 186, 84, 189, -5, -3, -2.601173153319209, 5.830951894845301
95, 93, 46, 342, 51, 343, -5, -1, -2.9441970937399127, 5.0990195135927845
95, 94, 82, 213, 85, 214, -3, -1, -2.819842099193151, 3.1622776601683795
95, 95, 303, 365, 307, 364, -4, 1, 2.896613990462929, 4.123105625617661
95, 96, 586, 344, 582, 343, 4, 1, 0.24497866312686414, 4.123105625617661
95, 97, 228, 140, 232, 143, -4, -3, -2.498091544796509, 5.0
95, 98, 588, 316, 584, 317, 4, -1, -0.24497866312686414, 4.123105625617661
95, 99, 160, 329, 163, 330, -3, -1, -2.819842099193151, 3.1622776601683795
95, 100, 313, 256, 318, 259, -5, -3, -2.601173153319209, 5.830951894845301
95, 101, 61, 270, 63, 270, -2, 0, 3.141592653589793, 2.0
95, 102, 104, 109, 107, 110, -3, -1, -2.819842099193151, 3.1622776601683795
95, 103, 603, 167, 605, 168, -2, -1, -2.677945044588987, 2.23606797749979
95, 104, 285, 218, 289, 220, -4, -2, -2.677945044588987, 4.47213595499958
95, 105, 46, 231, 47, 233, -1, -2, -2.0344439357957027, 2.23606797749979
95, 106, 74, 158, 79, 161, -5, -3, -2.601173153319209, 5.830951894845301
95, 107, 170, 366, 174, 366, -4, 0, 3.141592653589793, 4.0
95, 108, 96, 300, 102, 301, -6, -1, -2.976443976175166, 6.082762530298219
95, 109, 365, 265, 370, 268, -5, -3, -2.601173153319209, 5.830951894845301
95, 110, 508, 141, 508, 146, 0, -5, -1.5707963267948966, 5.0
95, 111, 50, 172, 54, 174, -4, -2, -2.677945044588987, 4.47213595499958
95, 113, 123, 349, 127, 349, -4, 0, 3.141592653589793, 4.0
95, 115, 547, 248, 543, 253, 4, -5, -0.8960553845713439, 6.4031242374328485
95, 117, 357, 359, 360, 359, -3, 0, 3.141592653589793, 3.0
95, 118, 575, 271, 573, 274, 2, -3, -0.982793723247329, 3.605551275463989
95, 119, 206, 117, 209, 118, -3, -1, -2.819842099193151, 3.1622776601683795
95, 120, 375, 331, 380, 330, -5, 1, 2.9441970937399127, 5.0990195135927845
95, 121, 42, 328, 43, 330, -1, -2, -2.0344439357957027, 2.23606797749979
95, 122, 484, 196, 484, 201, 0, -5, -1.5707963267948966, 5.0
95, 123, 92, 110, 96, 111, -4, -1, -2.896613990462929, 4.123105625617661
95, 124, 602, 153, 604, 156, -2, -3, -2.158798930342464, 3.605551275463989
95, 126, 107, 208, 114, 208, -7, 0, 3.141592653589793, 7.0
95, 127, 149, 167, 152, 169, -3, -2, -2.5535900500422257, 3.605551275463989
95, 128, 165, 352, 170, 351, -5, 1, 2.9441970937399127, 5.0990195135927845
95, 129, 326, 128, 330, 132, -4, -4, -2.356194490192345, 5.656854249492381
95, 130, 158, 176, 163, 179, -5, -3, -2.601173153319209, 5.830951894845301
95, 131, 588, 182, 587, 185, 1, -3, -1.2490457723982544, 3.1622776601683795
95, 132, 353, 219, 356, 222, -3, -3, -2.356194490192345, 4.242640687119285
95, 133, 554, 197, 551, 201, 3, -4, -0.9272952180016122, 5.0
95, 134, 449, 127, 451, 132, -2, -5, -1.9513027039072615, 5.385164807134504
95, 135, 157, 314, 161, 314, -4, 0, 3.141592653589793, 4.0
95, 136, 297, 339, 302, 339, -5, 0, 3.141592653589793, 5.0
95, 137, 580, 313, 577, 313, 3, 0, 0.0, 3.0
95, 138, 278, 283, 284, 284, -6, -1, -2.976443976175166, 6.082762530298219
95, 139, 65, 145, 70, 148, -5, -3, -2.601173153319209, 5.830951894845301
95, 140, 313, 144, 317, 148, -4, -4, -2.356194490192345, 5.656854249492381
95, 141, 540, 291, 538, 294, 2, -3, -0.982793723247329, 3.605551275463989
95, 142, 527, 150, 527, 154, 0, -4, -1.5707963267948966, 4.0
95, 143, 208, 217, 212, 219, -4, -2, -2.677945044588987, 4.47213595499958
95, 144, 191, 317, 194, 317, -3, 0, 3.141592653589793, 3.0
95, 145, 126, 151, 130, 153, -4, -2, -2.677945044588987, 4.47213595499958
95, 146, 415, 219, 419, 224, -4, -5, -2.2455372690184494, 6.4031242374328485
95, 147, 267, 118, 270, 119, -3, -1, -2.819842099193151, 3.1622776601683795
95, 149, 549, 151, 549, 155, 0, -4, -1.5707963267948966, 4.0
95, 150, 528, 130, 527, 135, 1, -5, -1.373400766945016, 5.0990195135927845
95, 151, 603, 261, 604, 263, -1, -2, -2.0344439357957027, 2.23606797749979
95, 152, 175, 169, 179, 171, -4, -2, -2.677945044588987, 4.47213595499958
95, 153, 331, 164, 334, 167, -3, -3, -2.356194490192345, 4.242640687119285
95, 154, 151, 260, 154, 261, -3, -1, -2.819842099193151, 3.1622776601683795
95, 155, 348, 149, 352, 154, -4, -5, -2.2455372690184494, 6.4031242374328485
95, 156, 335, 210, 339, 213, -4, -3, -2.498091544796509, 5.0
95, 157, 409, 146, 412, 150, -3, -4, -2.214297435588181, 5.0
95, 158, 378, 213, 382, 217, -4, -4, -2.356194490192345, 5.656854249492381
95, 159, 538, 164, 537, 168, 1, -4, -1.3258176636680326, 4.123105625617661
95, 160, 437, 186, 439, 190, -2, -4, -2.0344439357957027, 4.47213595499958
95, 161, 101, 340, 106, 340, -5, 0, 3.141592653589793, 5.0
95, 162, 106, 121, 110, 123, -4, -2, -2.677945044588987, 4.47213595499958
95, 163, 111, 133, 116, 136, -5, -3, -2.601173153319209, 5.830951894845301
95, 164, 189, 132, 193, 135, -4, -3, -2.498091544796509, 5.0
95, 165, 137, 366, 140, 367, -3, -1, -2.819842099193151, 3.1622776601683795
95, 166, 197, 169, 201, 171, -4, -2, -2.677945044588987, 4.47213595499958
95, 167, 401, 179, 403, 183, -2, -4, -2.0344439357957027, 4.47213595499958
95, 168, 371, 162, 375, 165, -4, -3, -2.498091544796509, 5.0
95, 169, 302, 167, 306, 170, -4, -3, -2.498091544796509, 5.0
95, 170, 273, 196, 277, 198, -4, -2, -2.677945044588987, 4.47213595499958
95, 171, 555, 106, 554, 107, 1, -1, -0.7853981633974483, 1.4142135623730951
95, 172, 316, 179, 320, 183, -4, -4, -2.356194490192345, 5.656854249492381
96, 0, 264, 300, 270, 302, -6, -2, -2.819842099193151, 6.324555320336759
96, 1, 104, 162, 108, 165, -4, -3, -2.498091544796509, 5.0
96, 3, 262, 211, 267, 214, -5, -3, -2.601173153319209, 5.830951894845301
96, 4, 596, 178, 596, 182, 0, -4, -1.5707963267948966, 4.0
96, 6, 162, 332, 167, 332, -5, 0, 3.141592653589793, 5.0
96, 7, 44, 268, 45, 270, -1, -2, -2.0344439357957027, 2.23606797749979
96, 8, 197, 134, 201, 138, -4, -4, -2.356194490192345, 5.656854249492381
96, 9, 68, 288, 74, 290, -6, -2, -2.819842099193151, 6.324555320336759
96, 10, 39, 356, 42, 357, -3, -1, -2.819842099193151, 3.1622776601683795
96, 11, 417, 178, 419, 182, -2, -4, -2.0344439357957027, 4.47213595499958
96, 12, 347, 192, 350, 196, -3, -4, -2.214297435588181, 5.0
96, 13, 77, 262, 83, 264, -6, -2, -2.819842099193151, 6.324555320336759
96, 14, 144, 209, 149, 211, -5, -2, -2.761086276477428, 5.385164807134504
96, 15, 419, 296, 423, 299, -4, -3, -2.498091544796509, 5.0
96, 16, 85, 161, 90, 164, -5, -3, -2.601173153319209, 5.830951894845301
96, 17, 340, 314, 345, 316, -5, -2, -2.761086276477428, 5.385164807134504
96, 18, 399, 281, 403, 285, -4, -4, -2.356194490192345, 5.656854249492381
96, 19, 342, 267, 347, 270, -5, -3, -2.601173153319209, 5.830951894845301
96, 20, 244, 110, 246, 111, -2, -1, -2.677945044588987, 2.23606797749979
96, 21, 34, 252, 36, 253, -2, -1, -2.677945044588987, 2.23606797749979
96, 22, 349, 366, 352, 366, -3, 0, 3.141592653589793, 3.0
96, 23, 48, 314, 50, 315, -2, -1, -2.677945044588987, 2.23606797749979
96, 24, 158, 134, 161, 137, -3, -3, -2.356194490192345, 4.242640687119285
96, 26, 39, 239, 39, 241, 0, -2, -1.5707963267948966, 2.0
96, 27, 429, 116, 430, 119, -1, -3, -1.892546881191539, 3.1622776601683795
96, 28, 567, 109, 565, 113, 2, -4, -1.1071487177940904, 4.47213595499958
96, 29, 333, 115, 335, 115, -2, 0, 3.141592653589793, 2.0
96, 30, 506, 116, 505, 120, 1, -4, -1.3258176636680326, 4.123105625617661
96, 31, 404, 116, 405, 118, -1, -2, -2.0344439357957027, 2.23606797749979
96, 33, 577, 129, 577, 133, 0, -4, -1.5707963267948966, 4.0
96, 34, 590, 121, 588, 125, 2, -4, -1.1071487177940904, 4.47213595499958
96, 35, 297, 199, 300, 201, -3, -2, -2.5535900500422257, 3.605551275463989
96, 36, 563, 108, 562, 109, 1, -1, -0.7853981633974483, 1.4142135623730951
96, 37, 364, 142, 367, 146, -3, -4, -2.214297435588181, 5.0
96, 39, 295, 219, 300, 221, -5, -2, -2.761086276477428, 5.385164807134504
96, 40, 45, 365, 47, 366, -2, -1, -2.677945044588987, 2.23606797749979
96, 42, 257, 121, 260, 123, -3, -2, -2.5535900500422257, 3.605551275463989
96, 43, 77, 364, 82, 365, -5, -1, -2.9441970937399127, 5.0990195135927845
96, 44, 286, 116, 288, 117, -2, -1, -2.677945044588987, 2.23606797749979
96, 45, 436, 198, 437, 203, -1, -5, -1.7681918866447774, 5.0990195135927845
96, 46, 234, 291, 239, 293, -5, -2, -2.761086276477428, 5.385164807134504
96, 47, 39, 223, 42, 224, -3, -1, -2.819842099193151, 3.1622776601683795
96, 48, 391, 368, 394, 368, -3, 0, 3.141592653589793, 3.0
96, 49, 597, 137, 597, 140, 0, -3, -1.5707963267948966, 3.0
96, 50, 558, 130, 556, 135, 2, -5, -1.1902899496825317, 5.385164807134504
96, 52, 244, 124, 247, 127, -3, -3, -2.356194490192345, 4.242640687119285
96, 53, 299, 106, 301, 106, -2, 0, 3.141592653589793, 2.0
96, 56, 38, 363, 40, 364, -2, -1, -2.677945044588987, 2.23606797749979
96, 57, 541, 260, 537, 264, 4, -4, -0.7853981633974483, 5.656854249492381
96, 58, 71, 114, 74, 114, -3, 0, 3.141592653589793, 3.0
96, 59, 380, 360, 384, 359, -4, 1, 2.896613990462929, 4.123105625617661
96, 61, 224, 271, 229, 273, -5, -2, -2.761086276477428, 5.385164807134504
96, 62, 596, 152, 596, 154, 0, -2, -1.5707963267948966, 2.0
96, 63, 124, 112, 126, 113, -2, -1, -2.677945044588987, 2.23606797749979
96, 64, 592, 305, 592, 307, 0, -2, -1.5707963267948966, 2.0
96, 65, 160, 105, 163, 105, -3, 0, 3.141592653589793, 3.0
96, 66, 184, 201, 189, 204, -5, -3, -2.601173153319209, 5.830951894845301
96, 68, 40, 211, 40, 213, 0, -2, -1.5707963267948966, 2.0
96, 69, 40, 293, 43, 294, -3, -1, -2.819842099193151, 3.1622776601683795
96, 70, 556, 224, 554, 228, 2, -4, -1.1071487177940904, 4.47213595499958
96, 71, 74, 313, 79, 314, -5, -1, -2.9441970937399127, 5.0990195135927845
96, 72, 202, 104, 204, 105, -2, -1, -2.677945044588987, 2.23606797749979
96, 73, 604, 242, 603, 243, 1, -1, -0.7853981633974483, 1.4142135623730951
96, 74, 594, 230, 592, 234, 2, -4, -1.1071487177940904, 4.47213595499958
96, 75, 484, 121, 484, 126, 0, -5, -1.5707963267948966, 5.0
96, 76, 54, 127, 57, 129, -3, -2, -2.5535900500422257, 3.605551275463989
96, 77, 55, 207, 58, 209, -3, -2, -2.5535900500422257, 3.605551275463989
96, 78, 44, 205, 46, 206, -2, -1, -2.677945044588987, 2.23606797749979
96, 79, 575, 366, 574, 367, 1, -1, -0.7853981633974483, 1.4142135623730951
96, 80, 473, 112, 474, 111, -1, 1, 2.356194490192345, 1.4142135623730951
96, 82, 495, 241, 494, 246, 1, -5, -1.373400766945016, 5.0990195135927845
96, 83, 498, 118, 498, 120, 0, -2, -1.5707963267948966, 2.0
96, 84, 75, 138, 80, 140, -5, -2, -2.761086276477428, 5.385164807134504
96, 85, 46, 237, 46, 240, 0, -3, -1.5707963267948966, 3.0
96, 86, 143, 225, 147, 227, -4, -2, -2.677945044588987, 4.47213595499958
96, 87, 589, 229, 586, 233, 3, -4, -0.9272952180016122, 5.0
96, 88, 127, 243, 133, 244, -6, -1, -2.976443976175166, 6.082762530298219
96, 89, 119, 196, 122, 197, -3, -1, -2.819842099193151, 3.1622776601683795
96, 90, 75, 184, 79, 186, -4, -2, -2.677945044588987, 4.47213595499958
96, 91, 43, 341, 46, 342, -3, -1, -2.819842099193151, 3.1622776601683795
96, 92, 78, 212, 82, 213, -4, -1, -2.896613990462929, 4.123105625617661
96, 93, 299, 366, 303, 365, -4, 1, 2.896613990462929, 4.123105625617661
96, 94, 590, 345, 586, 344, 4, 1, 0.24497866312686414, 4.123105625617661
96, 95, 226, 139, 228, 140, -2, -1, -2.677945044588987, 2.23606797749979
96, 96, 590, 315, 588, 316, 2, -1, -0.4636476090008061, 2.23606797749979
96, 97, 157, 328, 160, 329, -3, -1, -2.819842099193151, 3.1622776601683795
96, 98, 309, 254, 313, 256, -4, -2, -2.677945044588987, 4.47213595499958
96, 99, 59, 268, 61, 270, -2, -2, -2.356194490192345, 2.8284271247461903
96, 101, 601, 166, 603, 167, -2, -1, -2.677945044588987, 2.23606797749979
96, 102, 280, 215, 285, 218, -5, -3, -2.601173153319209, 5.830951894845301
96, 103, 44, 229, 46, 231, -2, -2, -2.356194490192345, 2.8284271247461903
96, 104, 69, 157, 74, 158, -5, -1, -2.9441970937399127, 5.0990195135927845
96, 105, 165, 365, 170, 366, -5, -1, -2.9441970937399127, 5.0990195135927845
96, 106, 91, 300, 96, 300, -5, 0, 3.141592653589793, 5.0
96, 107, 361, 263, 365, 265, -4, -2, -2.677945044588987, 4.47213595499958
96, 108, 509, 136, 508, 141, 1, -5, -1.373400766945016, 5.0990195135927845
96, 109, 47, 170, 50, 172, -3, -2, -2.5535900500422257, 3.605551275463989
96, 111, 118, 350, 123, 349, -5, 1, 2.9441970937399127, 5.0990195135927845
96, 113, 549, 244, 547, 248, 2, -4, -1.1071487177940904, 4.47213595499958
96, 114, 545, 355, 544, 356, 1, -1, -0.7853981633974483, 1.4142135623730951
96, 115, 355, 359, 357, 359, -2, 0, 3.141592653589793, 2.0
96, 116, 577, 267, 575, 271, 2, -4, -1.1071487177940904, 4.47213595499958
96, 117, 203, 115, 206, 117, -3, -2, -2.5535900500422257, 3.605551275463989
96, 118, 370, 332, 375, 331, -5, 1, 2.9441970937399127, 5.0990195135927845
96, 120, 483, 190, 484, 196, -1, -6, -1.7359450042095235, 6.082762530298219
96, 121, 88, 109, 92, 110, -4, -1, -2.896613990462929, 4.123105625617661
96, 122, 601, 151, 602, 153, -1, -2, -2.0344439357957027, 2.23606797749979
96, 124, 101, 206, 107, 208, -6, -2, -2.819842099193151, 6.324555320336759
96, 125, 145, 165, 149, 167, -4, -2, -2.677945044588987, 4.47213595499958
96, 126, 160, 353, 165, 352, -5, 1, 2.9441970937399127, 5.0990195135927845
96, 127, 323, 125, 326, 128, -3, -3, -2.356194490192345, 4.242640687119285
96, 128, 153, 174, 158, 176, -5, -2, -2.761086276477428, 5.385164807134504
96, 129, 588, 179, 588, 182, 0, -3, -1.5707963267948966, 3.0
96, 130, 350, 217, 353, 219, -3, -2, -2.5535900500422257, 3.605551275463989
96, 131, 556, 193, 554, 197, 2, -4, -1.1071487177940904, 4.47213595499958
96, 132, 448, 123, 449, 127, -1, -4, -1.8157749899217608, 4.123105625617661
96, 133, 152, 313, 157, 314, -5, -1, -2.9441970937399127, 5.0990195135927845
96, 134, 292, 339, 297, 339, -5, 0, 3.141592653589793, 5.0
96, 135, 583, 312, 580, 313, 3, -1, -0.3217505543966422, 3.1622776601683795
96, 136, 271, 281, 278, 283, -7, -2, -2.8632929945846817, 7.280109889280518
96, 137, 60, 142, 65, 145, -5, -3, -2.601173153319209, 5.830951894845301
96, 138, 309, 140, 313, 144, -4, -4, -2.356194490192345, 5.656854249492381
96, 139, 541, 288, 540, 291, 1, -3, -1.2490457723982544, 3.1622776601683795
96, 140, 526, 147, 527, 150, -1, -3, -1.892546881191539, 3.1622776601683795
96, 141, 204, 215, 208, 217, -4, -2, -2.677945044588987, 4.47213595499958
96, 142, 188, 317, 191, 317, -3, 0, 3.141592653589793, 3.0
96, 143, 122, 150, 126, 151, -4, -1, -2.896613990462929, 4.123105625617661
96, 144, 412, 215, 415, 219, -3, -4, -2.214297435588181, 5.0
96, 145, 264, 116, 267, 118, -3, -2, -2.5535900500422257, 3.605551275463989
96, 147, 551, 147, 549, 151, 2, -4, -1.1071487177940904, 4.47213595499958
96, 148, 529, 126, 528, 130, 1, -4, -1.3258176636680326, 4.123105625617661
96, 149, 170, 166, 175, 169, -5, -3, -2.601173153319209, 5.830951894845301
96, 150, 326, 159, 331, 164, -5, -5, -2.356194490192345, 7.0710678118654755
96, 151, 147, 259, 151, 260, -4, -1, -2.896613990462929, 4.123105625617661
96, 152, 343, 146, 348, 149, -5, -3, -2.601173153319209, 5.830951894845301
96, 153, 332, 207, 335, 210, -3, -3, -2.356194490192345, 4.242640687119285
96, 154, 406, 141, 409, 146, -3, -5, -2.1112158270654806, 5.830951894845301
96, 155, 374, 208, 378, 213, -4, -5, -2.2455372690184494, 6.4031242374328485
96, 156, 539, 159, 538, 164, 1, -5, -1.373400766945016, 5.0990195135927845
96, 157, 435, 183, 437, 186, -2, -3, -2.158798930342464, 3.605551275463989
96, 158, 97, 340, 101, 340, -4, 0, 3.141592653589793, 4.0
96, 159, 102, 120, 106, 121, -4, -1, -2.896613990462929, 4.123105625617661
96, 160, 108, 131, 111, 133, -3, -2, -2.5535900500422257, 3.605551275463989
96, 161, 185, 129, 189, 132, -4, -3, -2.498091544796509, 5.0
96, 162, 133, 366, 137, 366, -4, 0, 3.141592653589793, 4.0
96, 163, 193, 168, 197, 169, -4, -1, -2.896613990462929, 4.123105625617661
96, 164, 398, 175, 401, 179, -3, -4, -2.214297435588181, 5.0
96, 165, 369, 159, 371, 162, -2, -3, -2.158798930342464, 3.605551275463989
96, 166, 298, 165, 302, 167, -4, -2, -2.677945044588987, 4.47213595499958
96, 167, 269, 193, 273, 196, -4, -3, -2.498091544796509, 5.0
96, 169, 312, 176, 316, 179, -4, -3, -2.498091544796509, 5.0
97, 0, 261, 297, 264, 300, -3, -3, -2.356194490192345, 4.242640687119285
97, 1, 99, 159, 104, 162, -5, -3, -2.601173153319209, 5.830951894845301
97, 3, 258, 208, 262, 211, -4, -3, -2.498091544796509, 5.0
97, 4, 595, 176, 596, 178, -1, -2, -2.0344439357957027, 2.23606797749979
97, 6, 159, 331, 162, 332, -3, -1, -2.819842099193151, 3.1622776601683795
97, 7, 42, 267, 44, 268, -2, -1, -2.677945044588987, 2.23606797749979
97, 8, 193, 131, 197, 134, -4, -3, -2.498091544796509, 5.0
97, 9, 62, 288, 68, 288, -6, 0, 3.141592653589793, 6.0
97, 10, 415, 173, 417, 178, -2, -5, -1.9513027039072615, 5.385164807134504
97, 11, 344, 189, 347, 192, -3, -3, -2.356194490192345, 4.242640687119285
97, 12, 72, 261, 77, 262, -5, -1, -2.9441970937399127, 5.0990195135927845
97, 13, 140, 207, 144, 209, -4, -2, -2.677945044588987, 4.47213595499958
97, 14, 414, 293, 419, 296, -5, -3, -2.601173153319209, 5.830951894845301
97, 15, 80, 159, 85, 161, -5, -2, -2.761086276477428, 5.385164807134504
97, 16, 335, 313, 340, 314, -5, -1, -2.9441970937399127, 5.0990195135927845
97, 17, 396, 278, 399, 281, -3, -3, -2.356194490192345, 4.242640687119285
97, 18, 339, 264, 342, 267, -3, -3, -2.356194490192345, 4.242640687119285
97, 19, 345, 365, 349, 366, -4, -1, -2.896613990462929, 4.123105625617661
97, 21, 154, 132, 158, 134, -4, -2, -2.677945044588987, 4.47213595499958
97, 23, 428, 114, 429, 116, -1, -2, -2.0344439357957027, 2.23606797749979
97, 24, 568, 107, 567, 109, 1, -2, -1.1071487177940904, 2.23606797749979
97, 26, 507, 113, 506, 116, 1, -3, -1.2490457723982544, 3.1622776601683795
97, 27, 404, 114, 404, 116, 0, -2, -1.5707963267948966, 2.0
97, 29, 578, 124, 577, 129, 1, -5, -1.373400766945016, 5.0990195135927845
97, 30, 592, 118, 590, 121, 2, -3, -0.982793723247329, 3.605551275463989
97, 31, 294, 196, 297, 199, -3, -3, -2.356194490192345, 4.242640687119285
97, 33, 362, 139, 364, 142, -2, -3, -2.158798930342464, 3.605551275463989
97, 34, 552, 366, 551, 367, 1, -1, -0.7853981633974483, 1.4142135623730951
97, 35, 293, 217, 295, 219, -2, -2, -2.356194490192345, 2.8284271247461903
97, 37, 593, 191, 594, 196, -1, -5, -1.7681918866447774, 5.0990195135927845
97, 38, 254, 118, 257, 121, -3, -3, -2.356194490192345, 4.242640687119285
97, 39, 75, 362, 77, 364, -2, -2, -2.356194490192345, 2.8284271247461903
97, 40, 284, 116, 286, 116, -2, 0, 3.141592653589793, 2.0
97, 41, 434, 194, 436, 198, -2, -4, -2.0344439357957027, 4.47213595499958
97, 42, 230, 290, 234, 291, -4, -1, -2.896613990462929, 4.123105625617661
97, 43, 37, 222, 39, 223, -2, -1, -2.677945044588987, 2.23606797749979
97, 44, 388, 368, 391, 368, -3, 0, 3.141592653589793, 3.0
97, 45, 597, 134, 597, 137, 0, -3, -1.5707963267948966, 3.0
97, 46, 559, 126, 558, 130, 1, -4, -1.3258176636680326, 4.123105625617661
97, 48, 240, 121, 244, 124, -4, -3, -2.498091544796509, 5.0
97, 50, 596, 363, 594, 363, 2, 0, 0.0, 2.0
97, 53, 543, 256, 541, 260, 2, -4, -1.1071487177940904, 4.47213595499958
97, 54, 69, 114, 71, 114, -2, 0, 3.141592653589793, 2.0
97, 55, 376, 360, 380, 360, -4, 0, 3.141592653589793, 4.0
97, 56, 219, 268, 224, 271, -5, -3, -2.601173153319209, 5.830951894845301
97, 57, 595, 150, 596, 152, -1, -2, -2.0344439357957027, 2.23606797749979
97, 58, 122, 111, 124, 112, -2, -1, -2.677945044588987, 2.23606797749979
97, 59, 158, 105, 160, 105, -2, 0, 3.141592653589793, 2.0
97, 60, 180, 199, 184, 201, -4, -2, -2.677945044588987, 4.47213595499958
97, 62, 37, 210, 40, 211, -3, -1, -2.819842099193151, 3.1622776601683795
97, 63, 38, 293, 40, 293, -2, 0, 3.141592653589793, 2.0
97, 64, 557, 220, 556, 224, 1, -4, -1.3258176636680326, 4.123105625617661
97, 65, 68, 311, 74, 313, -6, -2, -2.819842099193151, 6.324555320336759
97, 66, 200, 103, 202, 104, -2, -1, -2.677945044588987, 2.23606797749979
97, 68, 595, 227, 594, 230, 1, -3, -1.2490457723982544, 3.1622776601683795
97, 69, 484, 118, 484, 121, 0, -3, -1.5707963267948966, 3.0
97, 70, 51, 125, 54, 127, -3, -2, -2.5535900500422257, 3.605551275463989
97, 71, 52, 205, 55, 207, -3, -2, -2.5535900500422257, 3.605551275463989
97, 72, 576, 365, 575, 366, 1, -1, -0.7853981633974483, 1.4142135623730951
97, 74, 496, 237, 495, 241, 1, -4, -1.3258176636680326, 4.123105625617661
97, 75, 499, 116, 498, 118, 1, -2, -1.1071487177940904, 2.23606797749979
97, 76, 73, 136, 75, 138, -2, -2, -2.356194490192345, 2.8284271247461903
97, 77, 138, 224, 143, 225, -5, -1, -2.9441970937399127, 5.0990195135927845
97, 78, 591, 226, 589, 229, 2, -3, -0.982793723247329, 3.605551275463989
97, 79, 126, 240, 127, 243, -1, -3, -1.892546881191539, 3.1622776601683795
97, 80, 114, 194, 119, 196, -5, -2, -2.761086276477428, 5.385164807134504
97, 81, 71, 182, 75, 184, -4, -2, -2.677945044588987, 4.47213595499958
97, 82, 41, 340, 43, 341, -2, -1, -2.677945044588987, 2.23606797749979
97, 83, 73, 211, 78, 212, -5, -1, -2.9441970937399127, 5.0990195135927845
97, 84, 296, 366, 299, 366, -3, 0, 3.141592653589793, 3.0
97, 85, 594, 345, 590, 345, 4, 0, 0.0, 4.0
97, 86, 222, 137, 226, 139, -4, -2, -2.677945044588987, 4.47213595499958
97, 87, 592, 314, 590, 315, 2, -1, -0.4636476090008061, 2.23606797749979
97, 88, 152, 328, 157, 328, -5, 0, 3.141592653589793, 5.0
97, 89, 305, 252, 309, 254, -4, -2, -2.677945044588987, 4.47213595499958
97, 90, 57, 267, 59, 268, -2, -1, -2.677945044588987, 2.23606797749979
97, 91, 102, 110, 103, 109, -1, 1, 2.356194490192345, 1.4142135623730951
97, 92, 599, 165, 601, 166, -2, -1, -2.677945044588987, 2.23606797749979
97, 93, 275, 212, 280, 215, -5, -3, -2.601173153319209, 5.830951894845301
97, 94, 42, 228, 44, 229, -2, -1, -2.677945044588987, 2.23606797749979
97, 95, 65, 155, 69, 157, -4, -2, -2.677945044588987, 4.47213595499958
97, 96, 161, 365, 165, 365, -4, 0, 3.141592653589793, 4.0
97, 97, 85, 298, 91, 300, -6, -2, -2.819842099193151, 6.324555320336759
97, 98, 357, 260, 361, 263, -4, -3, -2.498091544796509, 5.0
97, 99, 509, 131, 509, 136, 0, -5, -1.5707963267948966, 5.0
97, 100, 44, 168, 47, 170, -3, -2, -2.5535900500422257, 3.605551275463989
97, 102, 114, 350, 118, 350, -4, 0, 3.141592653589793, 4.0
97, 104, 550, 240, 549, 244, 1, -4, -1.3258176636680326, 4.123105625617661
97, 105, 546, 354, 545, 355, 1, -1, -0.7853981633974483, 1.4142135623730951
97, 106, 352, 359, 355, 359, -3, 0, 3.141592653589793, 3.0
97, 107, 579, 264, 577, 267, 2, -3, -0.982793723247329, 3.605551275463989
97, 108, 201, 114, 203, 115, -2, -1, -2.677945044588987, 2.23606797749979
97, 109, 366, 333, 370, 332, -4, 1, 2.896613990462929, 4.123105625617661
97, 110, 482, 186, 483, 190, -1, -4, -1.8157749899217608, 4.123105625617661
97, 111, 86, 108, 88, 109, -2, -1, -2.677945044588987, 2.23606797749979
97, 112, 600, 149, 601, 151, -1, -2, -2.0344439357957027, 2.23606797749979
97, 114, 95, 204, 101, 206, -6, -2, -2.819842099193151, 6.324555320336759
97, 115, 140, 162, 145, 165, -5, -3, -2.601173153319209, 5.830951894845301
97, 116, 156, 352, 160, 353, -4, -1, -2.896613990462929, 4.123105625617661
97, 117, 320, 123, 323, 125, -3, -2, -2.5535900500422257, 3.605551275463989
97, 118, 149, 172, 153, 174, -4, -2, -2.677945044588987, 4.47213595499958
97, 119, 588, 176, 588, 179, 0, -3, -1.5707963267948966, 3.0
97, 120, 346, 214, 350, 217, -4, -3, -2.498091544796509, 5.0
97, 121, 558, 189, 556, 193, 2, -4, -1.1071487177940904, 4.47213595499958
97, 122, 447, 121, 448, 123, -1, -2, -2.0344439357957027, 2.23606797749979
97, 123, 148, 312, 152, 313, -4, -1, -2.896613990462929, 4.123105625617661
97, 124, 286, 338, 292, 339, -6, -1, -2.976443976175166, 6.082762530298219
97, 125, 585, 312, 583, 312, 2, 0, 0.0, 2.0
97, 126, 266, 280, 271, 281, -5, -1, -2.9441970937399127, 5.0990195135927845
97, 127, 56, 139, 60, 142, -4, -3, -2.498091544796509, 5.0
97, 128, 307, 138, 309, 140, -2, -2, -2.356194490192345, 2.8284271247461903
97, 129, 543, 285, 541, 288, 2, -3, -0.982793723247329, 3.605551275463989
97, 130, 527, 143, 526, 147, 1, -4, -1.3258176636680326, 4.123105625617661
97, 131, 200, 213, 204, 215, -4, -2, -2.677945044588987, 4.47213595499958
97, 132, 183, 317, 188, 317, -5, 0, 3.141592653589793, 5.0
97, 133, 118, 147, 122, 150, -4, -3, -2.498091544796509, 5.0
97, 134, 409, 212, 412, 215, -3, -3, -2.356194490192345, 4.242640687119285
97, 135, 262, 115, 264, 116, -2, -1, -2.677945044588987, 2.23606797749979
97, 137, 553, 144, 551, 147, 2, -3, -0.982793723247329, 3.605551275463989
97, 138, 530, 124, 529, 126, 1, -2, -1.1071487177940904, 2.23606797749979
97, 139, 165, 164, 170, 166, -5, -2, -2.761086276477428, 5.385164807134504
97, 140, 321, 156, 326, 159, -5, -3, -2.601173153319209, 5.830951894845301
97, 141, 142, 258, 147, 259, -5, -1, -2.9441970937399127, 5.0990195135927845
97, 142, 340, 144, 343, 146, -3, -2, -2.5535900500422257, 3.605551275463989
97, 143, 329, 204, 332, 207, -3, -3, -2.356194490192345, 4.242640687119285
97, 144, 403, 137, 406, 141, -3, -4, -2.214297435588181, 5.0
97, 145, 372, 205, 374, 208, -2, -3, -2.158798930342464, 3.605551275463989
97, 146, 540, 155, 539, 159, 1, -4, -1.3258176636680326, 4.123105625617661
97, 147, 433, 181, 435, 183, -2, -2, -2.356194490192345, 2.8284271247461903
97, 148, 92, 340, 97, 340, -5, 0, 3.141592653589793, 5.0
97, 149, 99, 119, 102, 120, -3, -1, -2.819842099193151, 3.1622776601683795
97, 150, 106, 129, 108, 131, -2, -2, -2.356194490192345, 2.8284271247461903
97, 151, 181, 126, 185, 129, -4, -3, -2.498091544796509, 5.0
97, 152, 129, 366, 133, 366, -4, 0, 3.141592653589793, 4.0
97, 153, 191, 165, 193, 168, -2, -3, -2.158798930342464, 3.605551275463989
97, 154, 395, 172, 398, 175, -3, -3, -2.356194490192345, 4.242640687119285
97, 155, 367, 156, 369, 159, -2, -3, -2.158798930342464, 3.605551275463989
97, 156, 294, 162, 298, 165, -4, -3, -2.498091544796509, 5.0
97, 157, 264, 191, 269, 193, -5, -2, -2.761086276477428, 5.385164807134504
97, 158, 556, 104, 555, 105, 1, -1, -0.7853981633974483, 1.4142135623730951
97, 159, 308, 173, 312, 176, -4, -3, -2.498091544796509, 5.0
98, 0, 96, 158, 99, 159, -3, -1, -2.819842099193151, 3.1622776601683795
98, 2, 255, 206, 258, 208, -3, -2, -2.5535900500422257, 3.605551275463989
98, 3, 594, 173, 595, 176, -1, -3, -1.892546881191539, 3.1622776601683795
98, 5, 154, 331, 159, 331, -5, 0, 3.141592653589793, 5.0
98, 7, 189, 128, 193, 131, -4, -3, -2.498091544796509, 5.0
98, 8, 58, 287, 62, 288, -4, -1, -2.896613990462929, 4.123105625617661
98, 9, 413, 171, 415, 173, -2, -2, -2.356194490192345, 2.8284271247461903
98, 10, 340, 186, 344, 189, -4, -3, -2.498091544796509, 5.0
98, 11, 66, 259, 72, 261, -6, -2, -2.819842099193151, 6.324555320336759
98, 12, 143, 206, 140, 207, 3, -1, -0.3217505543966422, 3.1622776601683795
98, 13, 410, 291, 414, 293, -4, -2, -2.677945044588987, 4.47213595499958
98, 14, 77, 158, 80, 159, -3, -1, -2.819842099193151, 3.1622776601683795
98, 15, 331, 313, 335, 313, -4, 0, 3.141592653589793, 4.0
98, 16, 392, 275, 396, 278, -4, -3, -2.498091544796509, 5.0
98, 17, 336, 262, 339, 264, -3, -2, -2.5535900500422257, 3.605551275463989
98, 18, 343, 365, 345, 365, -2, 0, 3.141592653589793, 2.0
98, 20, 150, 131, 154, 132, -4, -1, -2.896613990462929, 4.123105625617661
98, 23, 569, 106, 568, 107, 1, -1, -0.7853981633974483, 1.4142135623730951
98, 26, 38, 202, 37, 203, 1, -1, -0.7853981633974483, 1.4142135623730951
98, 27, 592, 116, 592, 118, 0, -2, -1.5707963267948966, 2.0
98, 28, 292, 195, 294, 196, -2, -1, -2.677945044588987, 2.23606797749979
98, 30, 359, 135, 362, 139, -3, -4, -2.214297435588181, 5.0
98, 33, 593, 189, 593, 191, 0, -2, -1.5707963267948966, 2.0
98, 34, 252, 117, 254, 118, -2, -1, -2.677945044588987, 2.23606797749979
98, 35, 73, 361, 75, 362, -2, -1, -2.677945044588987, 2.23606797749979
98, 36, 434, 192, 434, 194, 0, -2, -1.5707963267948966, 2.0
98, 37, 227, 289, 230, 290, -3, -1, -2.819842099193151, 3.1622776601683795
98, 39, 385, 368, 388, 368, -3, 0, 3.141592653589793, 3.0
98, 40, 598, 132, 597, 134, 1, -2, -1.1071487177940904, 2.23606797749979
98, 41, 558, 122, 559, 126, -1, -4, -1.8157749899217608, 4.123105625617661
98, 43, 237, 118, 240, 121, -3, -3, -2.356194490192345, 4.242640687119285
98, 48, 543, 252, 543, 256, 0, -4, -1.5707963267948966, 4.0
98, 49, 67, 114, 69, 114, -2, 0, 3.141592653589793, 2.0
98, 50, 373, 360, 376, 360, -3, 0, 3.141592653589793, 3.0
98, 51, 216, 266, 219, 268, -3, -2, -2.5535900500422257, 3.605551275463989
98, 52, 595, 148, 595, 150, 0, -2, -1.5707963267948966, 2.0
98, 53, 120, 110, 122, 111, -2, -1, -2.677945044588987, 2.23606797749979
98, 54, 156, 105, 158, 105, -2, 0, 3.141592653589793, 2.0
98, 55, 178, 199, 180, 199, -2, 0, 3.141592653589793, 2.0
98, 56, 339, 106, 341, 106, -2, 0, 3.141592653589793, 2.0
98, 58, 36, 292, 38, 293, -2, -1, -2.677945044588987, 2.23606797749979
98, 60, 65, 307, 68, 311, -3, -4, -2.214297435588181, 5.0
98, 61, 595, 224, 595, 227, 0, -3, -1.5707963267948966, 3.0
98, 62, 484, 116, 484, 118, 0, -2, -1.5707963267948966, 2.0
98, 63, 50, 204, 52, 205, -2, -1, -2.677945044588987, 2.23606797749979
98, 64, 577, 364, 576, 365, 1, -1, -0.7853981633974483, 1.4142135623730951
98, 65, 471, 110, 473, 112, -2, -2, -2.356194490192345, 2.8284271247461903
98, 66, 496, 233, 496, 237, 0, -4, -1.5707963267948966, 4.0
98, 68, 71, 134, 73, 136, -2, -2, -2.356194490192345, 2.8284271247461903
98, 69, 133, 222, 138, 224, -5, -2, -2.761086276477428, 5.385164807134504
98, 70, 592, 224, 591, 226, 1, -2, -1.1071487177940904, 2.23606797749979
98, 71, 122, 238, 126, 240, -4, -2, -2.677945044588987, 4.47213595499958
98, 72, 109, 193, 114, 194, -5, -1, -2.9441970937399127, 5.0990195135927845
98, 73, 67, 182, 71, 182, -4, 0, 3.141592653589793, 4.0
98, 74, 39, 340, 41, 340, -2, 0, 3.141592653589793, 2.0
98, 75, 68, 209, 73, 211, -5, -2, -2.761086276477428, 5.385164807134504
98, 76, 291, 366, 296, 366, -5, 0, 3.141592653589793, 5.0
98, 77, 596, 346, 594, 345, 2, 1, 0.4636476090008061, 2.23606797749979
98, 78, 218, 134, 222, 137, -4, -3, -2.498091544796509, 5.0
98, 79, 594, 314, 592, 314, 2, 0, 0.0, 2.0
98, 80, 146, 328, 152, 328, -6, 0, 3.141592653589793, 6.0
98, 81, 300, 250, 305, 252, -5, -2, -2.761086276477428, 5.385164807134504
98, 82, 100, 110, 102, 110, -2, 0, 3.141592653589793, 2.0
98, 83, 597, 164, 599, 165, -2, -1, -2.677945044588987, 2.23606797749979
98, 84, 272, 210, 275, 212, -3, -2, -2.5535900500422257, 3.605551275463989
98, 85, 62, 156, 65, 155, -3, 1, 2.819842099193151, 3.1622776601683795
98, 86, 155, 364, 161, 365, -6, -1, -2.976443976175166, 6.082762530298219
98, 87, 84, 296, 85, 298, -1, -2, -2.0344439357957027, 2.23606797749979
98, 88, 353, 257, 357, 260, -4, -3, -2.498091544796509, 5.0
98, 91, 109, 350, 114, 350, -5, 0, 3.141592653589793, 5.0
98, 93, 549, 237, 550, 240, -1, -3, -1.892546881191539, 3.1622776601683795
98, 94, 547, 353, 546, 354, 1, -1, -0.7853981633974483, 1.4142135623730951
98, 95, 349, 358, 352, 359, -3, -1, -2.819842099193151, 3.1622776601683795
98, 96, 581, 261, 579, 264, 2, -3, -0.982793723247329, 3.605551275463989
98, 97, 362, 334, 366, 333, -4, 1, 2.896613990462929, 4.123105625617661
98, 98, 482, 183, 482, 186, 0, -3, -1.5707963267948966, 3.0
98, 99, 83, 107, 86, 108, -3, -1, -2.819842099193151, 3.1622776601683795
98, 100, 600, 147, 600, 149, 0, -2, -1.5707963267948966, 2.0
98, 102, 93, 203, 95, 204, -2, -1, -2.677945044588987, 2.23606797749979
98, 103, 137, 158, 140, 162, -3, -4, -2.214297435588181, 5.0
98, 104, 153, 350, 156, 352, -3, -2, -2.5535900500422257, 3.605551275463989
98, 105, 318, 121, 320, 123, -2, -2, -2.356194490192345, 2.8284271247461903
98, 106, 146, 170, 149, 172, -3, -2, -2.5535900500422257, 3.605551275463989
98, 107, 587, 174, 588, 176, -1, -2, -2.0344439357957027, 2.23606797749979
98, 108, 343, 211, 346, 214, -3, -3, -2.356194490192345, 4.242640687119285
98, 109, 560, 185, 558, 189, 2, -4, -1.1071487177940904, 4.47213595499958
98, 110, 446, 119, 447, 121, -1, -2, -2.0344439357957027, 2.23606797749979
98, 111, 145, 312, 148, 312, -3, 0, 3.141592653589793, 3.0
98, 112, 281, 338, 286, 338, -5, 0, 3.141592653589793, 5.0
98, 113, 587, 312, 585, 312, 2, 0, 0.0, 2.0
98, 114, 265, 278, 266, 280, -1, -2, -2.0344439357957027, 2.23606797749979
98, 115, 54, 139, 56, 139, -2, 0, 3.141592653589793, 2.0
98, 116, 303, 135, 307, 138, -4, -3, -2.498091544796509, 5.0
98, 117, 527, 140, 527, 143, 0, -3, -1.5707963267948966, 3.0
98, 118, 197, 211, 200, 213, -3, -2, -2.5535900500422257, 3.605551275463989
98, 119, 178, 317, 183, 317, -5, 0, 3.141592653589793, 5.0
98, 120, 114, 146, 118, 147, -4, -1, -2.896613990462929, 4.123105625617661
98, 121, 406, 210, 409, 212, -3, -2, -2.5535900500422257, 3.605551275463989
98, 122, 260, 113, 262, 115, -2, -2, -2.356194490192345, 2.8284271247461903
98, 124, 554, 140, 553, 144, 1, -4, -1.3258176636680326, 4.123105625617661
98, 125, 532, 122, 530, 124, 2, -2, -0.7853981633974483, 2.8284271247461903
98, 126, 162, 160, 165, 164, -3, -4, -2.214297435588181, 5.0
98, 127, 318, 154, 321, 156, -3, -2, -2.5535900500422257, 3.605551275463989
98, 128, 138, 256, 142, 258, -4, -2, -2.677945044588987, 4.47213595499958
98, 129, 337, 140, 340, 144, -3, -4, -2.214297435588181, 5.0
98, 130, 327, 202, 329, 204, -2, -2, -2.356194490192345, 2.8284271247461903
98, 131, 401, 134, 403, 137, -2, -3, -2.158798930342464, 3.605551275463989
98, 132, 372, 202, 372, 205, 0, -3, -1.5707963267948966, 3.0
98, 133, 541, 151, 540, 155, 1, -4, -1.3258176636680326, 4.123105625617661
98, 134, 430, 179, 433, 181, -3, -2, -2.5535900500422257, 3.605551275463989
98, 135, 87, 340, 92, 340, -5, 0, 3.141592653589793, 5.0
98, 136, 96, 118, 99, 119, -3, -1, -2.819842099193151, 3.1622776601683795
98, 137, 104, 127, 106, 129, -2, -2, -2.356194490192345, 2.8284271247461903
98, 138, 178, 124, 181, 126, -3, -2, -2.5535900500422257, 3.605551275463989
98, 139, 125, 366, 129, 366, -4, 0, 3.141592653589793, 4.0
98, 140, 188, 162, 191, 165, -3, -3, -2.356194490192345, 4.242640687119285
98, 141, 393, 168, 395, 172, -2, -4, -2.0344439357957027, 4.47213595499958
98, 142, 364, 153, 367, 156, -3, -3, -2.356194490192345, 4.242640687119285
98, 143, 290, 161, 294, 162, -4, -1, -2.896613990462929, 4.123105625617661
98, 144, 261, 190, 264, 191, -3, -1, -2.819842099193151, 3.1622776601683795
98, 145, 304, 170, 308, 173, -4, -3, -2.498091544796509, 5.0
99, 0, 91, 156, 96, 158, -5, -2, -2.761086276477428, 5.385164807134504
99, 2, 252, 204, 255, 206, -3, -2, -2.5535900500422257, 3.605551275463989
99, 3, 593, 171, 594, 173, -1, -2, -2.0344439357957027, 2.23606797749979
99, 4, 151, 331, 154, 331, -3, 0, 3.141592653589793, 3.0
99, 6, 185, 126, 189, 128, -4, -2, -2.677945044588987, 4.47213595499958
99, 7, 54, 286, 58, 287, -4, -1, -2.896613990462929, 4.123105625617661
99, 8, 413, 169, 413, 171, 0, -2, -1.5707963267948966, 2.0
99, 9, 338, 184, 340, 186, -2, -2, -2.356194490192345, 2.8284271247461903
99, 10, 62, 258, 66, 259, -4, -1, -2.896613990462929, 4.123105625617661
99, 11, 138, 204, 143, 206, -5, -2, -2.761086276477428, 5.385164807134504
99, 12, 407, 289, 410, 291, -3, -2, -2.5535900500422257, 3.605551275463989
99, 13, 74, 156, 77, 158, -3, -2, -2.5535900500422257, 3.605551275463989
99, 14, 328, 313, 331, 313, -3, 0, 3.141592653589793, 3.0
99, 15, 391, 272, 392, 275, -1, -3, -1.892546881191539, 3.1622776601683795
99, 16, 334, 260, 336, 262, -2, -2, -2.356194490192345, 2.8284271247461903
99, 17, 340, 364, 343, 365, -3, -1, -2.819842099193151, 3.1622776601683795
99, 19, 147, 129, 150, 131, -3, -2, -2.5535900500422257, 3.605551275463989
99, 24, 289, 192, 292, 195, -3, -3, -2.356194490192345, 4.242640687119285
99, 25, 356, 132, 359, 135, -3, -3, -2.356194490192345, 4.242640687119285
99, 26, 553, 364, 552, 365, 1, -1, -0.7853981633974483, 1.4142135623730951
99, 28, 593, 187, 593, 189, 0, -2, -1.5707963267948966, 2.0
99, 30, 433, 188, 434, 192, -1, -4, -1.8157749899217608, 4.123105625617661
99, 31, 224, 288, 227, 289, -3, -1, -2.819842099193151, 3.1622776601683795
99, 32, 598, 130, 598, 132, 0, -2, -1.5707963267948966, 2.0
99, 33, 560, 121, 558, 122, 2, -1, -0.4636476090008061, 2.23606797749979
99, 35, 235, 116, 237, 118, -2, -2, -2.356194490192345, 2.8284271247461903
99, 39, 544, 249, 543, 252, 1, -3, -1.2490457723982544, 3.1622776601683795
99, 40, 64, 113, 67, 114, -3, -1, -2.819842099193151, 3.1622776601683795
99, 41, 370, 360, 373, 360, -3, 0, 3.141592653589793, 3.0
99, 42, 214, 265, 216, 266, -2, -1, -2.677945044588987, 2.23606797749979
99, 43, 597, 147, 595, 148, 2, -1, -0.4636476090008061, 2.23606797749979
99, 44, 118, 109, 120, 110, -2, -1, -2.677945044588987, 2.23606797749979
99, 45, 154, 105, 156, 105, -2, 0, 3.141592653589793, 2.0
99, 46, 174, 198, 178, 199, -4, -1, -2.896613990462929, 4.123105625617661
99, 48, 35, 208, 37, 209, -2, -1, -2.677945044588987, 2.23606797749979
99, 50, 557, 219, 557, 221, 0, -2, -1.5707963267948966, 2.0
99, 51, 62, 306, 65, 307, -3, -1, -2.819842099193151, 3.1622776601683795
99, 52, 484, 114, 484, 116, 0, -2, -1.5707963267948966, 2.0
99, 53, 48, 202, 50, 204, -2, -2, -2.356194490192345, 2.8284271247461903
99, 54, 578, 363, 577, 364, 1, -1, -0.7853981633974483, 1.4142135623730951
99, 56, 496, 228, 496, 233, 0, -5, -1.5707963267948966, 5.0
99, 58, 128, 220, 133, 222, -5, -2, -2.761086276477428, 5.385164807134504
99, 59, 119, 237, 122, 238, -3, -1, -2.819842099193151, 3.1622776601683795
99, 60, 104, 191, 109, 193, -5, -2, -2.761086276477428, 5.385164807134504
99, 61, 37, 339, 39, 340, -2, -1, -2.677945044588987, 2.23606797749979
99, 62, 63, 206, 68, 209, -5, -3, -2.601173153319209, 5.830951894845301
99, 63, 287, 366, 291, 366, -4, 0, 3.141592653589793, 4.0
99, 65, 215, 133, 218, 134, -3, -1, -2.819842099193151, 3.1622776601683795
99, 66, 595, 313, 594, 314, 1, -1, -0.7853981633974483, 1.4142135623730951
99, 67, 143, 327, 146, 328, -3, -1, -2.819842099193151, 3.1622776601683795
99, 68, 298, 248, 300, 250, -2, -2, -2.356194490192345, 2.8284271247461903
99, 70, 595, 162, 597, 164, -2, -2, -2.356194490192345, 2.8284271247461903
99, 71, 270, 208, 272, 210, -2, -2, -2.356194490192345, 2.8284271247461903
99, 72, 59, 157, 62, 156, -3, 1, 2.819842099193151, 3.1622776601683795
99, 73, 151, 365, 155, 364, -4, 1, 2.896613990462929, 4.123105625617661
99, 74, 82, 295, 84, 296, -2, -1, -2.677945044588987, 2.23606797749979
99, 75, 351, 256, 353, 257, -2, -1, -2.677945044588987, 2.23606797749979
99, 76, 510, 127, 510, 131, 0, -4, -1.5707963267948966, 4.0
99, 77, 41, 166, 44, 167, -3, -1, -2.819842099193151, 3.1622776601683795
99, 80, 549, 233, 549, 237, 0, -4, -1.5707963267948966, 4.0
99, 81, 548, 352, 547, 353, 1, -1, -0.7853981633974483, 1.4142135623730951
99, 82, 345, 357, 349, 358, -4, -1, -2.896613990462929, 4.123105625617661
99, 83, 582, 257, 581, 261, 1, -4, -1.3258176636680326, 4.123105625617661
99, 84, 358, 336, 362, 334, -4, 2, 2.677945044588987, 4.47213595499958
99, 85, 482, 180, 482, 183, 0, -3, -1.5707963267948966, 3.0
99, 86, 81, 106, 83, 107, -2, -1, -2.677945044588987, 2.23606797749979
99, 89, 89, 202, 93, 203, -4, -1, -2.896613990462929, 4.123105625617661
99, 90, 136, 156, 137, 158, -1, -2, -2.0344439357957027, 2.23606797749979
99, 91, 150, 350, 153, 350, -3, 0, 3.141592653589793, 3.0
99, 92, 315, 120, 318, 121, -3, -1, -2.819842099193151, 3.1622776601683795
99, 93, 144, 169, 146, 170, -2, -1, -2.677945044588987, 2.23606797749979
99, 94, 587, 172, 587, 174, 0, -2, -1.5707963267948966, 2.0
99, 95, 341, 209, 343, 211, -2, -2, -2.356194490192345, 2.8284271247461903
99, 96, 561, 180, 560, 185, 1, -5, -1.373400766945016, 5.0990195135927845
99, 97, 445, 117, 446, 119, -1, -2, -2.0344439357957027, 2.23606797749979
99, 98, 143, 311, 145, 312, -2, -1, -2.677945044588987, 2.23606797749979
99, 99, 589, 312, 587, 312, 2, 0, 0.0, 2.0
99, 100, 263, 275, 265, 278, -2, -3, -2.158798930342464, 3.605551275463989
99, 101, 51, 138, 54, 139, -3, -1, -2.819842099193151, 3.1622776601683795
99, 102, 301, 134, 303, 135, -2, -1, -2.677945044588987, 2.23606797749979
99, 103, 528, 134, 527, 140, 1, -6, -1.4056476493802699, 6.082762530298219
99, 104, 193, 211, 197, 211, -4, 0, 3.141592653589793, 4.0
99, 105, 174, 317, 178, 317, -4, 0, 3.141592653589793, 4.0
99, 106, 112, 145, 114, 146, -2, -1, -2.677945044588987, 2.23606797749979
99, 107, 404, 209, 406, 210, -2, -1, -2.677945044588987, 2.23606797749979
99, 108, 258, 112, 260, 113, -2, -1, -2.677945044588987, 2.23606797749979
99, 110, 555, 137, 554, 140, 1, -3, -1.2490457723982544, 3.1622776601683795
99, 111, 533, 121, 532, 122, 1, -1, -0.7853981633974483, 1.4142135623730951
99, 112, 158, 157, 162, 160, -4, -3, -2.498091544796509, 5.0
99, 113, 315, 153, 318, 154, -3, -1, -2.819842099193151, 3.1622776601683795
99, 114, 133, 255, 138, 256, -5, -1, -2.9441970937399127, 5.0990195135927845
99, 115, 334, 136, 337, 140, -3, -4, -2.214297435588181, 5.0
99, 117, 397, 131, 401, 134, -4, -3, -2.498091544796509, 5.0
99, 118, 370, 200, 372, 202, -2, -2, -2.356194490192345, 2.8284271247461903
99, 119, 541, 148, 541, 151, 0, -3, -1.5707963267948966, 3.0
99, 120, 429, 176, 430, 179, -1, -3, -1.892546881191539, 3.1622776601683795
99, 121, 82, 340, 87, 340, -5, 0, 3.141592653589793, 5.0
99, 122, 93, 117, 96, 118, -3, -1, -2.819842099193151, 3.1622776601683795
99, 123, 100, 125, 104, 127, -4, -2, -2.677945044588987, 4.47213595499958
99, 124, 175, 122, 178, 124, -3, -2, -2.5535900500422257, 3.605551275463989
99, 125, 121, 365, 125, 366, -4, -1, -2.896613990462929, 4.123105625617661
99, 126, 185, 159, 188, 162, -3, -3, -2.356194490192345, 4.242640687119285
99, 127, 363, 150, 364, 153, -1, -3, -1.892546881191539, 3.1622776601683795
99, 128, 259, 188, 261, 190, -2, -2, -2.356194490192345, 2.8284271247461903
99, 129, 299, 167, 304, 170, -5, -3, -2.601173153319209, 5.830951894845301
100, 0, 35, 362, 36, 364, -1, -2, -2.0344439357957027, 2.23606797749979
100, 2, 340, 187, 345, 191, -5, -4, -2.4668517113662407, 6.4031242374328485
100, 4, 136, 206, 141, 208, -5, -2, -2.761086276477428, 5.385164807134504
100, 5, 192, 132, 196, 135, -4, -3, -2.498091544796509, 5.0
100, 6, 154, 132, 158, 135, -4, -3, -2.498091544796509, 5.0
100, 8, 432, 193, 434, 198, -2, -5, -1.9513027039072615, 5.385164807134504
100, 9, 257, 301, 263, 302, -6, -1, -2.976443976175166, 6.082762530298219
100, 13, 594, 314, 593, 315, 1, -1, -0.7853981633974483, 1.4142135623730951
100, 14, 291, 215, 295, 219, -4, -4, -2.356194490192345, 5.656854249492381
100, 15, 258, 207, 262, 211, -4, -4, -2.356194490192345, 5.656854249492381
100, 16, 416, 169, 419, 174, -3, -5, -2.1112158270654806, 5.830951894845301
100, 18, 81, 158, 86, 161, -5, -3, -2.601173153319209, 5.830951894845301
100, 19, 243, 111, 245, 112, -2, -1, -2.677945044588987, 2.23606797749979
100, 21, 389, 368, 391, 368, -2, 0, 3.141592653589793, 2.0
100, 22, 52, 124, 54, 126, -2, -2, -2.356194490192345, 2.8284271247461903
100, 24, 100, 157, 105, 160, -5, -3, -2.601173153319209, 5.830951894845301
100, 25, 70, 133, 75, 136, -5, -3, -2.601173153319209, 5.830951894845301
100, 27, 593, 176, 594, 178, -1, -2, -2.0344439357957027, 2.23606797749979
100, 28, 586, 261, 584, 264, 2, -3, -0.982793723247329, 3.605551275463989
100, 29, 227, 289, 233, 291, -6, -2, -2.819842099193151, 6.324555320336759
100, 30, 582, 125, 581, 129, 1, -4, -1.3258176636680326, 4.123105625617661
100, 31, 375, 364, 380, 363, -5, 1, 2.9441970937399127, 5.0990195135927845
100, 32, 72, 261, 77, 263, -5, -2, -2.761086276477428, 5.385164807134504
100, 33, 156, 334, 161, 334, -5, 0, 3.141592653589793, 5.0
100, 34, 257, 119, 258, 121, -1, -2, -2.0344439357957027, 2.23606797749979
100, 35, 337, 264, 342, 267, -5, -3, -2.601173153319209, 5.830951894845301
100, 36, 61, 288, 67, 290, -6, -2, -2.819842099193151, 6.324555320336759
100, 37, 331, 314, 338, 315, -7, -1, -2.999695598985629, 7.0710678118654755
100, 38, 294, 192, 299, 196, -5, -4, -2.4668517113662407, 6.4031242374328485
100, 39, 554, 367, 553, 368, 1, -1, -0.7853981633974483, 1.4142135623730951
100, 41, 596, 194, 596, 196, 0, -2, -1.5707963267948966, 2.0
100, 42, 72, 366, 76, 366, -4, 0, 3.141592653589793, 4.0
100, 43, 38, 354, 39, 356, -1, -2, -2.0344439357957027, 2.23606797749979
100, 45, 597, 135, 597, 137, 0, -2, -1.5707963267948966, 2.0
100, 46, 239, 120, 243, 123, -4, -3, -2.498091544796509, 5.0
100, 47, 561, 125, 560, 130, 1, -5, -1.373400766945016, 5.0990195135927845
100, 50, 347, 366, 350, 366, -3, 0, 3.141592653589793, 3.0
100, 51, 460, 367, 462, 368, -2, -1, -2.677945044588987, 2.23606797749979
100, 53, 216, 268, 222, 271, -6, -3, -2.677945044588987, 6.708203932499369
100, 54, 298, 105, 300, 106, -2, -1, -2.677945044588987, 2.23606797749979
100, 55, 177, 196, 183, 199, -6, -3, -2.677945044588987, 6.708203932499369
100, 57, 123, 241, 128, 243, -5, -2, -2.761086276477428, 5.385164807134504
100, 58, 448, 121, 448, 123, 0, -2, -1.5707963267948966, 2.0
100, 59, 364, 136, 367, 141, -3, -5, -2.1112158270654806, 5.830951894845301
100, 61, 48, 249, 52, 251, -4, -2, -2.677945044588987, 4.47213595499958
100, 62, 57, 208, 63, 210, -6, -2, -2.819842099193151, 6.324555320336759
100, 63, 102, 110, 104, 111, -2, -1, -2.677945044588987, 2.23606797749979
100, 64, 66, 314, 71, 315, -5, -1, -2.9441970937399127, 5.0990195135927845
100, 66, 283, 340, 289, 340, -6, 0, 3.141592653589793, 6.0
100, 67, 53, 186, 58, 188, -5, -2, -2.761086276477428, 5.385164807134504
100, 68, 584, 313, 582, 313, 2, 0, 0.0, 2.0
100, 69, 554, 127, 552, 131, 2, -4, -1.1071487177940904, 4.47213595499958
100, 70, 407, 212, 410, 215, -3, -3, -2.356194490192345, 4.242640687119285
100, 74, 590, 231, 589, 233, 1, -2, -1.1071487177940904, 2.23606797749979
100, 76, 36, 210, 39, 211, -3, -1, -2.819842099193151, 3.1622776601683795
100, 77, 481, 115, 481, 120, 0, -5, -1.5707963267948966, 5.0
100, 79, 219, 138, 223, 141, -4, -3, -2.498091544796509, 5.0
100, 80, 200, 107, 202, 108, -2, -1, -2.677945044588987, 2.23606797749979
100, 81, 549, 354, 548, 355, 1, -1, -0.7853981633974483, 1.4142135623730951
100, 83, 360, 332, 365, 332, -5, 0, 3.141592653589793, 5.0
100, 84, 69, 115, 71, 116, -2, -1, -2.677945044588987, 2.23606797749979
100, 85, 579, 366, 578, 367, 1, -1, -0.7853981633974483, 1.4142135623730951
100, 86, 597, 230, 597, 232, 0, -2, -1.5707963267948966, 2.0
100, 87, 281, 115, 283, 116, -2, -1, -2.677945044588987, 2.23606797749979
100, 90, 601, 164, 602, 166, -1, -2, -2.0344439357957027, 2.23606797749979
100, 91, 155, 366, 160, 367, -5, -1, -2.9441970937399127, 5.0990195135927845
100, 92, 85, 299, 90, 300, -5, -1, -2.9441970937399127, 5.0990195135927845
100, 94, 197, 211, 202, 214, -5, -3, -2.601173153319209, 5.830951894845301
100, 95, 558, 358, 556, 359, 2, -1, -0.4636476090008061, 2.23606797749979
100, 96, 87, 342, 91, 342, -4, 0, 3.141592653589793, 4.0
100, 97, 515, 172, 515, 177, 0, -5, -1.5707963267948966, 5.0
100, 98, 527, 128, 526, 129, 1, -1, -0.7853981633974483, 1.4142135623730951
100, 100, 71, 183, 75, 185, -4, -2, -2.677945044588987, 4.47213595499958
100, 101, 511, 131, 511, 136, 0, -5, -1.5707963267948966, 5.0
100, 102, 596, 304, 596, 306, 0, -2, -1.5707963267948966, 2.0
100, 103, 176, 126, 180, 128, -4, -2, -2.677945044588987, 4.47213595499958
100, 105, 154, 352, 158, 352, -4, 0, 3.141592653589793, 4.0
100, 106, 500, 233, 498, 238, 2, -5, -1.1902899496825317, 5.385164807134504
100, 107, 432, 175, 435, 180, -3, -5, -2.1112158270654806, 5.830951894845301
100, 109, 94, 201, 101, 204, -7, -3, -2.7367008673047097, 7.615773105863909
100, 110, 366, 152, 369, 156, -3, -4, -2.214297435588181, 5.0
100, 111, 306, 132, 310, 136, -4, -4, -2.356194490192345, 5.656854249492381
100, 112, 542, 256, 539, 260, 3, -4, -0.9272952180016122, 5.0
100, 113, 483, 186, 483, 190, 0, -4, -1.5707963267948966, 4.0
100, 114, 593, 364, 595, 364, -2, 0, 3.141592653589793, 2.0
100, 115, 376, 162, 380, 166, -4, -4, -2.356194490192345, 5.656854249492381
100, 116, 553, 142, 552, 145, 1, -3, -1.2490457723982544, 3.1622776601683795
100, 117, 146, 168, 150, 171, -4, -3, -2.498091544796509, 5.0
100, 118, 271, 212, 277, 215, -6, -3, -2.677945044588987, 6.708203932499369
100, 119, 301, 249, 307, 253, -6, -4, -2.5535900500422257, 7.211102550927978
100, 120, 351, 359, 354, 360, -3, -1, -2.819842099193151, 3.1622776601683795
100, 122, 137, 257, 142, 258, -5, -1, -2.9441970937399127, 5.0990195135927845
100, 123, 169, 121, 172, 121, -3, 0, 3.141592653589793, 3.0
100, 124, 171, 260, 175, 261, -4, -1, -2.896613990462929, 4.123105625617661
100, 125, 54, 206, 56, 206, -2, 0, 3.141592653589793, 2.0
100, 126, 55, 139, 60, 141, -5, -2, -2.761086276477428, 5.385164807134504
100, 127, 36, 240, 38, 241, -2, -1, -2.677945044588987, 2.23606797749979
100, 128, 293, 368, 298, 367, -5, 1, 2.9441970937399127, 5.0990195135927845
100, 129, 84, 110, 86, 111, -2, -1, -2.677945044588987, 2.23606797749979
100, 130, 147, 313, 151, 314, -4, -1, -2.896613990462929, 4.123105625617661
100, 132, 534, 136, 532, 141, 2, -5, -1.1902899496825317, 5.385164807134504
100, 133, 490, 129, 490, 133, 0, -4, -1.5707963267948966, 4.0
100, 134, 319, 119, 322, 121, -3, -2, -2.5535900500422257, 3.605551275463989
100, 135, 298, 320, 304, 320, -6, 0, 3.141592653589793, 6.0
100, 136, 33, 342, 35, 342, -2, 0, 3.141592653589793, 2.0
100, 137, 118, 122, 122, 123, -4, -1, -2.896613990462929, 4.123105625617661
100, 139, 344, 213, 348, 216, -4, -3, -2.498091544796509, 5.0
100, 141, 164, 162, 168, 165, -4, -3, -2.498091544796509, 5.0
100, 142, 563, 290, 559, 292, 4, -2, -0.4636476090008061, 4.47213595499958
100, 143, 409, 171, 411, 176, -2, -5, -1.9513027039072615, 5.385164807134504
100, 144, 188, 164, 192, 166, -4, -2, -2.677945044588987, 4.47213595499958
100, 145, 228, 115, 231, 118, -3, -3, -2.356194490192345, 4.242640687119285
100, 146, 62, 154, 67, 156, -5, -2, -2.761086276477428, 5.385164807134504
101, 2, 336, 183, 340, 187, -4, -4, -2.356194490192345, 5.656854249492381
101, 3, 133, 204, 136, 206, -3, -2, -2.5535900500422257, 3.605551275463989
101, 4, 189, 129, 192, 132, -3, -3, -2.356194490192345, 4.242640687119285
101, 5, 150, 129, 154, 132, -4, -3, -2.498091544796509, 5.0
101, 7, 430, 188, 432, 193, -2, -5, -1.9513027039072615, 5.385164807134504
101, 8, 251, 299, 257, 301, -6, -2, -2.819842099193151, 6.324555320336759
101, 12, 286, 211, 291, 215, -5, -4, -2.4668517113662407, 6.4031242374328485
101, 13, 253, 204, 258, 207, -5, -3, -2.601173153319209, 5.830951894845301
101, 14, 413, 164, 416, 169, -3, -5, -2.1112158270654806, 5.830951894845301
101, 16, 76, 155, 81, 158, -5, -3, -2.601173153319209, 5.830951894845301
101, 18, 595, 347, 594, 348, 1, -1, -0.7853981633974483, 1.4142135623730951
101, 19, 386, 367, 389, 368, -3, -1, -2.819842099193151, 3.1622776601683795
101, 22, 95, 154, 100, 157, -5, -3, -2.601173153319209, 5.830951894845301
101, 23, 65, 131, 70, 133, -5, -2, -2.761086276477428, 5.385164807134504
101, 26, 589, 258, 586, 261, 3, -3, -0.7853981633974483, 4.242640687119285
101, 27, 222, 288, 227, 289, -5, -1, -2.9441970937399127, 5.0990195135927845
101, 28, 583, 120, 582, 125, 1, -5, -1.373400766945016, 5.0990195135927845
101, 29, 370, 365, 375, 364, -5, 1, 2.9441970937399127, 5.0990195135927845
101, 30, 67, 259, 72, 261, -5, -2, -2.761086276477428, 5.385164807134504
101, 31, 151, 334, 156, 334, -5, 0, 3.141592653589793, 5.0
101, 32, 334, 264, 337, 264, -3, 0, 3.141592653589793, 3.0
101, 33, 57, 288, 61, 288, -4, 0, 3.141592653589793, 4.0
101, 34, 327, 312, 331, 314, -4, -2, -2.677945044588987, 4.47213595499958
101, 35, 291, 188, 294, 192, -3, -4, -2.214297435588181, 5.0
101, 36, 555, 366, 554, 367, 1, -1, -0.7853981633974483, 1.4142135623730951
101, 39, 67, 366, 72, 366, -5, 0, 3.141592653589793, 5.0
101, 41, 158, 109, 160, 110, -2, -1, -2.677945044588987, 2.23606797749979
101, 42, 597, 133, 597, 135, 0, -2, -1.5707963267948966, 2.0
101, 43, 236, 118, 239, 120, -3, -2, -2.5535900500422257, 3.605551275463989
101, 44, 562, 121, 561, 125, 1, -4, -1.3258176636680326, 4.123105625617661
101, 45, 43, 179, 43, 181, 0, -2, -1.5707963267948966, 2.0
101, 47, 344, 365, 347, 366, -3, -1, -2.819842099193151, 3.1622776601683795
101, 48, 458, 367, 460, 367, -2, 0, 3.141592653589793, 2.0
101, 49, 209, 266, 216, 268, -7, -2, -2.8632929945846817, 7.280109889280518
101, 50, 172, 193, 177, 196, -5, -3, -2.601173153319209, 5.830951894845301
101, 52, 117, 239, 123, 241, -6, -2, -2.819842099193151, 6.324555320336759
101, 53, 361, 131, 364, 136, -3, -5, -2.1112158270654806, 5.830951894845301
101, 54, 45, 248, 48, 249, -3, -1, -2.819842099193151, 3.1622776601683795
101, 55, 54, 206, 57, 208, -3, -2, -2.5535900500422257, 3.605551275463989
101, 56, 100, 110, 102, 110, -2, 0, 3.141592653589793, 2.0
101, 57, 61, 314, 66, 314, -5, 0, 3.141592653589793, 5.0
101, 59, 277, 339, 283, 340, -6, -1, -2.976443976175166, 6.082762530298219
101, 60, 50, 184, 53, 186, -3, -2, -2.5535900500422257, 3.605551275463989
101, 61, 586, 313, 584, 313, 2, 0, 0.0, 2.0
101, 62, 556, 123, 554, 127, 2, -4, -1.1071487177940904, 4.47213595499958
101, 63, 403, 209, 407, 212, -4, -3, -2.498091544796509, 5.0
101, 67, 590, 229, 590, 231, 0, -2, -1.5707963267948966, 2.0
101, 69, 34, 209, 36, 210, -2, -1, -2.677945044588987, 2.23606797749979
101, 70, 482, 112, 481, 115, 1, -3, -1.2490457723982544, 3.1622776601683795
101, 72, 214, 135, 219, 138, -5, -3, -2.601173153319209, 5.830951894845301
101, 73, 551, 353, 549, 354, 2, -1, -0.4636476090008061, 2.23606797749979
101, 75, 355, 333, 360, 332, -5, 1, 2.9441970937399127, 5.0990195135927845
101, 76, 67, 114, 69, 115, -2, -1, -2.677945044588987, 2.23606797749979
101, 77, 580, 365, 579, 366, 1, -1, -0.7853981633974483, 1.4142135623730951
101, 78, 597, 228, 597, 230, 0, -2, -1.5707963267948966, 2.0
101, 79, 151, 367, 155, 366, -4, 1, 2.896613990462929, 4.123105625617661
101, 80, 80, 298, 85, 299, -5, -1, -2.9441970937399127, 5.0990195135927845
101, 81, 416, 294, 418, 294, -2, 0, 3.141592653589793, 2.0
101, 82, 192, 209, 197, 211, -5, -2, -2.761086276477428, 5.385164807134504
101, 83, 560, 357, 558, 358, 2, -1, -0.4636476090008061, 2.23606797749979
101, 84, 83, 342, 87, 342, -4, 0, 3.141592653589793, 4.0
101, 85, 516, 166, 515, 172, 1, -6, -1.4056476493802699, 6.082762530298219
101, 86, 528, 127, 527, 128, 1, -1, -0.7853981633974483, 1.4142135623730951
101, 88, 66, 180, 71, 183, -5, -3, -2.601173153319209, 5.830951894845301
101, 89, 511, 127, 511, 131, 0, -4, -1.5707963267948966, 4.0
101, 90, 596, 302, 596, 304, 0, -2, -1.5707963267948966, 2.0
101, 91, 171, 124, 176, 126, -5, -2, -2.761086276477428, 5.385164807134504
101, 93, 149, 352, 154, 352, -5, 0, 3.141592653589793, 5.0
101, 94, 502, 229, 500, 233, 2, -4, -1.1071487177940904, 4.47213595499958
101, 95, 429, 171, 432, 175, -3, -4, -2.214297435588181, 5.0
101, 97, 87, 199, 94, 201, -7, -2, -2.8632929945846817, 7.280109889280518
101, 98, 363, 148, 366, 152, -3, -4, -2.214297435588181, 5.0
101, 99, 304, 129, 306, 132, -2, -3, -2.158798930342464, 3.605551275463989
101, 100, 546, 252, 542, 256, 4, -4, -0.7853981633974483, 5.656854249492381
101, 101, 483, 181, 483, 186, 0, -5, -1.5707963267948966, 5.0
101, 102, 594, 362, 593, 364, 1, -2, -1.1071487177940904, 2.23606797749979
101, 103, 372, 158, 376, 162, -4, -4, -2.356194490192345, 5.656854249492381
101, 104, 554, 138, 553, 142, 1, -4, -1.3258176636680326, 4.123105625617661
101, 105, 142, 166, 146, 168, -4, -2, -2.677945044588987, 4.47213595499958
101, 106, 268, 210, 271, 212, -3, -2, -2.5535900500422257, 3.605551275463989
101, 107, 298, 247, 301, 249, -3, -2, -2.5535900500422257, 3.605551275463989
101, 108, 348, 359, 351, 359, -3, 0, 3.141592653589793, 3.0
101, 109, 201, 117, 203, 118, -2, -1, -2.677945044588987, 2.23606797749979
101, 110, 131, 255, 137, 257, -6, -2, -2.819842099193151, 6.324555320336759
101, 111, 166, 121, 169, 121, -3, 0, 3.141592653589793, 3.0
101, 112, 167, 259, 171, 260, -4, -1, -2.896613990462929, 4.123105625617661
101, 113, 52, 204, 54, 206, -2, -2, -2.356194490192345, 2.8284271247461903
101, 114, 51, 137, 55, 139, -4, -2, -2.677945044588987, 4.47213595499958
101, 116, 289, 367, 293, 368, -4, -1, -2.896613990462929, 4.123105625617661
101, 117, 82, 109, 84, 110, -2, -1, -2.677945044588987, 2.23606797749979
101, 118, 142, 313, 147, 313, -5, 0, 3.141592653589793, 5.0
101, 120, 535, 134, 534, 136, 1, -2, -1.1071487177940904, 2.23606797749979
101, 121, 490, 124, 490, 129, 0, -5, -1.5707963267948966, 5.0
101, 122, 316, 116, 319, 119, -3, -3, -2.356194490192345, 4.242640687119285
101, 123, 293, 320, 298, 320, -5, 0, 3.141592653589793, 5.0
101, 124, 115, 122, 118, 122, -3, 0, 3.141592653589793, 3.0
101, 126, 340, 210, 344, 213, -4, -3, -2.498091544796509, 5.0
101, 128, 159, 159, 164, 162, -5, -3, -2.601173153319209, 5.830951894845301
101, 129, 567, 287, 563, 290, 4, -3, -0.6435011087932844, 5.0
101, 130, 407, 164, 409, 171, -2, -7, -1.849095985800008, 7.280109889280518
101, 131, 183, 162, 188, 164, -5, -2, -2.761086276477428, 5.385164807134504
101, 132, 226, 114, 228, 115, -2, -1, -2.677945044588987, 2.23606797749979
101, 133, 59, 151, 62, 154, -3, -3, -2.356194490192345, 4.242640687119285
102, 1, 333, 179, 336, 183, -3, -4, -2.214297435588181, 5.0
102, 3, 185, 126, 189, 129, -4, -3, -2.498091544796509, 5.0
102, 4, 146, 127, 150, 129, -4, -2, -2.677945044588987, 4.47213595499958
102, 6, 427, 184, 430, 188, -3, -4, -2.214297435588181, 5.0
102, 7, 247, 297, 251, 299, -4, -2, -2.677945044588987, 4.47213595499958
102, 10, 282, 209, 286, 211, -4, -2, -2.677945044588987, 4.47213595499958
102, 11, 249, 201, 253, 204, -4, -3, -2.498091544796509, 5.0
102, 12, 410, 159, 413, 164, -3, -5, -2.1112158270654806, 5.830951894845301
102, 14, 72, 153, 76, 155, -4, -2, -2.677945044588987, 4.47213595499958
102, 16, 383, 366, 386, 367, -3, -1, -2.819842099193151, 3.1622776601683795
102, 17, 49, 123, 51, 124, -2, -1, -2.677945044588987, 2.23606797749979
102, 19, 91, 151, 95, 154, -4, -3, -2.498091544796509, 5.0
102, 20, 63, 130, 65, 131, -2, -1, -2.677945044588987, 2.23606797749979
102, 22, 592, 173, 593, 175, -1, -2, -2.0344439357957027, 2.23606797749979
102, 23, 591, 254, 589, 258, 2, -4, -1.1071487177940904, 4.47213595499958
102, 24, 216, 286, 222, 288, -6, -2, -2.819842099193151, 6.324555320336759
102, 25, 583, 117, 583, 120, 0, -3, -1.5707963267948966, 3.0
102, 26, 367, 365, 370, 365, -3, 0, 3.141592653589793, 3.0
102, 27, 62, 256, 67, 259, -5, -3, -2.601173153319209, 5.830951894845301
102, 28, 146, 334, 151, 334, -5, 0, 3.141592653589793, 5.0
102, 29, 331, 261, 334, 264, -3, -3, -2.356194490192345, 4.242640687119285
102, 30, 54, 288, 57, 288, -3, 0, 3.141592653589793, 3.0
102, 31, 323, 309, 327, 312, -4, -3, -2.498091544796509, 5.0
102, 32, 288, 185, 291, 188, -3, -3, -2.356194490192345, 4.242640687119285
102, 36, 63, 366, 67, 366, -4, 0, 3.141592653589793, 4.0
102, 37, 39, 352, 38, 353, 1, -1, -0.7853981633974483, 1.4142135623730951
102, 38, 156, 108, 158, 109, -2, -1, -2.677945044588987, 2.23606797749979
102, 40, 233, 115, 236, 118, -3, -3, -2.356194490192345, 4.242640687119285
102, 41, 564, 119, 562, 121, 2, -2, -0.7853981633974483, 2.8284271247461903
102, 44, 341, 364, 344, 365, -3, -1, -2.819842099193151, 3.1622776601683795
102, 45, 456, 366, 458, 367, -2, -1, -2.677945044588987, 2.23606797749979
102, 46, 204, 264, 209, 266, -5, -2, -2.761086276477428, 5.385164807134504
102, 47, 169, 191, 172, 193, -3, -2, -2.5535900500422257, 3.605551275463989
102, 49, 112, 237, 117, 239, -5, -2, -2.761086276477428, 5.385164807134504
102, 50, 358, 128, 361, 131, -3, -3, -2.356194490192345, 4.242640687119285
102, 51, 43, 246, 45, 248, -2, -2, -2.356194490192345, 2.8284271247461903
102, 52, 52, 204, 54, 206, -2, -2, -2.356194490192345, 2.8284271247461903
102, 53, 98, 109, 100, 110, -2, -1, -2.677945044588987, 2.23606797749979
102, 54, 57, 312, 61, 314, -4, -2, -2.677945044588987, 4.47213595499958
102, 56, 274, 336, 277, 339, -3, -3, -2.356194490192345, 4.242640687119285
102, 57, 589, 313, 586, 313, 3, 0, 0.0, 3.0
102, 58, 558, 119, 556, 123, 2, -4, -1.1071487177940904, 4.47213595499958
102, 59, 400, 204, 403, 209, -3, -5, -2.1112158270654806, 5.830951894845301
102, 62, 482, 110, 482, 112, 0, -2, -1.5707963267948966, 2.0
102, 63, 213, 133, 214, 135, -1, -2, -2.0344439357957027, 2.23606797749979
102, 64, 553, 352, 551, 353, 2, -1, -0.4636476090008061, 2.23606797749979
102, 66, 349, 333, 355, 333, -6, 0, 3.141592653589793, 6.0
102, 67, 65, 113, 67, 114, -2, -1, -2.677945044588987, 2.23606797749979
102, 68, 581, 364, 580, 365, 1, -1, -0.7853981633974483, 1.4142135623730951
102, 69, 597, 225, 597, 228, 0, -3, -1.5707963267948966, 3.0
102, 70, 146, 366, 151, 367, -5, -1, -2.9441970937399127, 5.0990195135927845
102, 71, 74, 297, 80, 298, -6, -1, -2.976443976175166, 6.082762530298219
102, 73, 188, 206, 192, 209, -4, -3, -2.498091544796509, 5.0
102, 74, 561, 356, 560, 357, 1, -1, -0.7853981633974483, 1.4142135623730951
102, 75, 80, 341, 83, 342, -3, -1, -2.819842099193151, 3.1622776601683795
102, 76, 516, 160, 516, 166, 0, -6, -1.5707963267948966, 6.0
102, 79, 61, 177, 66, 180, -5, -3, -2.601173153319209, 5.830951894845301
102, 80, 511, 124, 511, 127, 0, -3, -1.5707963267948966, 3.0
102, 81, 597, 300, 596, 302, 1, -2, -1.1071487177940904, 2.23606797749979
102, 82, 169, 123, 171, 124, -2, -1, -2.677945044588987, 2.23606797749979
102, 84, 143, 352, 149, 352, -6, 0, 3.141592653589793, 6.0
102, 85, 504, 225, 502, 229, 2, -4, -1.1071487177940904, 4.47213595499958
102, 86, 426, 168, 429, 171, -3, -3, -2.356194490192345, 4.242640687119285
102, 88, 360, 144, 363, 148, -3, -4, -2.214297435588181, 5.0
102, 89, 303, 127, 304, 129, -1, -2, -2.0344439357957027, 2.23606797749979
102, 90, 551, 249, 546, 252, 5, -3, -0.5404195002705842, 5.830951894845301
102, 91, 483, 176, 483, 181, 0, -5, -1.5707963267948966, 5.0
102, 92, 369, 156, 372, 158, -3, -2, -2.5535900500422257, 3.605551275463989
102, 93, 555, 134, 554, 138, 1, -4, -1.3258176636680326, 4.123105625617661
102, 94, 137, 164, 142, 166, -5, -2, -2.761086276477428, 5.385164807134504
102, 95, 264, 207, 268, 210, -4, -3, -2.498091544796509, 5.0
102, 96, 296, 244, 298, 247, -2, -3, -2.158798930342464, 3.605551275463989
102, 97, 346, 358, 348, 359, -2, -1, -2.677945044588987, 2.23606797749979
102, 98, 199, 116, 201, 117, -2, -1, -2.677945044588987, 2.23606797749979
102, 99, 126, 253, 131, 255, -5, -2, -2.761086276477428, 5.385164807134504
102, 100, 162, 258, 167, 259, -5, -1, -2.9441970937399127, 5.0990195135927845
102, 101, 53, 203, 52, 204, 1, -1, -0.7853981633974483, 1.4142135623730951
102, 104, 285, 367, 289, 367, -4, 0, 3.141592653589793, 4.0
102, 105, 80, 109, 82, 109, -2, 0, 3.141592653589793, 2.0
102, 106, 137, 312, 142, 313, -5, -1, -2.9441970937399127, 5.0990195135927845
102, 108, 537, 132, 535, 134, 2, -2, -0.7853981633974483, 2.8284271247461903
102, 109, 490, 120, 490, 124, 0, -4, -1.5707963267948966, 4.0
102, 110, 314, 114, 316, 116, -2, -2, -2.356194490192345, 2.8284271247461903
102, 111, 289, 320, 293, 320, -4, 0, 3.141592653589793, 4.0
102, 112, 111, 120, 115, 122, -4, -2, -2.677945044588987, 4.47213595499958
102, 114, 337, 207, 340, 210, -3, -3, -2.356194490192345, 4.242640687119285
102, 115, 53, 264, 54, 266, -1, -2, -2.0344439357957027, 2.23606797749979
102, 116, 155, 155, 159, 159, -4, -4, -2.356194490192345, 5.656854249492381
102, 117, 570, 284, 567, 287, 3, -3, -0.7853981633974483, 4.242640687119285
102, 118, 407, 161, 407, 164, 0, -3, -1.5707963267948966, 3.0
102, 119, 178, 159, 183, 162, -5, -3, -2.601173153319209, 5.830951894845301
102, 121, 54, 150, 59, 151, -5, -1, -2.9441970937399127, 5.0990195135927845
103, 1, 330, 177, 333, 179, -3, -2, -2.5535900500422257, 3.605551275463989
103, 2, 128, 202, 133, 204, -5, -2, -2.761086276477428, 5.385164807134504
103, 3, 182, 124, 185, 126, -3, -2, -2.5535900500422257, 3.605551275463989
103, 4, 142, 125, 146, 127, -4, -2, -2.677945044588987, 4.47213595499958
103, 6, 427, 179, 427, 184, 0, -5, -1.5707963267948966, 5.0
103, 7, 245, 297, 247, 297, -2, 0, 3.141592653589793, 2.0
103, 8, 594, 123, 595, 122, -1, 1, 2.356194490192345, 1.4142135623730951
103, 10, 279, 207, 282, 209, -3, -2, -2.5535900500422257, 3.605551275463989
103, 11, 246, 198, 249, 201, -3, -3, -2.356194490192345, 4.242640687119285
103, 12, 409, 157, 410, 159, -1, -2, -2.0344439357957027, 2.23606797749979
103, 14, 69, 151, 72, 153, -3, -2, -2.5535900500422257, 3.605551275463989
103, 15, 380, 365, 383, 366, -3, -1, -2.819842099193151, 3.1622776601683795
103, 16, 509, 363, 508, 364, 1, -1, -0.7853981633974483, 1.4142135623730951
103, 17, 90, 149, 91, 151, -1, -2, -2.0344439357957027, 2.23606797749979
103, 18, 61, 128, 63, 130, -2, -2, -2.356194490192345, 2.8284271247461903
103, 20, 592, 170, 592, 173, 0, -3, -1.5707963267948966, 3.0
103, 21, 591, 252, 591, 254, 0, -2, -1.5707963267948966, 2.0
103, 22, 210, 285, 216, 286, -6, -1, -2.976443976175166, 6.082762530298219
103, 23, 583, 115, 583, 117, 0, -2, -1.5707963267948966, 2.0
103, 24, 364, 364, 367, 365, -3, -1, -2.819842099193151, 3.1622776601683795
103, 25, 58, 254, 62, 256, -4, -2, -2.677945044588987, 4.47213595499958
103, 26, 141, 334, 146, 334, -5, 0, 3.141592653589793, 5.0
103, 27, 329, 259, 331, 261, -2, -2, -2.356194490192345, 2.8284271247461903
103, 28, 318, 307, 323, 309, -5, -2, -2.761086276477428, 5.385164807134504
103, 29, 287, 183, 288, 185, -1, -2, -2.0344439357957027, 2.23606797749979
103, 30, 558, 365, 556, 366, 2, -1, -0.4636476090008061, 2.23606797749979
103, 32, 596, 190, 596, 192, 0, -2, -1.5707963267948966, 2.0
103, 33, 60, 365, 63, 366, -3, -1, -2.819842099193151, 3.1622776601683795
103, 36, 232, 113, 233, 115, -1, -2, -2.0344439357957027, 2.23606797749979
103, 37, 564, 116, 564, 119, 0, -3, -1.5707963267948966, 3.0
103, 40, 338, 363, 341, 364, -3, -1, -2.819842099193151, 3.1622776601683795
103, 43, 109, 236, 112, 237, -3, -1, -2.819842099193151, 3.1622776601683795
103, 44, 357, 124, 358, 128, -1, -4, -1.8157749899217608, 4.123105625617661
103, 45, 96, 108, 98, 109, -2, -1, -2.677945044588987, 2.23606797749979
103, 47, 272, 335, 274, 336, -2, -1, -2.677945044588987, 2.23606797749979
103, 49, 559, 116, 558, 119, 1, -3, -1.2490457723982544, 3.1622776601683795
103, 50, 398, 198, 400, 204, -2, -6, -1.892546881191539, 6.324555320336759
103, 52, 590, 226, 590, 228, 0, -2, -1.5707963267948966, 2.0
103, 53, 211, 131, 213, 133, -2, -2, -2.356194490192345, 2.8284271247461903
103, 54, 556, 351, 553, 352, 3, -1, -0.3217505543966422, 3.1622776601683795
103, 56, 343, 335, 349, 333, -6, 2, 2.819842099193151, 6.324555320336759
103, 57, 63, 112, 65, 113, -2, -1, -2.677945044588987, 2.23606797749979
103, 59, 597, 223, 597, 225, 0, -2, -1.5707963267948966, 2.0
103, 60, 142, 366, 146, 366, -4, 0, 3.141592653589793, 4.0
103, 61, 71, 294, 74, 297, -3, -3, -2.356194490192345, 4.242640687119285
103, 62, 413, 291, 415, 294, -2, -3, -2.158798930342464, 3.605551275463989
103, 63, 186, 204, 188, 206, -2, -2, -2.356194490192345, 2.8284271247461903
103, 64, 562, 355, 561, 356, 1, -1, -0.7853981633974483, 1.4142135623730951
103, 65, 77, 337, 80, 341, -3, -4, -2.214297435588181, 5.0
103, 66, 516, 157, 516, 160, 0, -3, -1.5707963267948966, 3.0
103, 69, 58, 176, 61, 177, -3, -1, -2.819842099193151, 3.1622776601683795
103, 70, 512, 121, 511, 124, 1, -3, -1.2490457723982544, 3.1622776601683795
103, 71, 598, 297, 597, 300, 1, -3, -1.2490457723982544, 3.1622776601683795
103, 72, 167, 122, 169, 123, -2, -1, -2.677945044588987, 2.23606797749979
103, 74, 139, 351, 143, 352, -4, -1, -2.896613990462929, 4.123105625617661
103, 75, 505, 221, 504, 225, 1, -4, -1.3258176636680326, 4.123105625617661
103, 77, 360, 141, 360, 144, 0, -3, -1.5707963267948966, 3.0
103, 78, 301, 124, 303, 127, -2, -3, -2.158798930342464, 3.605551275463989
103, 79, 555, 244, 551, 249, 4, -5, -0.8960553845713439, 6.4031242374328485
103, 80, 483, 170, 483, 176, 0, -6, -1.5707963267948966, 6.0
103, 81, 367, 153, 369, 156, -2, -3, -2.158798930342464, 3.605551275463989
103, 82, 557, 130, 555, 134, 2, -4, -1.1071487177940904, 4.47213595499958
103, 83, 133, 161, 137, 164, -4, -3, -2.498091544796509, 5.0
103, 84, 260, 205, 264, 207, -4, -2, -2.677945044588987, 4.47213595499958
103, 85, 292, 241, 296, 244, -4, -3, -2.498091544796509, 5.0
103, 86, 343, 357, 346, 358, -3, -1, -2.819842099193151, 3.1622776601683795
103, 87, 123, 252, 126, 253, -3, -1, -2.819842099193151, 3.1622776601683795
103, 88, 158, 256, 162, 258, -4, -2, -2.677945044588987, 4.47213595499958
103, 89, 51, 202, 53, 203, -2, -1, -2.677945044588987, 2.23606797749979
103, 90, 47, 135, 50, 137, -3, -2, -2.5535900500422257, 3.605551275463989
103, 92, 281, 366, 285, 367, -4, -1, -2.896613990462929, 4.123105625617661
103, 94, 133, 309, 137, 312, -4, -3, -2.498091544796509, 5.0
103, 96, 539, 131, 537, 132, 2, -1, -0.4636476090008061, 2.23606797749979
103, 97, 283, 320, 289, 320, -6, 0, 3.141592653589793, 6.0
103, 98, 108, 119, 111, 120, -3, -1, -2.819842099193151, 3.1622776601683795
103, 99, 334, 204, 337, 207, -3, -3, -2.356194490192345, 4.242640687119285
103, 100, 153, 153, 155, 155, -2, -2, -2.356194490192345, 2.8284271247461903
103, 101, 571, 282, 570, 284, 1, -2, -1.1071487177940904, 2.23606797749979
103, 102, 406, 159, 407, 161, -1, -2, -2.0344439357957027, 2.23606797749979
103, 103, 174, 159, 178, 159, -4, 0, 3.141592653589793, 4.0
103, 104, 225, 111, 226, 113, -1, -2, -2.0344439357957027, 2.23606797749979
103, 105, 52, 149, 54, 150, -2, -1, -2.677945044588987, 2.23606797749979
104, 1, 328, 175, 330, 177, -2, -2, -2.356194490192345, 2.8284271247461903
104, 2, 124, 201, 128, 202, -4, -1, -2.896613990462929, 4.123105625617661
104, 3, 179, 123, 182, 124, -3, -1, -2.819842099193151, 3.1622776601683795
104, 4, 138, 123, 142, 125, -4, -2, -2.677945044588987, 4.47213595499958
104, 6, 426, 177, 427, 179, -1, -2, -2.0344439357957027, 2.23606797749979
104, 7, 241, 294, 245, 297, -4, -3, -2.498091544796509, 5.0
104, 10, 276, 205, 279, 207, -3, -2, -2.5535900500422257, 3.605551275463989
104, 11, 242, 197, 246, 198, -4, -1, -2.896613990462929, 4.123105625617661
104, 12, 407, 153, 409, 157, -2, -4, -2.0344439357957027, 4.47213595499958
104, 13, 67, 149, 69, 151, -2, -2, -2.356194490192345, 2.8284271247461903
104, 14, 378, 365, 380, 365, -2, 0, 3.141592653589793, 2.0
104, 16, 88, 149, 90, 149, -2, 0, 3.141592653589793, 2.0
104, 17, 59, 126, 61, 128, -2, -2, -2.356194490192345, 2.8284271247461903
104, 19, 591, 250, 591, 252, 0, -2, -1.5707963267948966, 2.0
104, 20, 205, 283, 210, 285, -5, -2, -2.761086276477428, 5.385164807134504
104, 21, 362, 365, 364, 364, -2, 1, 2.677945044588987, 2.23606797749979
104, 22, 58, 252, 58, 254, 0, -2, -1.5707963267948966, 2.0
104, 23, 137, 333, 141, 334, -4, -1, -2.896613990462929, 4.123105625617661
104, 24, 325, 257, 329, 259, -4, -2, -2.677945044588987, 4.47213595499958
104, 25, 315, 307, 318, 307, -3, 0, 3.141592653589793, 3.0
104, 26, 285, 181, 287, 183, -2, -2, -2.356194490192345, 2.8284271247461903
104, 27, 559, 364, 558, 365, 1, -1, -0.7853981633974483, 1.4142135623730951
104, 29, 57, 362, 60, 365, -3, -3, -2.356194490192345, 4.242640687119285
104, 30, 231, 111, 232, 113, -1, -2, -2.0344439357957027, 2.23606797749979
104, 31, 565, 114, 564, 116, 1, -2, -1.1071487177940904, 2.23606797749979
104, 33, 334, 362, 338, 363, -4, -1, -2.896613990462929, 4.123105625617661
104, 34, 200, 263, 203, 264, -3, -1, -2.819842099193151, 3.1622776601683795
104, 36, 106, 235, 109, 236, -3, -1, -2.819842099193151, 3.1622776601683795
104, 37, 355, 123, 357, 124, -2, -1, -2.677945044588987, 2.23606797749979
104, 38, 54, 312, 56, 312, -2, 0, 3.141592653589793, 2.0
104, 41, 397, 196, 398, 198, -1, -2, -2.0344439357957027, 2.23606797749979
104, 43, 589, 224, 590, 226, -1, -2, -2.0344439357957027, 2.23606797749979
104, 44, 207, 130, 211, 131, -4, -1, -2.896613990462929, 4.123105625617661
104, 45, 558, 351, 556, 351, 2, 0, 0.0, 2.0
104, 46, 341, 336, 343, 335, -2, 1, 2.677945044588987, 2.23606797749979
104, 47, 61, 111, 63, 112, -2, -1, -2.677945044588987, 2.23606797749979
104, 49, 596, 220, 597, 223, -1, -3, -1.892546881191539, 3.1622776601683795
104, 50, 139, 365, 142, 366, -3, -1, -2.819842099193151, 3.1622776601683795
104, 51, 69, 293, 71, 294, -2, -1, -2.677945044588987, 2.23606797749979
104, 52, 408, 289, 413, 291, -5, -2, -2.761086276477428, 5.385164807134504
104, 53, 564, 355, 562, 355, 2, 0, 0.0, 2.0
104, 54, 72, 337, 77, 337, -5, 0, 3.141592653589793, 5.0
104, 55, 516, 155, 516, 157, 0, -2, -1.5707963267948966, 2.0
104, 58, 55, 175, 58, 176, -3, -1, -2.819842099193151, 3.1622776601683795
104, 59, 512, 119, 512, 121, 0, -2, -1.5707963267948966, 2.0
104, 60, 599, 295, 598, 297, 1, -2, -1.1071487177940904, 2.23606797749979
104, 61, 165, 121, 167, 122, -2, -1, -2.677945044588987, 2.23606797749979
104, 62, 41, 257, 43, 257, -2, 0, 3.141592653589793, 2.0
104, 63, 137, 350, 139, 351, -2, -1, -2.677945044588987, 2.23606797749979
104, 64, 505, 217, 505, 221, 0, -4, -1.5707963267948966, 4.0
104, 66, 357, 138, 360, 141, -3, -3, -2.356194490192345, 4.242640687119285
104, 67, 558, 242, 555, 244, 3, -2, -0.5880026035475675, 3.605551275463989
104, 68, 483, 167, 483, 170, 0, -3, -1.5707963267948966, 3.0
104, 69, 365, 148, 367, 153, -2, -5, -1.9513027039072615, 5.385164807134504
104, 70, 557, 127, 557, 130, 0, -3, -1.5707963267948966, 3.0
104, 71, 131, 160, 133, 161, -2, -1, -2.677945044588987, 2.23606797749979
104, 72, 255, 202, 260, 205, -5, -3, -2.601173153319209, 5.830951894845301
104, 73, 288, 239, 292, 241, -4, -2, -2.677945044588987, 4.47213595499958
104, 74, 341, 356, 343, 357, -2, -1, -2.677945044588987, 2.23606797749979
104, 75, 121, 251, 123, 252, -2, -1, -2.677945044588987, 2.23606797749979
104, 76, 154, 254, 158, 256, -4, -2, -2.677945044588987, 4.47213595499958
104, 78, 276, 366, 281, 366, -5, 0, 3.141592653589793, 5.0
104, 80, 132, 307, 133, 309, -1, -2, -2.0344439357957027, 2.23606797749979
104, 82, 540, 130, 539, 131, 1, -1, -0.7853981633974483, 1.4142135623730951
104, 83, 278, 319, 283, 320, -5, -1, -2.9441970937399127, 5.0990195135927845
104, 84, 105, 117, 108, 119, -3, -2, -2.5535900500422257, 3.605551275463989
104, 85, 330, 201, 334, 204, -4, -3, -2.498091544796509, 5.0
104, 86, 150, 151, 153, 153, -3, -2, -2.5535900500422257, 3.605551275463989
104, 87, 572, 280, 571, 282, 1, -2, -1.1071487177940904, 2.23606797749979
104, 88, 406, 155, 406, 159, 0, -4, -1.5707963267948966, 4.0
104, 89, 173, 157, 174, 159, -1, -2, -2.0344439357957027, 2.23606797749979
104, 90, 223, 111, 225, 111, -2, 0, 3.141592653589793, 2.0
105, 0, 565, 119, 564, 120, 1, -1, -0.7853981633974483, 1.4142135623730951
105, 1, 313, 117, 315, 118, -2, -1, -2.677945044588987, 2.23606797749979
105, 3, 330, 176, 335, 182, -5, -6, -2.2655346029916, 7.810249675906654
105, 4, 356, 128, 359, 132, -3, -4, -2.214297435588181, 5.0
105, 6, 55, 314, 57, 314, -2, 0, 3.141592653589793, 2.0
105, 9, 143, 124, 148, 127, -5, -3, -2.601173153319209, 5.830951894845301
105, 10, 603, 302, 600, 304, 3, -2, -0.5880026035475675, 3.605551275463989
105, 11, 55, 285, 58, 286, -3, -1, -2.819842099193151, 3.1622776601683795
105, 12, 594, 173, 594, 175, 0, -2, -1.5707963267948966, 2.0
105, 13, 410, 156, 413, 162, -3, -6, -2.0344439357957027, 6.708203932499369
105, 14, 246, 200, 251, 204, -5, -4, -2.4668517113662407, 6.4031242374328485
105, 16, 503, 217, 502, 223, 1, -6, -1.4056476493802699, 6.082762530298219
105, 17, 233, 122, 235, 123, -2, -1, -2.677945044588987, 2.23606797749979
105, 18, 276, 209, 282, 213, -6, -4, -2.5535900500422257, 7.211102550927978
105, 19, 425, 180, 428, 185, -3, -5, -2.1112158270654806, 5.830951894845301
105, 20, 124, 201, 130, 203, -6, -2, -2.819842099193151, 6.324555320336759
105, 21, 322, 261, 328, 264, -6, -3, -2.677945044588987, 6.708203932499369
105, 22, 144, 365, 149, 366, -5, -1, -2.9441970937399127, 5.0990195135927845
105, 23, 63, 130, 66, 131, -3, -1, -2.819842099193151, 3.1622776601683795
105, 24, 512, 365, 511, 366, 1, -1, -0.7853981633974483, 1.4142135623730951
105, 25, 142, 334, 148, 334, -6, 0, 3.141592653589793, 6.0
105, 26, 244, 300, 250, 300, -6, 0, 3.141592653589793, 6.0
105, 27, 283, 184, 288, 189, -5, -5, -2.356194490192345, 7.0710678118654755
105, 28, 319, 313, 325, 314, -6, -1, -2.976443976175166, 6.082762530298219
105, 30, 60, 257, 65, 259, -5, -2, -2.761086276477428, 5.385164807134504
105, 31, 381, 273, 383, 274, -2, -1, -2.677945044588987, 2.23606797749979
105, 33, 401, 289, 403, 290, -2, -1, -2.677945044588987, 2.23606797749979
105, 34, 58, 366, 63, 367, -5, -1, -2.9441970937399127, 5.0990195135927845
105, 36, 300, 132, 302, 133, -2, -1, -2.677945044588987, 2.23606797749979
105, 37, 601, 159, 601, 162, 0, -3, -1.5707963267948966, 3.0
105, 39, 184, 124, 189, 126, -5, -2, -2.761086276477428, 5.385164807134504
105, 40, 514, 120, 513, 122, 1, -2, -1.1071487177940904, 2.23606797749979
105, 42, 558, 366, 557, 367, 1, -1, -0.7853981633974483, 1.4142135623730951
105, 43, 337, 369, 341, 370, -4, -1, -2.896613990462929, 4.123105625617661
105, 44, 549, 244, 546, 249, 3, -5, -1.0303768265243125, 5.830951894845301
105, 46, 594, 148, 594, 150, 0, -2, -1.5707963267948966, 2.0
105, 51, 594, 256, 594, 258, 0, -2, -1.5707963267948966, 2.0
105, 55, 597, 326, 596, 327, 1, -1, -0.7853981633974483, 1.4142135623730951
105, 59, 87, 152, 93, 155, -6, -3, -2.677945044588987, 6.708203932499369
105, 60, 600, 143, 600, 145, 0, -2, -1.5707963267948966, 2.0
105, 62, 40, 200, 39, 201, 1, -1, -0.7853981633974483, 1.4142135623730951
105, 63, 343, 333, 349, 334, -6, -1, -2.976443976175166, 6.082762530298219
105, 68, 55, 120, 56, 122, -1, -2, -2.0344439357957027, 2.23606797749979
105, 69, 73, 342, 77, 343, -4, -1, -2.896613990462929, 4.123105625617661
105, 70, 154, 109, 156, 110, -2, -1, -2.677945044588987, 2.23606797749979
105, 71, 141, 352, 146, 353, -5, -1, -2.9441970937399127, 5.0990195135927845
105, 72, 210, 131, 213, 133, -3, -2, -2.5535900500422257, 3.605551275463989
105, 73, 589, 225, 589, 227, 0, -2, -1.5707963267948966, 2.0
105, 74, 68, 150, 74, 153, -6, -3, -2.677945044588987, 6.708203932499369
105, 75, 55, 150, 57, 151, -2, -1, -2.677945044588987, 2.23606797749979
105, 76, 294, 161, 299, 165, -5, -4, -2.4668517113662407, 6.4031242374328485
105, 77, 486, 171, 485, 177, 1, -6, -1.4056476493802699, 6.082762530298219
105, 78, 186, 206, 191, 209, -5, -3, -2.601173153319209, 5.830951894845301
105, 79, 203, 265, 209, 268, -6, -3, -2.677945044588987, 6.708203932499369
105, 80, 110, 237, 116, 240, -6, -3, -2.677945044588987, 6.708203932499369
105, 81, 427, 164, 429, 169, -2, -5, -1.9513027039072615, 5.385164807134504
105, 82, 337, 204, 340, 208, -3, -4, -2.214297435588181, 5.0
105, 83, 166, 190, 171, 193, -5, -3, -2.601173153319209, 5.830951894845301
105, 84, 174, 123, 176, 125, -2, -2, -2.356194490192345, 2.8284271247461903
105, 85, 71, 298, 76, 299, -5, -1, -2.9441970937399127, 5.0990195135927845
105, 88, 346, 358, 348, 359, -2, -1, -2.677945044588987, 2.23606797749979
105, 89, 46, 135, 48, 137, -2, -2, -2.356194490192345, 2.8284271247461903
105, 90, 197, 112, 199, 112, -2, 0, 3.141592653589793, 2.0
105, 91, 32, 257, 35, 256, -3, 1, 2.819842099193151, 3.1622776601683795
105, 93, 386, 159, 389, 163, -3, -4, -2.214297435588181, 5.0
105, 96, 90, 124, 93, 125, -3, -1, -2.819842099193151, 3.1622776601683795
105, 97, 135, 162, 140, 166, -5, -4, -2.4668517113662407, 6.4031242374328485
105, 102, 172, 290, 177, 291, -5, -1, -2.9441970937399127, 5.0990195135927845
105, 103, 133, 312, 137, 313, -4, -1, -2.896613990462929, 4.123105625617661
105, 104, 558, 127, 555, 132, 3, -5, -1.0303768265243125, 5.830951894845301
105, 105, 120, 364, 122, 365, -2, -1, -2.677945044588987, 2.23606797749979
105, 106, 258, 204, 262, 206, -4, -2, -2.677945044588987, 4.47213595499958
105, 107, 224, 265, 229, 267, -5, -2, -2.761086276477428, 5.385164807134504
105, 108, 214, 289, 220, 291, -6, -2, -2.819842099193151, 6.324555320336759
105, 109, 252, 277, 257, 278, -5, -1, -2.9441970937399127, 5.0990195135927845
105, 110, 159, 258, 164, 259, -5, -1, -2.9441970937399127, 5.0990195135927845
105, 111, 63, 116, 65, 116, -2, 0, 3.141592653589793, 2.0
105, 112, 383, 366, 386, 367, -3, -1, -2.819842099193151, 3.1622776601683795
105, 113, 51, 202, 53, 204, -2, -2, -2.356194490192345, 2.8284271247461903
105, 114, 81, 196, 88, 199, -7, -3, -2.7367008673047097, 7.615773105863909
105, 115, 347, 271, 352, 274, -5, -3, -2.601173153319209, 5.830951894845301
105, 116, 282, 149, 286, 153, -4, -4, -2.356194490192345, 5.656854249492381
105, 117, 271, 341, 276, 342, -5, -1, -2.9441970937399127, 5.0990195135927845
105, 118, 465, 143, 466, 149, -1, -6, -1.7359450042095235, 6.082762530298219
105, 119, 161, 316, 168, 317, -7, -1, -2.999695598985629, 7.0710678118654755
105, 121, 319, 198, 323, 201, -4, -3, -2.498091544796509, 5.0
105, 122, 558, 245, 554, 251, 4, -6, -0.982793723247329, 7.211102550927978
105, 123, 569, 208, 567, 212, 2, -4, -1.1071487177940904, 4.47213595499958
105, 124, 160, 339, 164, 339, -4, 0, 3.141592653589793, 4.0
105, 125, 565, 358, 563, 359, 2, -1, -0.4636476090008061, 2.23606797749979
105, 126, 547, 141, 546, 145, 1, -4, -1.3258176636680326, 4.123105625617661
105, 127, 233, 338, 239, 339, -6, -1, -2.976443976175166, 6.082762530298219
105, 128, 340, 363, 342, 363, -2, 0, 3.141592653589793, 2.0
105, 129, 529, 137, 527, 138, 2, -1, -0.4636476090008061, 2.23606797749979
105, 130, 177, 158, 181, 161, -4, -3, -2.498091544796509, 5.0
105, 131, 519, 158, 518, 163, 1, -5, -1.373400766945016, 5.0990195135927845
105, 132, 341, 250, 346, 254, -5, -4, -2.4668517113662407, 6.4031242374328485
105, 133, 540, 135, 538, 136, 2, -1, -0.4636476090008061, 2.23606797749979
105, 134, 366, 368, 370, 368, -4, 0, 3.141592653589793, 4.0
105, 135, 97, 110, 99, 110, -2, 0, 3.141592653589793, 2.0
105, 136, 115, 148, 119, 151, -4, -3, -2.498091544796509, 5.0
105, 137, 60, 342, 63, 342, -3, 0, 3.141592653589793, 3.0
105, 138, 378, 194, 382, 198, -4, -4, -2.356194490192345, 5.656854249492381
105, 139, 472, 208, 474, 214, -2, -6, -1.892546881191539, 6.324555320336759
105, 140, 371, 157, 373, 161, -2, -4, -2.0344439357957027, 4.47213595499958
105, 141, 65, 192, 68, 194, -3, -2, -2.5535900500422257, 3.605551275463989
105, 142, 562, 230, 559, 234, 3, -4, -0.9272952180016122, 5.0
105, 143, 55, 184, 54, 185, 1, -1, -0.7853981633974483, 1.4142135623730951
105, 144, 153, 157, 157, 159, -4, -2, -2.677945044588987, 4.47213595499958
105, 145, 120, 332, 125, 333, -5, -1, -2.9441970937399127, 5.0990195135927845
105, 146, 109, 120, 113, 121, -4, -1, -2.896613990462929, 4.123105625617661
105, 147, 587, 174, 587, 176, 0, -2, -1.5707963267948966, 2.0
105, 148, 358, 193, 363, 197, -5, -4, -2.4668517113662407, 6.4031242374328485
105, 149, 96, 156, 101, 158, -5, -2, -2.761086276477428, 5.385164807134504
105, 150, 569, 176, 567, 179, 2, -3, -0.982793723247329, 3.605551275463989
105, 151, 581, 286, 579, 288, 2, -2, -0.7853981633974483, 2.8284271247461903
105, 152, 596, 225, 597, 227, -1, -2, -2.0344439357957027, 2.23606797749979
105, 153, 588, 159, 587, 162, 1, -3, -1.2490457723982544, 3.1622776601683795
105, 154, 486, 123, 486, 125, 0, -2, -1.5707963267948966, 2.0
106, 2, 326, 173, 330, 176, -4, -3, -2.498091544796509, 5.0
106, 3, 354, 125, 356, 128, -2, -3, -2.158798930342464, 3.605551275463989
106, 7, 139, 122, 143, 124, -4, -2, -2.677945044588987, 4.47213595499958
106, 8, 604, 300, 603, 302, 1, -2, -1.1071487177940904, 2.23606797749979
106, 9, 53, 285, 55, 285, -2, 0, 3.141592653589793, 2.0
106, 10, 594, 171, 594, 173, 0, -2, -1.5707963267948966, 2.0
106, 11, 407, 151, 410, 156, -3, -5, -2.1112158270654806, 5.830951894845301
106, 12, 242, 197, 246, 200, -4, -3, -2.498091544796509, 5.0
106, 14, 504, 211, 503, 217, 1, -6, -1.4056476493802699, 6.082762530298219
106, 15, 231, 121, 233, 122, -2, -1, -2.677945044588987, 2.23606797749979
106, 16, 271, 206, 276, 209, -5, -3, -2.601173153319209, 5.830951894845301
106, 17, 423, 175, 425, 180, -2, -5, -1.9513027039072615, 5.385164807134504
106, 18, 119, 198, 124, 201, -5, -3, -2.601173153319209, 5.830951894845301
106, 19, 318, 260, 322, 261, -4, -1, -2.896613990462929, 4.123105625617661
106, 20, 139, 365, 144, 365, -5, 0, 3.141592653589793, 5.0
106, 21, 60, 129, 63, 130, -3, -1, -2.819842099193151, 3.1622776601683795
106, 23, 136, 334, 142, 334, -6, 0, 3.141592653589793, 6.0
106, 24, 237, 299, 244, 300, -7, -1, -2.999695598985629, 7.0710678118654755
106, 25, 279, 180, 283, 184, -4, -4, -2.356194490192345, 5.656854249492381
106, 26, 318, 314, 319, 313, -1, 1, 2.356194490192345, 1.4142135623730951
106, 27, 44, 292, 43, 293, 1, -1, -0.7853981633974483, 1.4142135623730951
106, 28, 55, 255, 60, 257, -5, -2, -2.761086276477428, 5.385164807134504
106, 29, 379, 272, 381, 273, -2, -1, -2.677945044588987, 2.23606797749979
106, 30, 399, 289, 401, 289, -2, 0, 3.141592653589793, 2.0
106, 31, 55, 365, 58, 366, -3, -1, -2.819842099193151, 3.1622776601683795
106, 34, 601, 157, 601, 159, 0, -2, -1.5707963267948966, 2.0
106, 36, 179, 121, 184, 124, -5, -3, -2.601173153319209, 5.830951894845301
106, 37, 515, 117, 514, 120, 1, -3, -1.2490457723982544, 3.1622776601683795
106, 40, 333, 368, 337, 369, -4, -1, -2.896613990462929, 4.123105625617661
106, 41, 552, 240, 549, 244, 3, -4, -0.9272952180016122, 5.0
106, 43, 594, 146, 594, 148, 0, -2, -1.5707963267948966, 2.0
106, 46, 594, 254, 594, 256, 0, -2, -1.5707963267948966, 2.0
106, 50, 598, 325, 597, 326, 1, -1, -0.7853981633974483, 1.4142135623730951
106, 53, 82, 150, 87, 152, -5, -2, -2.761086276477428, 5.385164807134504
106, 54, 600, 141, 600, 143, 0, -2, -1.5707963267948966, 2.0
106, 56, 336, 334, 343, 333, -7, 1, 2.999695598985629, 7.0710678118654755
106, 59, 70, 340, 73, 342, -3, -2, -2.5535900500422257, 3.605551275463989
106, 61, 136, 352, 141, 352, -5, 0, 3.141592653589793, 5.0
106, 62, 208, 129, 210, 131, -2, -2, -2.356194490192345, 2.8284271247461903
106, 63, 588, 223, 589, 225, -1, -2, -2.0344439357957027, 2.23606797749979
106, 64, 62, 147, 68, 150, -6, -3, -2.677945044588987, 6.708203932499369
106, 65, 55, 148, 55, 150, 0, -2, -1.5707963267948966, 2.0
106, 66, 289, 157, 294, 161, -5, -4, -2.4668517113662407, 6.4031242374328485
106, 67, 486, 166, 486, 171, 0, -5, -1.5707963267948966, 5.0
106, 68, 181, 203, 186, 206, -5, -3, -2.601173153319209, 5.830951894845301
106, 69, 197, 263, 203, 265, -6, -2, -2.819842099193151, 6.324555320336759
106, 70, 105, 235, 110, 237, -5, -2, -2.761086276477428, 5.385164807134504
106, 71, 425, 160, 427, 164, -2, -4, -2.0344439357957027, 4.47213595499958
106, 72, 333, 200, 337, 204, -4, -4, -2.356194490192345, 5.656854249492381
106, 73, 160, 187, 166, 190, -6, -3, -2.677945044588987, 6.708203932499369
106, 74, 172, 122, 174, 123, -2, -1, -2.677945044588987, 2.23606797749979
106, 75, 65, 297, 71, 298, -6, -1, -2.976443976175166, 6.082762530298219
106, 77, 584, 366, 583, 367, 1, -1, -0.7853981633974483, 1.4142135623730951
106, 78, 342, 357, 346, 358, -4, -1, -2.896613990462929, 4.123105625617661
106, 80, 599, 189, 599, 191, 0, -2, -1.5707963267948966, 2.0
106, 81, 382, 154, 386, 159, -4, -5, -2.2455372690184494, 6.4031242374328485
106, 83, 87, 124, 90, 124, -3, 0, 3.141592653589793, 3.0
106, 84, 130, 159, 135, 162, -5, -3, -2.601173153319209, 5.830951894845301
106, 88, 168, 289, 172, 290, -4, -1, -2.896613990462929, 4.123105625617661
106, 89, 127, 311, 133, 312, -6, -1, -2.976443976175166, 6.082762530298219
106, 90, 558, 125, 558, 127, 0, -2, -1.5707963267948966, 2.0
106, 91, 118, 363, 120, 364, -2, -1, -2.677945044588987, 2.23606797749979
106, 92, 255, 201, 258, 204, -3, -3, -2.356194490192345, 4.242640687119285
106, 93, 217, 262, 224, 265, -7, -3, -2.7367008673047097, 7.615773105863909
106, 94, 207, 287, 214, 289, -7, -2, -2.8632929945846817, 7.280109889280518
106, 95, 246, 275, 252, 277, -6, -2, -2.819842099193151, 6.324555320336759
106, 96, 154, 257, 159, 258, -5, -1, -2.9441970937399127, 5.0990195135927845
106, 97, 61, 115, 63, 116, -2, -1, -2.677945044588987, 2.23606797749979
106, 98, 380, 365, 383, 366, -3, -1, -2.819842099193151, 3.1622776601683795
106, 99, 75, 194, 81, 196, -6, -2, -2.819842099193151, 6.324555320336759
106, 100, 342, 269, 347, 271, -5, -2, -2.761086276477428, 5.385164807134504
106, 101, 277, 145, 282, 149, -5, -4, -2.4668517113662407, 6.4031242374328485
106, 102, 266, 340, 271, 341, -5, -1, -2.9441970937399127, 5.0990195135927845
106, 103, 465, 138, 465, 143, 0, -5, -1.5707963267948966, 5.0
106, 104, 156, 315, 161, 316, -5, -1, -2.9441970937399127, 5.0990195135927845
106, 106, 315, 194, 319, 198, -4, -4, -2.356194490192345, 5.656854249492381
106, 107, 562, 241, 558, 245, 4, -4, -0.7853981633974483, 5.656854249492381
106, 108, 570, 205, 569, 208, 1, -3, -1.2490457723982544, 3.1622776601683795
106, 109, 157, 338, 160, 339, -3, -1, -2.819842099193151, 3.1622776601683795
106, 110, 567, 357, 565, 358, 2, -1, -0.4636476090008061, 2.23606797749979
106, 111, 548, 137, 547, 141, 1, -4, -1.3258176636680326, 4.123105625617661
106, 112, 227, 338, 233, 338, -6, 0, 3.141592653589793, 6.0
106, 113, 336, 362, 340, 363, -4, -1, -2.896613990462929, 4.123105625617661
106, 115, 173, 155, 177, 158, -4, -3, -2.498091544796509, 5.0
106, 116, 519, 154, 519, 158, 0, -4, -1.5707963267948966, 4.0
106, 117, 336, 247, 341, 250, -5, -3, -2.601173153319209, 5.830951894845301
106, 119, 363, 369, 366, 368, -3, 1, 2.819842099193151, 3.1622776601683795
106, 120, 95, 110, 97, 110, -2, 0, 3.141592653589793, 2.0
106, 121, 111, 146, 115, 148, -4, -2, -2.677945044588987, 4.47213595499958
106, 122, 57, 342, 60, 342, -3, 0, 3.141592653589793, 3.0
106, 123, 376, 191, 378, 194, -2, -3, -2.158798930342464, 3.605551275463989
106, 124, 470, 204, 472, 208, -2, -4, -2.0344439357957027, 4.47213595499958
106, 125, 367, 154, 371, 157, -4, -3, -2.498091544796509, 5.0
106, 126, 565, 225, 562, 230, 3, -5, -1.0303768265243125, 5.830951894845301
106, 127, 56, 183, 55, 184, 1, -1, -0.7853981633974483, 1.4142135623730951
106, 128, 148, 154, 153, 157, -5, -3, -2.601173153319209, 5.830951894845301
106, 129, 115, 330, 120, 332, -5, -2, -2.761086276477428, 5.385164807134504
106, 130, 105, 118, 109, 120, -4, -2, -2.677945044588987, 4.47213595499958
106, 131, 586, 172, 587, 174, -1, -2, -2.0344439357957027, 2.23606797749979
106, 132, 354, 189, 358, 193, -4, -4, -2.356194490192345, 5.656854249492381
106, 133, 91, 154, 96, 156, -5, -2, -2.761086276477428, 5.385164807134504
106, 134, 571, 173, 569, 176, 2, -3, -0.982793723247329, 3.605551275463989
106, 135, 582, 284, 581, 286, 1, -2, -1.1071487177940904, 2.23606797749979
106, 136, 596, 223, 596, 225, 0, -2, -1.5707963267948966, 2.0
106, 137, 588, 156, 588, 159, 0, -3, -1.5707963267948966, 3.0
107, 1, 505, 116, 504, 117, 1, -1, -0.7853981633974483, 1.4142135623730951
107, 2, 320, 170, 326, 173, -6, -3, -2.677945044588987, 6.708203932499369
107, 3, 351, 123, 354, 125, -3, -2, -2.5535900500422257, 3.605551275463989
107, 5, 137, 121, 139, 122, -2, -1, -2.677945044588987, 2.23606797749979
107, 6, 605, 298, 604, 300, 1, -2, -1.1071487177940904, 2.23606797749979
107, 7, 593, 169, 594, 171, -1, -2, -2.0344439357957027, 2.23606797749979
107, 8, 405, 146, 407, 151, -2, -5, -1.9513027039072615, 5.385164807134504
107, 9, 238, 194, 242, 197, -4, -3, -2.498091544796509, 5.0
107, 10, 504, 206, 504, 211, 0, -5, -1.5707963267948966, 5.0
107, 11, 229, 121, 231, 121, -2, 0, 3.141592653589793, 2.0
107, 12, 268, 206, 271, 206, -3, 0, 3.141592653589793, 3.0
107, 13, 420, 172, 423, 175, -3, -3, -2.356194490192345, 4.242640687119285
107, 14, 114, 196, 119, 198, -5, -2, -2.761086276477428, 5.385164807134504
107, 15, 314, 258, 318, 260, -4, -2, -2.677945044588987, 4.47213595499958
107, 16, 134, 364, 139, 365, -5, -1, -2.9441970937399127, 5.0990195135927845
107, 17, 57, 129, 60, 129, -3, 0, 3.141592653589793, 3.0
107, 19, 132, 333, 136, 334, -4, -1, -2.896613990462929, 4.123105625617661
107, 20, 233, 298, 237, 299, -4, -1, -2.896613990462929, 4.123105625617661
107, 21, 276, 178, 279, 180, -3, -2, -2.5535900500422257, 3.605551275463989
107, 22, 313, 313, 318, 314, -5, -1, -2.9441970937399127, 5.0990195135927845
107, 24, 51, 253, 55, 255, -4, -2, -2.677945044588987, 4.47213595499958
107, 28, 297, 131, 299, 132, -2, -1, -2.677945044588987, 2.23606797749979
107, 29, 601, 155, 601, 157, 0, -2, -1.5707963267948966, 2.0
107, 31, 177, 120, 179, 121, -2, -1, -2.677945044588987, 2.23606797749979
107, 32, 516, 115, 515, 117, 1, -2, -1.1071487177940904, 2.23606797749979
107, 34, 560, 365, 559, 366, 1, -1, -0.7853981633974483, 1.4142135623730951
107, 35, 329, 367, 333, 368, -4, -1, -2.896613990462929, 4.123105625617661
107, 36, 554, 236, 552, 240, 2, -4, -1.1071487177940904, 4.47213595499958
107, 38, 594, 144, 594, 146, 0, -2, -1.5707963267948966, 2.0
107, 44, 599, 324, 598, 325, 1, -1, -0.7853981633974483, 1.4142135623730951
107, 45, 604, 239, 603, 240, 1, -1, -0.7853981633974483, 1.4142135623730951
107, 46, 78, 148, 82, 150, -4, -2, -2.677945044588987, 4.47213595499958
107, 49, 329, 334, 336, 334, -7, 0, 3.141592653589793, 7.0
107, 52, 68, 339, 70, 340, -2, -1, -2.677945044588987, 2.23606797749979
107, 53, 151, 109, 153, 109, -2, 0, 3.141592653589793, 2.0
107, 54, 132, 351, 136, 352, -4, -1, -2.896613990462929, 4.123105625617661
107, 55, 205, 128, 208, 129, -3, -1, -2.819842099193151, 3.1622776601683795
107, 56, 587, 221, 588, 223, -1, -2, -2.0344439357957027, 2.23606797749979
107, 57, 60, 146, 62, 147, -2, -1, -2.677945044588987, 2.23606797749979
107, 59, 284, 155, 289, 157, -5, -2, -2.761086276477428, 5.385164807134504
107, 60, 486, 160, 486, 166, 0, -6, -1.5707963267948966, 6.0
107, 61, 177, 200, 181, 203, -4, -3, -2.498091544796509, 5.0
107, 62, 193, 262, 197, 263, -4, -1, -2.896613990462929, 4.123105625617661
107, 63, 101, 233, 105, 235, -4, -2, -2.677945044588987, 4.47213595499958
107, 64, 422, 157, 425, 160, -3, -3, -2.356194490192345, 4.242640687119285
107, 65, 329, 197, 333, 200, -4, -3, -2.498091544796509, 5.0
107, 66, 159, 184, 160, 187, -1, -3, -1.892546881191539, 3.1622776601683795
107, 67, 170, 121, 172, 122, -2, -1, -2.677945044588987, 2.23606797749979
107, 68, 61, 296, 65, 297, -4, -1, -2.896613990462929, 4.123105625617661
107, 71, 337, 356, 342, 357, -5, -1, -2.9441970937399127, 5.0990195135927845
107, 72, 379, 150, 382, 154, -3, -4, -2.214297435588181, 5.0
107, 73, 84, 123, 87, 124, -3, -1, -2.819842099193151, 3.1622776601683795
107, 74, 125, 156, 130, 159, -5, -3, -2.601173153319209, 5.830951894845301
107, 78, 166, 288, 168, 289, -2, -1, -2.677945044588987, 2.23606797749979
107, 79, 122, 310, 127, 311, -5, -1, -2.9441970937399127, 5.0990195135927845
107, 80, 558, 123, 558, 125, 0, -2, -1.5707963267948966, 2.0
107, 81, 114, 362, 118, 363, -4, -1, -2.896613990462929, 4.123105625617661
107, 82, 252, 197, 255, 201, -3, -4, -2.214297435588181, 5.0
107, 83, 213, 262, 217, 262, -4, 0, 3.141592653589793, 4.0
107, 84, 203, 286, 207, 287, -4, -1, -2.896613990462929, 4.123105625617661
107, 85, 240, 273, 246, 275, -6, -2, -2.819842099193151, 6.324555320336759
107, 86, 149, 256, 154, 257, -5, -1, -2.9441970937399127, 5.0990195135927845
107, 87, 376, 364, 380, 365, -4, -1, -2.896613990462929, 4.123105625617661
107, 88, 73, 193, 75, 194, -2, -1, -2.677945044588987, 2.23606797749979
107, 89, 337, 267, 342, 269, -5, -2, -2.761086276477428, 5.385164807134504
107, 90, 272, 144, 277, 145, -5, -1, -2.9441970937399127, 5.0990195135927845
107, 91, 261, 339, 266, 340, -5, -1, -2.9441970937399127, 5.0990195135927845
107, 92, 463, 136, 465, 138, -2, -2, -2.356194490192345, 2.8284271247461903
107, 93, 153, 313, 156, 315, -3, -2, -2.5535900500422257, 3.605551275463989
107, 94, 596, 310, 598, 311, -2, -1, -2.677945044588987, 2.23606797749979
107, 95, 311, 191, 315, 194, -4, -3, -2.498091544796509, 5.0
107, 96, 563, 239, 562, 241, 1, -2, -1.1071487177940904, 2.23606797749979
107, 97, 569, 356, 567, 357, 2, -1, -0.4636476090008061, 2.23606797749979
107, 98, 550, 133, 548, 137, 2, -4, -1.1071487177940904, 4.47213595499958
107, 99, 220, 337, 227, 338, -7, -1, -2.999695598985629, 7.0710678118654755
107, 100, 332, 361, 336, 362, -4, -1, -2.896613990462929, 4.123105625617661
107, 101, 530, 136, 529, 137, 1, -1, -0.7853981633974483, 1.4142135623730951
107, 102, 169, 152, 173, 155, -4, -3, -2.498091544796509, 5.0
107, 103, 519, 151, 519, 154, 0, -3, -1.5707963267948966, 3.0
107, 104, 332, 244, 336, 247, -4, -3, -2.498091544796509, 5.0
107, 106, 360, 369, 363, 369, -3, 0, 3.141592653589793, 3.0
107, 108, 108, 144, 111, 146, -3, -2, -2.5535900500422257, 3.605551275463989
107, 109, 55, 342, 57, 342, -2, 0, 3.141592653589793, 2.0
107, 110, 372, 187, 376, 191, -4, -4, -2.356194490192345, 5.656854249492381
107, 111, 469, 199, 470, 204, -1, -5, -1.7681918866447774, 5.0990195135927845
107, 112, 363, 150, 367, 154, -4, -4, -2.356194490192345, 5.656854249492381
107, 113, 568, 220, 565, 225, 3, -5, -1.0303768265243125, 5.830951894845301
107, 115, 144, 151, 148, 154, -4, -3, -2.498091544796509, 5.0
107, 116, 111, 329, 115, 330, -4, -1, -2.896613990462929, 4.123105625617661
107, 117, 103, 118, 105, 118, -2, 0, 3.141592653589793, 2.0
107, 118, 585, 170, 586, 172, -1, -2, -2.0344439357957027, 2.23606797749979
107, 119, 350, 186, 354, 189, -4, -3, -2.498091544796509, 5.0
107, 120, 86, 152, 91, 154, -5, -2, -2.761086276477428, 5.385164807134504
107, 121, 573, 169, 571, 173, 2, -4, -1.1071487177940904, 4.47213595499958
107, 122, 583, 281, 582, 284, 1, -3, -1.2490457723982544, 3.1622776601683795
107, 123, 595, 220, 596, 223, -1, -3, -1.892546881191539, 3.1622776601683795
107, 124, 588, 153, 588, 156, 0, -3, -1.5707963267948966, 3.0
108, 1, 505, 114, 505, 116, 0, -2, -1.5707963267948966, 2.0
108, 2, 317, 168, 320, 170, -3, -2, -2.5535900500422257, 3.605551275463989
108, 3, 349, 122, 351, 123, -2, -1, -2.677945044588987, 2.23606797749979
108, 5, 135, 121, 137, 121, -2, 0, 3.141592653589793, 2.0
108, 7, 592, 167, 593, 169, -1, -2, -2.0344439357957027, 2.23606797749979
108, 8, 404, 143, 405, 146, -1, -3, -1.892546881191539, 3.1622776601683795
108, 9, 232, 190, 238, 194, -6, -4, -2.5535900500422257, 7.211102550927978
108, 10, 504, 201, 504, 206, 0, -5, -1.5707963267948966, 5.0
108, 11, 226, 121, 229, 121, -3, 0, 3.141592653589793, 3.0
108, 12, 264, 205, 268, 206, -4, -1, -2.896613990462929, 4.123105625617661
108, 13, 419, 167, 420, 172, -1, -5, -1.7681918866447774, 5.0990195135927845
108, 14, 108, 195, 114, 196, -6, -1, -2.976443976175166, 6.082762530298219
108, 15, 310, 256, 314, 258, -4, -2, -2.677945044588987, 4.47213595499958
108, 16, 131, 364, 134, 364, -3, 0, 3.141592653589793, 3.0
108, 17, 55, 128, 57, 129, -2, -1, -2.677945044588987, 2.23606797749979
108, 18, 514, 364, 513, 365, 1, -1, -0.7853981633974483, 1.4142135623730951
108, 19, 131, 331, 132, 333, -1, -2, -2.0344439357957027, 2.23606797749979
108, 20, 229, 298, 233, 298, -4, 0, 3.141592653589793, 4.0
108, 21, 272, 175, 276, 178, -4, -3, -2.498091544796509, 5.0
108, 22, 311, 313, 313, 313, -2, 0, 3.141592653589793, 2.0
108, 25, 379, 268, 379, 271, 0, -3, -1.5707963267948966, 3.0
108, 26, 53, 364, 55, 365, -2, -1, -2.677945044588987, 2.23606797749979
108, 31, 175, 118, 177, 120, -2, -2, -2.356194490192345, 2.8284271247461903
108, 33, 561, 364, 560, 365, 1, -1, -0.7853981633974483, 1.4142135623730951
108, 35, 554, 233, 554, 236, 0, -3, -1.5707963267948966, 3.0
108, 43, 600, 322, 599, 324, 1, -2, -1.1071487177940904, 2.23606797749979
108, 45, 73, 145, 78, 148, -5, -3, -2.601173153319209, 5.830951894845301
108, 48, 325, 334, 329, 334, -4, 0, 3.141592653589793, 4.0
108, 51, 66, 339, 68, 339, -2, 0, 3.141592653589793, 2.0
108, 52, 149, 109, 151, 109, -2, 0, 3.141592653589793, 2.0
108, 53, 127, 350, 132, 351, -5, -1, -2.9441970937399127, 5.0990195135927845
108, 54, 203, 127, 205, 128, -2, -1, -2.677945044588987, 2.23606797749979
108, 55, 586, 219, 587, 221, -1, -2, -2.0344439357957027, 2.23606797749979
108, 57, 281, 153, 284, 155, -3, -2, -2.5535900500422257, 3.605551275463989
108, 58, 485, 156, 486, 160, -1, -4, -1.8157749899217608, 4.123105625617661
108, 59, 190, 261, 193, 262, -3, -1, -2.819842099193151, 3.1622776601683795
108, 60, 98, 230, 101, 233, -3, -3, -2.356194490192345, 4.242640687119285
108, 61, 420, 152, 422, 157, -2, -5, -1.9513027039072615, 5.385164807134504
108, 62, 325, 198, 329, 197, -4, 1, 2.896613990462929, 4.123105625617661
108, 63, 156, 182, 159, 184, -3, -2, -2.5535900500422257, 3.605551275463989
108, 64, 167, 119, 170, 121, -3, -2, -2.5535900500422257, 3.605551275463989
108, 67, 334, 356, 337, 356, -3, 0, 3.141592653589793, 3.0
108, 69, 81, 123, 84, 123, -3, 0, 3.141592653589793, 3.0
108, 70, 122, 154, 125, 156, -3, -2, -2.5535900500422257, 3.605551275463989
108, 74, 118, 307, 122, 310, -4, -3, -2.498091544796509, 5.0
108, 75, 111, 361, 114, 362, -3, -1, -2.819842099193151, 3.1622776601683795
108, 76, 248, 193, 252, 197, -4, -4, -2.356194490192345, 5.656854249492381
108, 77, 212, 263, 213, 262, -1, 1, 2.356194490192345, 1.4142135623730951
108, 78, 200, 287, 203, 286, -3, 1, 2.819842099193151, 3.1622776601683795
108, 79, 238, 272, 240, 273, -2, -1, -2.677945044588987, 2.23606797749979
108, 80, 143, 255, 149, 256, -6, -1, -2.976443976175166, 6.082762530298219
108, 81, 374, 363, 376, 364, -2, -1, -2.677945044588987, 2.23606797749979
108, 82, 70, 191, 73, 193, -3, -2, -2.5535900500422257, 3.605551275463989
108, 83, 332, 266, 337, 267, -5, -1, -2.9441970937399127, 5.0990195135927845
108, 84, 270, 143, 272, 144, -2, -1, -2.677945044588987, 2.23606797749979
108, 85, 151, 312, 153, 313, -2, -1, -2.677945044588987, 2.23606797749979
108, 87, 307, 191, 311, 191, -4, 0, 3.141592653589793, 4.0
108, 88, 566, 237, 563, 239, 3, -2, -0.5880026035475675, 3.605551275463989
108, 89, 571, 356, 569, 356, 2, 0, 0.0, 2.0
108, 90, 550, 130, 550, 133, 0, -3, -1.5707963267948966, 3.0
108, 91, 216, 335, 220, 337, -4, -2, -2.677945044588987, 4.47213595499958
108, 92, 329, 362, 332, 361, -3, 1, 2.819842099193151, 3.1622776601683795
108, 93, 531, 134, 530, 136, 1, -2, -1.1071487177940904, 2.23606797749979
108, 94, 166, 149, 169, 152, -3, -3, -2.356194490192345, 4.242640687119285
108, 95, 519, 148, 519, 151, 0, -3, -1.5707963267948966, 3.0
108, 96, 329, 243, 332, 244, -3, -1, -2.819842099193151, 3.1622776601683795
108, 97, 543, 134, 542, 135, 1, -1, -0.7853981633974483, 1.4142135623730951
108, 98, 357, 368, 360, 369, -3, -1, -2.819842099193151, 3.1622776601683795
108, 100, 103, 141, 108, 144, -5, -3, -2.601173153319209, 5.830951894845301
108, 102, 370, 185, 372, 187, -2, -2, -2.356194490192345, 2.8284271247461903
108, 103, 467, 196, 469, 199, -2, -3, -2.158798930342464, 3.605551275463989
108, 104, 361, 147, 363, 150, -2, -3, -2.158798930342464, 3.605551275463989
108, 105, 568, 218, 568, 220, 0, -2, -1.5707963267948966, 2.0
108, 106, 55, 180, 56, 182, -1, -2, -2.0344439357957027, 2.23606797749979
108, 107, 139, 148, 144, 151, -5, -3, -2.601173153319209, 5.830951894845301
108, 108, 109, 327, 111, 329, -2, -2, -2.356194490192345, 2.8284271247461903
108, 109, 100, 118, 103, 118, -3, 0, 3.141592653589793, 3.0
108, 110, 585, 168, 585, 170, 0, -2, -1.5707963267948966, 2.0
108, 111, 348, 183, 350, 186, -2, -3, -2.158798930342464, 3.605551275463989
108, 112, 82, 149, 86, 152, -4, -3, -2.498091544796509, 5.0
108, 113, 575, 166, 573, 169, 2, -3, -0.982793723247329, 3.605551275463989
108, 114, 583, 279, 583, 281, 0, -2, -1.5707963267948966, 2.0
108, 115, 595, 218, 595, 220, 0, -2, -1.5707963267948966, 2.0
108, 116, 587, 151, 588, 153, -1, -2, -2.0344439357957027, 2.23606797749979
109, 1, 505, 112, 505, 114, 0, -2, -1.5707963267948966, 2.0
109, 2, 313, 165, 317, 168, -4, -3, -2.498091544796509, 5.0
109, 3, 347, 122, 349, 122, -2, 0, 3.141592653589793, 2.0
109, 5, 133, 120, 135, 121, -2, -1, -2.677945044588987, 2.23606797749979
109, 6, 592, 165, 592, 167, 0, -2, -1.5707963267948966, 2.0
109, 8, 228, 188, 232, 190, -4, -2, -2.677945044588987, 4.47213595499958
109, 9, 503, 197, 504, 201, -1, -4, -1.8157749899217608, 4.123105625617661
109, 10, 224, 120, 226, 121, -2, -1, -2.677945044588987, 2.23606797749979
109, 12, 418, 165, 419, 167, -1, -2, -2.0344439357957027, 2.23606797749979
109, 13, 103, 193, 108, 195, -5, -2, -2.761086276477428, 5.385164807134504
109, 15, 128, 363, 131, 364, -3, -1, -2.819842099193151, 3.1622776601683795
109, 17, 126, 330, 131, 331, -5, -1, -2.9441970937399127, 5.0990195135927845
109, 18, 226, 298, 229, 298, -3, 0, 3.141592653589793, 3.0
109, 19, 269, 173, 272, 175, -3, -2, -2.5535900500422257, 3.605551275463989
109, 20, 306, 313, 311, 313, -5, 0, 3.141592653589793, 5.0
109, 22, 48, 250, 51, 252, -3, -2, -2.5535900500422257, 3.605551275463989
109, 23, 377, 266, 379, 268, -2, -2, -2.356194490192345, 2.8284271247461903
109, 26, 294, 130, 296, 131, -2, -1, -2.677945044588987, 2.23606797749979
109, 27, 173, 117, 175, 118, -2, -1, -2.677945044588987, 2.23606797749979
109, 29, 562, 363, 561, 364, 1, -1, -0.7853981633974483, 1.4142135623730951
109, 30, 325, 368, 328, 367, -3, 1, 2.819842099193151, 3.1622776601683795
109, 31, 554, 231, 554, 233, 0, -2, -1.5707963267948966, 2.0
109, 37, 601, 321, 600, 322, 1, -1, -0.7853981633974483, 1.4142135623730951
109, 41, 321, 333, 325, 334, -4, -1, -2.896613990462929, 4.123105625617661
109, 42, 64, 339, 66, 339, -2, 0, 3.141592653589793, 2.0
109, 43, 147, 108, 149, 109, -2, -1, -2.677945044588987, 2.23606797749979
109, 44, 125, 347, 127, 350, -2, -3, -2.158798930342464, 3.605551275463989
109, 45, 583, 219, 586, 219, -3, 0, 3.141592653589793, 3.0
109, 46, 56, 145, 56, 147, 0, -2, -1.5707963267948966, 2.0
109, 47, 278, 151, 281, 153, -3, -2, -2.5535900500422257, 3.605551275463989
109, 48, 485, 151, 485, 156, 0, -5, -1.5707963267948966, 5.0
109, 49, 187, 261, 190, 261, -3, 0, 3.141592653589793, 3.0
109, 50, 94, 228, 98, 230, -4, -2, -2.677945044588987, 4.47213595499958
109, 52, 324, 196, 325, 198, -1, -2, -2.0344439357957027, 2.23606797749979
109, 53, 153, 180, 156, 182, -3, -2, -2.5535900500422257, 3.605551275463989
109, 54, 165, 118, 167, 119, -2, -1, -2.677945044588987, 2.23606797749979
109, 57, 331, 356, 334, 356, -3, 0, 3.141592653589793, 3.0
109, 58, 376, 148, 378, 150, -2, -2, -2.356194490192345, 2.8284271247461903
109, 59, 79, 122, 81, 123, -2, -1, -2.677945044588987, 2.23606797749979
109, 60, 121, 152, 122, 154, -1, -2, -2.0344439357957027, 2.23606797749979
109, 61, 78, 110, 80, 111, -2, -1, -2.677945044588987, 2.23606797749979
109, 64, 119, 305, 118, 307, 1, -2, -1.1071487177940904, 2.23606797749979
109, 65, 107, 360, 111, 361, -4, -1, -2.896613990462929, 4.123105625617661
109, 66, 246, 191, 248, 193, -2, -2, -2.356194490192345, 2.8284271247461903
109, 67, 208, 262, 212, 263, -4, -1, -2.896613990462929, 4.123105625617661
109, 68, 197, 288, 200, 287, -3, 1, 2.819842099193151, 3.1622776601683795
109, 69, 235, 272, 238, 272, -3, 0, 3.141592653589793, 3.0
109, 70, 142, 256, 143, 255, -1, 1, 2.356194490192345, 1.4142135623730951
109, 71, 371, 362, 374, 363, -3, -1, -2.819842099193151, 3.1622776601683795
109, 72, 67, 189, 70, 191, -3, -2, -2.5535900500422257, 3.605551275463989
109, 73, 328, 264, 332, 266, -4, -2, -2.677945044588987, 4.47213595499958
109, 74, 145, 311, 151, 312, -6, -1, -2.976443976175166, 6.082762530298219
109, 75, 569, 236, 566, 237, 3, -1, -0.3217505543966422, 3.1622776601683795
109, 76, 573, 355, 571, 356, 2, -1, -0.4636476090008061, 2.23606797749979
109, 77, 548, 128, 550, 130, -2, -2, -2.356194490192345, 2.8284271247461903
109, 78, 212, 334, 216, 335, -4, -1, -2.896613990462929, 4.123105625617661
109, 79, 325, 364, 329, 362, -4, 2, 2.677945044588987, 4.47213595499958
109, 80, 532, 133, 531, 134, 1, -1, -0.7853981633974483, 1.4142135623730951
109, 81, 164, 146, 166, 149, -2, -3, -2.158798930342464, 3.605551275463989
109, 82, 520, 145, 519, 148, 1, -3, -1.2490457723982544, 3.1622776601683795
109, 83, 325, 243, 329, 243, -4, 0, 3.141592653589793, 4.0
109, 84, 544, 132, 543, 134, 1, -2, -1.1071487177940904, 2.23606797749979
109, 85, 355, 367, 357, 368, -2, -1, -2.677945044588987, 2.23606797749979
109, 86, 91, 109, 93, 110, -2, -1, -2.677945044588987, 2.23606797749979
109, 87, 99, 139, 103, 141, -4, -2, -2.677945044588987, 4.47213595499958
109, 88, 52, 342, 54, 342, -2, 0, 3.141592653589793, 2.0
109, 89, 367, 183, 370, 185, -3, -2, -2.5535900500422257, 3.605551275463989
109, 90, 466, 193, 467, 196, -1, -3, -1.892546881191539, 3.1622776601683795
109, 91, 356, 146, 361, 147, -5, -1, -2.9441970937399127, 5.0990195135927845
109, 92, 568, 214, 568, 218, 0, -4, -1.5707963267948966, 4.0
109, 94, 135, 148, 139, 148, -4, 0, 3.141592653589793, 4.0
109, 95, 106, 328, 109, 327, -3, 1, 2.819842099193151, 3.1622776601683795
109, 96, 97, 117, 100, 118, -3, -1, -2.819842099193151, 3.1622776601683795
109, 97, 584, 166, 585, 168, -1, -2, -2.0344439357957027, 2.23606797749979
109, 98, 345, 179, 348, 183, -3, -4, -2.214297435588181, 5.0
109, 99, 77, 147, 82, 149, -5, -2, -2.761086276477428, 5.385164807134504
109, 100, 577, 163, 575, 166, 2, -3, -0.982793723247329, 3.605551275463989
109, 101, 595, 216, 595, 218, 0, -2, -1.5707963267948966, 2.0
110, 1, 46, 269, 47, 271, -1, -2, -2.0344439357957027, 2.23606797749979
110, 2, 235, 194, 239, 197, -4, -3, -2.498091544796509, 5.0
110, 3, 229, 296, 234, 297, -5, -1, -2.9441970937399127, 5.0990195135927845
110, 4, 321, 167, 325, 171, -4, -4, -2.356194490192345, 5.656854249492381
110, 6, 60, 149, 61, 151, -1, -2, -2.0344439357957027, 2.23606797749979
110, 7, 74, 149, 79, 152, -5, -3, -2.601173153319209, 5.830951894845301
110, 8, 177, 123, 179, 125, -2, -2, -2.356194490192345, 2.8284271247461903
110, 9, 109, 196, 115, 199, -6, -3, -2.677945044588987, 6.708203932499369
110, 10, 129, 334, 135, 334, -6, 0, 3.141592653589793, 6.0
110, 14, 351, 124, 353, 125, -2, -1, -2.677945044588987, 2.23606797749979
110, 15, 482, 117, 483, 116, -1, 1, 2.356194490192345, 1.4142135623730951
110, 17, 418, 168, 420, 174, -2, -6, -1.892546881191539, 6.324555320336759
110, 18, 515, 366, 514, 367, 1, -1, -0.7853981633974483, 1.4142135623730951
110, 20, 328, 118, 330, 119, -2, -1, -2.677945044588987, 2.23606797749979
110, 21, 51, 250, 54, 252, -3, -2, -2.5535900500422257, 3.605551275463989
110, 26, 137, 126, 139, 126, -2, 0, 3.141592653589793, 2.0
110, 28, 305, 311, 311, 311, -6, 0, 3.141592653589793, 6.0
110, 30, 331, 366, 335, 366, -4, 0, 3.141592653589793, 4.0
110, 31, 404, 146, 407, 151, -3, -5, -2.1112158270654806, 5.830951894845301
110, 33, 168, 121, 170, 122, -2, -1, -2.677945044588987, 2.23606797749979
110, 37, 595, 169, 595, 171, 0, -2, -1.5707963267948966, 2.0
110, 38, 200, 286, 207, 287, -7, -1, -2.999695598985629, 7.0710678118654755
110, 39, 53, 117, 54, 119, -1, -2, -2.0344439357957027, 2.23606797749979
110, 40, 150, 110, 154, 111, -4, -1, -2.896613990462929, 4.123105625617661
110, 41, 368, 260, 373, 263, -5, -3, -2.601173153319209, 5.830951894845301
110, 45, 58, 132, 60, 132, -2, 0, 3.141592653589793, 2.0
110, 46, 274, 173, 279, 178, -5, -5, -2.356194490192345, 7.0710678118654755
110, 50, 590, 219, 590, 222, 0, -3, -1.5707963267948966, 3.0
110, 51, 595, 189, 596, 191, -1, -2, -2.0344439357957027, 2.23606797749979
110, 52, 541, 135, 540, 136, 1, -1, -0.7853981633974483, 1.4142135623730951
110, 56, 207, 130, 209, 130, -2, 0, 3.141592653589793, 2.0
110, 57, 248, 199, 252, 201, -4, -2, -2.677945044588987, 4.47213595499958
110, 59, 455, 367, 457, 367, -2, 0, 3.141592653589793, 2.0
110, 60, 312, 254, 318, 258, -6, -4, -2.5535900500422257, 7.211102550927978
110, 61, 266, 199, 272, 204, -6, -5, -2.44685437739309, 7.810249675906654
110, 64, 572, 359, 569, 359, 3, 0, 0.0, 3.0
110, 65, 231, 121, 233, 122, -2, -1, -2.677945044588987, 2.23606797749979
110, 66, 374, 367, 378, 368, -4, -1, -2.896613990462929, 4.123105625617661
110, 67, 133, 366, 137, 366, -4, 0, 3.141592653589793, 4.0
110, 69, 87, 116, 89, 118, -2, -2, -2.356194490192345, 2.8284271247461903
110, 75, 484, 158, 485, 164, -1, -6, -1.7359450042095235, 6.082762530298219
110, 76, 68, 196, 74, 198, -6, -2, -2.819842099193151, 6.324555320336759
110, 80, 509, 202, 507, 207, 2, -5, -1.1902899496825317, 5.385164807134504
110, 81, 98, 232, 103, 234, -5, -2, -2.761086276477428, 5.385164807134504
110, 82, 61, 297, 66, 298, -5, -1, -2.9441970937399127, 5.0990195135927845
110, 84, 111, 251, 114, 251, -3, 0, 3.141592653589793, 3.0
110, 85, 196, 109, 198, 109, -2, 0, 3.141592653589793, 2.0
110, 86, 601, 325, 600, 326, 1, -1, -0.7853981633974483, 1.4142135623730951
110, 90, 348, 184, 353, 188, -5, -4, -2.4668517113662407, 6.4031242374328485
110, 91, 83, 126, 87, 127, -4, -1, -2.896613990462929, 4.123105625617661
110, 93, 569, 234, 565, 240, 4, -6, -0.982793723247329, 7.211102550927978
110, 94, 506, 130, 505, 133, 1, -3, -1.2490457723982544, 3.1622776601683795
110, 96, 535, 124, 534, 125, 1, -1, -0.7853981633974483, 1.4142135623730951
110, 98, 63, 345, 66, 345, -3, 0, 3.141592653589793, 3.0
110, 99, 593, 144, 594, 146, -1, -2, -2.0344439357957027, 2.23606797749979
110, 100, 162, 290, 165, 290, -3, 0, 3.141592653589793, 3.0
110, 101, 189, 261, 195, 263, -6, -2, -2.819842099193151, 6.324555320336759
110, 102, 294, 137, 297, 138, -3, -1, -2.819842099193151, 3.1622776601683795
110, 103, 603, 188, 604, 190, -1, -2, -2.0344439357957027, 2.23606797749979
110, 104, 525, 143, 524, 148, 1, -5, -1.373400766945016, 5.0990195135927845
110, 107, 129, 352, 134, 353, -5, -1, -2.9441970937399127, 5.0990195135927845
110, 109, 120, 312, 123, 313, -3, -1, -2.819842099193151, 3.1622776601683795
110, 110, 117, 330, 121, 330, -4, 0, 3.141592653589793, 4.0
110, 112, 586, 169, 587, 171, -1, -2, -2.0344439357957027, 2.23606797749979
110, 113, 67, 166, 69, 169, -2, -3, -2.158798930342464, 3.605551275463989
110, 114, 286, 132, 290, 134, -4, -2, -2.677945044588987, 4.47213595499958
110, 115, 154, 188, 160, 190, -6, -2, -2.819842099193151, 6.324555320336759
110, 119, 118, 109, 120, 110, -2, -1, -2.677945044588987, 2.23606797749979
110, 121, 597, 221, 597, 224, 0, -3, -1.5707963267948966, 3.0
110, 122, 561, 235, 558, 238, 3, -3, -0.7853981633974483, 4.242640687119285
110, 124, 123, 156, 128, 159, -5, -3, -2.601173153319209, 5.830951894845301
110, 125, 152, 318, 155, 318, -3, 0, 3.141592653589793, 3.0
110, 128, 239, 273, 243, 274, -4, -1, -2.896613990462929, 4.123105625617661
110, 129, 165, 153, 169, 155, -4, -2, -2.677945044588987, 4.47213595499958
110, 131, 81, 353, 86, 353, -5, 0, 3.141592653589793, 5.0
110, 132, 423, 153, 425, 158, -2, -5, -1.9513027039072615, 5.385164807134504
110, 133, 309, 191, 314, 194, -5, -3, -2.601173153319209, 5.830951894845301
110, 134, 563, 356, 561, 356, 2, 0, 0.0, 2.0
110, 135, 465, 129, 466, 134, -1, -5, -1.7681918866447774, 5.0990195135927845
110, 137, 59, 171, 60, 173, -1, -2, -2.0344439357957027, 2.23606797749979
110, 138, 574, 162, 573, 167, 1, -5, -1.373400766945016, 5.0990195135927845
110, 140, 174, 201, 179, 204, -5, -3, -2.601173153319209, 5.830951894845301
110, 141, 113, 146, 118, 149, -5, -3, -2.601173153319209, 5.830951894845301
110, 142, 512, 126, 512, 130, 0, -4, -1.5707963267948966, 4.0
110, 144, 257, 343, 262, 343, -5, 0, 3.141592653589793, 5.0
110, 145, 323, 336, 332, 335, -9, 1, 3.0309354324158977, 9.055385138137417
110, 146, 239, 296, 243, 297, -4, -1, -2.896613990462929, 4.123105625617661
110, 147, 210, 260, 216, 262, -6, -2, -2.819842099193151, 6.324555320336759
110, 148, 86, 181, 90, 183, -4, -2, -2.677945044588987, 4.47213595499958
110, 149, 329, 243, 333, 246, -4, -3, -2.498091544796509, 5.0
110, 150, 335, 171, 340, 176, -5, -5, -2.356194490192345, 7.0710678118654755
110, 153, 137, 305, 143, 306, -6, -1, -2.976443976175166, 6.082762530298219
110, 154, 291, 314, 294, 314, -3, 0, 3.141592653589793, 3.0
110, 155, 238, 361, 242, 360, -4, 1, 2.896613990462929, 4.123105625617661
110, 156, 146, 255, 151, 256, -5, -1, -2.9441970937399127, 5.0990195135927845
110, 157, 109, 365, 113, 366, -4, -1, -2.896613990462929, 4.123105625617661
110, 158, 214, 211, 220, 214, -6, -3, -2.677945044588987, 6.708203932499369
110, 159, 433, 199, 435, 203, -2, -4, -2.0344439357957027, 4.47213595499958
110, 161, 339, 358, 342, 359, -3, -1, -2.819842099193151, 3.1622776601683795
110, 162, 277, 367, 281, 368, -4, -1, -2.896613990462929, 4.123105625617661
110, 163, 92, 260, 94, 261, -2, -1, -2.677945044588987, 2.23606797749979
110, 164, 176, 146, 180, 149, -4, -3, -2.498091544796509, 5.0
110, 166, 278, 238, 283, 241, -5, -3, -2.601173153319209, 5.830951894845301
110, 168, 74, 275, 79, 276, -5, -1, -2.9441970937399127, 5.0990195135927845
110, 169, 95, 135, 98, 137, -3, -2, -2.5535900500422257, 3.605551275463989
110, 170, 97, 211, 102, 214, -5, -3, -2.601173153319209, 5.830951894845301
110, 171, 246, 233, 250, 235, -4, -2, -2.677945044588987, 4.47213595499958
110, 172, 103, 142, 107, 144, -4, -2, -2.677945044588987, 4.47213595499958
110, 175, 576, 197, 575, 201, 1, -4, -1.3258176636680326, 4.123105625617661
110, 176, 273, 144, 276, 146, -3, -2, -2.5535900500422257, 3.605551275463989
110, 178, 163, 231, 167, 233, -4, -2, -2.677945044588987, 4.47213595499958
111, 2, 231, 191, 235, 194, -4, -3, -2.498091544796509, 5.0
111, 3, 223, 295, 229, 296, -6, -1, -2.976443976175166, 6.082762530298219
111, 4, 317, 163, 321, 167, -4, -4, -2.356194490192345, 5.656854249492381
111, 6, 60, 147, 60, 149, 0, -2, -1.5707963267948966, 2.0
111, 7, 70, 146, 74, 149, -4, -3, -2.498091544796509, 5.0
111, 8, 175, 122, 177, 123, -2, -1, -2.677945044588987, 2.23606797749979
111, 9, 105, 194, 109, 196, -4, -2, -2.677945044588987, 4.47213595499958
111, 10, 123, 333, 129, 334, -6, -1, -2.976443976175166, 6.082762530298219
111, 13, 349, 124, 351, 124, -2, 0, 3.141592653589793, 2.0
111, 14, 480, 117, 482, 117, -2, 0, 3.141592653589793, 2.0
111, 16, 414, 163, 418, 168, -4, -5, -2.2455372690184494, 6.4031242374328485
111, 19, 324, 116, 328, 118, -4, -2, -2.677945044588987, 4.47213595499958
111, 20, 49, 249, 51, 250, -2, -1, -2.677945044588987, 2.23606797749979
111, 24, 135, 125, 137, 126, -2, -1, -2.677945044588987, 2.23606797749979
111, 25, 402, 118, 403, 117, -1, 1, 2.356194490192345, 1.4142135623730951
111, 26, 301, 310, 305, 311, -4, -1, -2.896613990462929, 4.123105625617661
111, 28, 327, 366, 331, 366, -4, 0, 3.141592653589793, 4.0
111, 29, 401, 141, 404, 146, -3, -5, -2.1112158270654806, 5.830951894845301
111, 31, 166, 120, 168, 121, -2, -1, -2.677945044588987, 2.23606797749979
111, 34, 595, 167, 595, 169, 0, -2, -1.5707963267948966, 2.0
111, 35, 193, 285, 200, 286, -7, -1, -2.999695598985629, 7.0710678118654755
111, 36, 148, 109, 150, 110, -2, -1, -2.677945044588987, 2.23606797749979
111, 37, 363, 257, 368, 260, -5, -3, -2.601173153319209, 5.830951894845301
111, 38, 598, 130, 599, 133, -1, -3, -1.892546881191539, 3.1622776601683795
111, 39, 491, 116, 493, 116, -2, 0, 3.141592653589793, 2.0
111, 41, 56, 133, 58, 132, -2, 1, 2.677945044588987, 2.23606797749979
111, 42, 269, 168, 274, 173, -5, -5, -2.356194490192345, 7.0710678118654755
111, 46, 591, 216, 590, 219, 1, -3, -1.2490457723982544, 3.1622776601683795
111, 47, 594, 186, 595, 189, -1, -3, -1.892546881191539, 3.1622776601683795
111, 52, 205, 130, 207, 130, -2, 0, 3.141592653589793, 2.0
111, 53, 244, 197, 248, 199, -4, -2, -2.677945044588987, 4.47213595499958
111, 54, 453, 366, 455, 367, -2, -1, -2.677945044588987, 2.23606797749979
111, 55, 307, 252, 312, 254, -5, -2, -2.761086276477428, 5.385164807134504
111, 56, 261, 196, 266, 199, -5, -3, -2.601173153319209, 5.830951894845301
111, 59, 574, 359, 572, 359, 2, 0, 0.0, 2.0
111, 60, 229, 120, 231, 121, -2, -1, -2.677945044588987, 2.23606797749979
111, 61, 370, 366, 374, 367, -4, -1, -2.896613990462929, 4.123105625617661
111, 62, 129, 366, 133, 366, -4, 0, 3.141592653589793, 4.0
111, 63, 593, 253, 593, 255, 0, -2, -1.5707963267948966, 2.0
111, 64, 85, 115, 87, 116, -2, -1, -2.677945044588987, 2.23606797749979
111, 68, 94, 111, 96, 111, -2, 0, 3.141592653589793, 2.0
111, 70, 482, 154, 484, 158, -2, -4, -2.0344439357957027, 4.47213595499958
111, 71, 62, 194, 68, 196, -6, -2, -2.819842099193151, 6.324555320336759
111, 75, 510, 196, 509, 202, 1, -6, -1.4056476493802699, 6.082762530298219
111, 76, 92, 231, 98, 232, -6, -1, -2.976443976175166, 6.082762530298219
111, 77, 57, 296, 61, 297, -4, -1, -2.896613990462929, 4.123105625617661
111, 78, 107, 249, 111, 251, -4, -2, -2.677945044588987, 4.47213595499958
111, 83, 343, 178, 348, 184, -5, -6, -2.2655346029916, 7.810249675906654
111, 84, 80, 126, 83, 126, -3, 0, 3.141592653589793, 3.0
111, 86, 573, 229, 569, 234, 4, -5, -0.8960553845713439, 6.4031242374328485
111, 87, 506, 128, 506, 130, 0, -2, -1.5707963267948966, 2.0
111, 91, 61, 345, 63, 345, -2, 0, 3.141592653589793, 2.0
111, 93, 159, 289, 162, 290, -3, -1, -2.819842099193151, 3.1622776601683795
111, 94, 183, 259, 189, 261, -6, -2, -2.819842099193151, 6.324555320336759
111, 95, 292, 136, 294, 137, -2, -1, -2.677945044588987, 2.23606797749979
111, 96, 602, 186, 603, 188, -1, -2, -2.0344439357957027, 2.23606797749979
111, 97, 526, 140, 525, 143, 1, -3, -1.2490457723982544, 3.1622776601683795
111, 100, 123, 351, 129, 352, -6, -1, -2.976443976175166, 6.082762530298219
111, 101, 115, 311, 120, 312, -5, -1, -2.9441970937399127, 5.0990195135927845
111, 102, 110, 330, 117, 330, -7, 0, 3.141592653589793, 7.0
111, 105, 65, 164, 67, 166, -2, -2, -2.356194490192345, 2.8284271247461903
111, 106, 283, 130, 286, 132, -3, -2, -2.5535900500422257, 3.605551275463989
111, 107, 148, 185, 154, 188, -6, -3, -2.677945044588987, 6.708203932499369
111, 109, 603, 256, 602, 258, 1, -2, -1.1071487177940904, 2.23606797749979
111, 110, 115, 109, 118, 109, -3, 0, 3.141592653589793, 3.0
111, 111, 200, 116, 202, 116, -2, 0, 3.141592653589793, 2.0
111, 112, 597, 219, 597, 221, 0, -2, -1.5707963267948966, 2.0
111, 113, 564, 232, 561, 235, 3, -3, -0.7853981633974483, 4.242640687119285
111, 114, 604, 143, 605, 145, -1, -2, -2.0344439357957027, 2.23606797749979
111, 115, 118, 154, 123, 156, -5, -2, -2.761086276477428, 5.385164807134504
111, 116, 149, 318, 152, 318, -3, 0, 3.141592653589793, 3.0
111, 118, 234, 271, 239, 273, -5, -2, -2.761086276477428, 5.385164807134504
111, 119, 160, 151, 165, 153, -5, -2, -2.761086276477428, 5.385164807134504
111, 121, 76, 352, 81, 353, -5, -1, -2.9441970937399127, 5.0990195135927845
111, 122, 420, 148, 423, 153, -3, -5, -2.1112158270654806, 5.830951894845301
111, 123, 305, 188, 309, 191, -4, -3, -2.498091544796509, 5.0
111, 124, 565, 356, 563, 356, 2, 0, 0.0, 2.0
111, 125, 464, 126, 465, 129, -1, -3, -1.892546881191539, 3.1622776601683795
111, 127, 576, 158, 574, 162, 2, -4, -1.1071487177940904, 4.47213595499958
111, 129, 169, 198, 174, 201, -5, -3, -2.601173153319209, 5.830951894845301
111, 130, 108, 144, 113, 146, -5, -2, -2.761086276477428, 5.385164807134504
111, 131, 512, 124, 512, 126, 0, -2, -1.5707963267948966, 2.0
111, 132, 253, 343, 257, 343, -4, 0, 3.141592653589793, 4.0
111, 133, 317, 337, 323, 336, -6, 1, 2.976443976175166, 6.082762530298219
111, 134, 233, 296, 239, 296, -6, 0, 3.141592653589793, 6.0
111, 135, 204, 257, 210, 260, -6, -3, -2.677945044588987, 6.708203932499369
111, 136, 82, 179, 86, 181, -4, -2, -2.677945044588987, 4.47213595499958
111, 137, 324, 240, 329, 243, -5, -3, -2.601173153319209, 5.830951894845301
111, 138, 331, 166, 335, 171, -4, -5, -2.2455372690184494, 6.4031242374328485
111, 139, 32, 257, 33, 256, -1, 1, 2.356194490192345, 1.4142135623730951
111, 141, 131, 304, 137, 305, -6, -1, -2.976443976175166, 6.082762530298219
111, 142, 289, 314, 291, 314, -2, 0, 3.141592653589793, 2.0
111, 143, 235, 362, 238, 361, -3, 1, 2.819842099193151, 3.1622776601683795
111, 144, 141, 254, 146, 255, -5, -1, -2.9441970937399127, 5.0990195135927845
111, 145, 106, 364, 109, 365, -3, -1, -2.819842099193151, 3.1622776601683795
111, 146, 209, 208, 214, 211, -5, -3, -2.601173153319209, 5.830951894845301
111, 147, 431, 195, 433, 199, -2, -4, -2.0344439357957027, 4.47213595499958
111, 149, 336, 358, 339, 358, -3, 0, 3.141592653589793, 3.0
111, 150, 273, 367, 277, 367, -4, 0, 3.141592653589793, 4.0
111, 151, 90, 259, 92, 260, -2, -1, -2.677945044588987, 2.23606797749979
111, 152, 172, 144, 176, 146, -4, -2, -2.677945044588987, 4.47213595499958
111, 154, 274, 235, 278, 238, -4, -3, -2.498091544796509, 5.0
111, 156, 69, 273, 74, 275, -5, -2, -2.761086276477428, 5.385164807134504
111, 157, 92, 132, 95, 135, -3, -3, -2.356194490192345, 4.242640687119285
111, 158, 93, 209, 97, 211, -4, -2, -2.677945044588987, 4.47213595499958
111, 159, 241, 231, 246, 233, -5, -2, -2.761086276477428, 5.385164807134504
111, 160, 98, 140, 103, 142, -5, -2, -2.761086276477428, 5.385164807134504
111, 163, 577, 194, 576, 197, 1, -3, -1.2490457723982544, 3.1622776601683795
111, 164, 271, 143, 273, 144, -2, -1, -2.677945044588987, 2.23606797749979
111, 166, 159, 229, 163, 231, -4, -2, -2.677945044588987, 4.47213595499958
112, 1, 228, 188, 231, 191, -3, -3, -2.356194490192345, 4.242640687119285
112, 2, 218, 294, 223, 295, -5, -1, -2.9441970937399127, 5.0990195135927845
112, 3, 314, 159, 317, 163, -3, -4, -2.214297435588181, 5.0
112, 4, 60, 145, 60, 147, 0, -2, -1.5707963267948966, 2.0
112, 5, 69, 144, 70, 146, -1, -2, -2.0344439357957027, 2.23606797749979
112, 6, 173, 120, 175, 122, -2, -2, -2.356194490192345, 2.8284271247461903
112, 7, 100, 192, 105, 194, -5, -2, -2.761086276477428, 5.385164807134504
112, 8, 118, 332, 123, 333, -5, -1, -2.9441970937399127, 5.0990195135927845
112, 10, 347, 122, 349, 124, -2, -2, -2.356194490192345, 2.8284271247461903
112, 13, 412, 159, 414, 163, -2, -4, -2.0344439357957027, 4.47213595499958
112, 19, 131, 125, 135, 125, -4, 0, 3.141592653589793, 4.0
112, 21, 298, 308, 301, 310, -3, -2, -2.5535900500422257, 3.605551275463989
112, 22, 322, 365, 327, 366, -5, -1, -2.9441970937399127, 5.0990195135927845
112, 23, 399, 136, 401, 141, -2, -5, -1.9513027039072615, 5.385164807134504
112, 25, 164, 119, 166, 120, -2, -1, -2.677945044588987, 2.23606797749979
112, 28, 595, 164, 595, 167, 0, -3, -1.5707963267948966, 3.0
112, 29, 190, 285, 193, 285, -3, 0, 3.141592653589793, 3.0
112, 30, 146, 108, 148, 109, -2, -1, -2.677945044588987, 2.23606797749979
112, 31, 360, 253, 363, 257, -3, -4, -2.214297435588181, 5.0
112, 35, 54, 133, 56, 133, -2, 0, 3.141592653589793, 2.0
112, 36, 266, 166, 269, 168, -3, -2, -2.5535900500422257, 3.605551275463989
112, 38, 333, 107, 336, 108, -3, -1, -2.819842099193151, 3.1622776601683795
112, 39, 591, 213, 591, 216, 0, -3, -1.5707963267948966, 3.0
112, 40, 542, 133, 541, 134, 1, -1, -0.7853981633974483, 1.4142135623730951
112, 43, 604, 222, 604, 225, 0, -3, -1.5707963267948966, 3.0
112, 44, 202, 130, 205, 130, -3, 0, 3.141592653589793, 3.0
112, 45, 240, 196, 244, 197, -4, -1, -2.896613990462929, 4.123105625617661
112, 47, 305, 250, 307, 252, -2, -2, -2.356194490192345, 2.8284271247461903
112, 48, 259, 195, 261, 196, -2, -1, -2.677945044588987, 2.23606797749979
112, 51, 576, 358, 574, 359, 2, -1, -0.4636476090008061, 2.23606797749979
112, 52, 227, 119, 229, 120, -2, -1, -2.677945044588987, 2.23606797749979
112, 53, 367, 365, 370, 366, -3, -1, -2.819842099193151, 3.1622776601683795
112, 54, 126, 366, 129, 366, -3, 0, 3.141592653589793, 3.0
112, 55, 83, 115, 85, 115, -2, 0, 3.141592653589793, 2.0
112, 56, 54, 198, 57, 201, -3, -3, -2.356194490192345, 4.242640687119285
112, 57, 33, 177, 35, 178, -2, -1, -2.677945044588987, 2.23606797749979
112, 58, 92, 110, 94, 111, -2, -1, -2.677945044588987, 2.23606797749979
112, 60, 481, 149, 482, 154, -1, -5, -1.7681918866447774, 5.0990195135927845
112, 61, 58, 192, 62, 194, -4, -2, -2.677945044588987, 4.47213595499958
112, 64, 46, 194, 46, 196, 0, -2, -1.5707963267948966, 2.0
112, 65, 512, 190, 510, 196, 2, -6, -1.2490457723982544, 6.324555320336759
112, 66, 87, 229, 92, 231, -5, -2, -2.761086276477428, 5.385164807134504
112, 67, 54, 296, 57, 296, -3, 0, 3.141592653589793, 3.0
112, 68, 102, 248, 107, 249, -5, -1, -2.9441970937399127, 5.0990195135927845
112, 69, 192, 109, 195, 109, -3, 0, 3.141592653589793, 3.0
112, 73, 339, 174, 343, 178, -4, -4, -2.356194490192345, 5.656854249492381
112, 74, 77, 125, 80, 126, -3, -1, -2.819842099193151, 3.1622776601683795
112, 77, 506, 126, 506, 128, 0, -2, -1.5707963267948966, 2.0
112, 79, 536, 122, 535, 123, 1, -1, -0.7853981633974483, 1.4142135623730951
112, 80, 59, 346, 61, 345, -2, 1, 2.677945044588987, 2.23606797749979
112, 82, 155, 289, 159, 289, -4, 0, 3.141592653589793, 4.0
112, 83, 178, 258, 183, 259, -5, -1, -2.9441970937399127, 5.0990195135927845
112, 84, 290, 135, 292, 136, -2, -1, -2.677945044588987, 2.23606797749979
112, 85, 527, 135, 526, 140, 1, -5, -1.373400766945016, 5.0990195135927845
112, 88, 118, 350, 123, 351, -5, -1, -2.9441970937399127, 5.0990195135927845
112, 89, 109, 311, 115, 311, -6, 0, 3.141592653589793, 6.0
112, 90, 106, 329, 110, 330, -4, -1, -2.896613990462929, 4.123105625617661
112, 92, 586, 166, 586, 168, 0, -2, -1.5707963267948966, 2.0
112, 93, 63, 162, 65, 164, -2, -2, -2.356194490192345, 2.8284271247461903
112, 94, 280, 128, 283, 130, -3, -2, -2.5535900500422257, 3.605551275463989
112, 95, 145, 183, 148, 185, -3, -2, -2.5535900500422257, 3.605551275463989
112, 96, 605, 236, 605, 239, 0, -3, -1.5707963267948966, 3.0
112, 99, 198, 116, 200, 116, -2, 0, 3.141592653589793, 2.0
112, 100, 597, 217, 597, 219, 0, -2, -1.5707963267948966, 2.0
112, 101, 567, 228, 564, 232, 3, -4, -0.9272952180016122, 5.0
112, 103, 113, 151, 118, 154, -5, -3, -2.601173153319209, 5.830951894845301
112, 104, 144, 318, 149, 318, -5, 0, 3.141592653589793, 5.0
112, 106, 227, 269, 234, 271, -7, -2, -2.8632929945846817, 7.280109889280518
112, 107, 156, 148, 160, 151, -4, -3, -2.498091544796509, 5.0
112, 109, 73, 351, 76, 352, -3, -1, -2.819842099193151, 3.1622776601683795
112, 110, 418, 145, 420, 148, -2, -3, -2.158798930342464, 3.605551275463989
112, 111, 302, 186, 305, 188, -3, -2, -2.5535900500422257, 3.605551275463989
112, 112, 567, 355, 565, 356, 2, -1, -0.4636476090008061, 2.23606797749979
112, 113, 463, 124, 464, 126, -1, -2, -2.0344439357957027, 2.23606797749979
112, 115, 577, 154, 576, 158, 1, -4, -1.3258176636680326, 4.123105625617661
112, 117, 166, 196, 169, 198, -3, -2, -2.5535900500422257, 3.605551275463989
112, 118, 103, 142, 108, 144, -5, -2, -2.761086276477428, 5.385164807134504
112, 119, 511, 122, 512, 124, -1, -2, -2.0344439357957027, 2.23606797749979
112, 120, 249, 342, 253, 343, -4, -1, -2.896613990462929, 4.123105625617661
112, 121, 314, 337, 317, 337, -3, 0, 3.141592653589793, 3.0
112, 122, 226, 295, 233, 296, -7, -1, -2.999695598985629, 7.0710678118654755
112, 123, 202, 254, 204, 257, -2, -3, -2.158798930342464, 3.605551275463989
112, 124, 77, 178, 82, 179, -5, -1, -2.9441970937399127, 5.0990195135927845
112, 125, 319, 237, 324, 240, -5, -3, -2.601173153319209, 5.830951894845301
112, 126, 328, 163, 331, 166, -3, -3, -2.356194490192345, 4.242640687119285
112, 127, 32, 255, 32, 257, 0, -2, -1.5707963267948966, 2.0
112, 129, 125, 303, 131, 304, -6, -1, -2.976443976175166, 6.082762530298219
112, 130, 287, 314, 289, 314, -2, 0, 3.141592653589793, 2.0
112, 131, 231, 362, 235, 362, -4, 0, 3.141592653589793, 4.0
112, 132, 135, 253, 141, 254, -6, -1, -2.976443976175166, 6.082762530298219
112, 133, 103, 363, 106, 364, -3, -1, -2.819842099193151, 3.1622776601683795
112, 134, 203, 205, 209, 208, -6, -3, -2.677945044588987, 6.708203932499369
112, 135, 429, 191, 431, 195, -2, -4, -2.0344439357957027, 4.47213595499958
112, 137, 333, 358, 336, 358, -3, 0, 3.141592653589793, 3.0
112, 138, 269, 367, 273, 367, -4, 0, 3.141592653589793, 4.0
112, 139, 86, 258, 90, 259, -4, -1, -2.896613990462929, 4.123105625617661
112, 140, 168, 142, 172, 144, -4, -2, -2.677945044588987, 4.47213595499958
112, 142, 271, 233, 274, 235, -3, -2, -2.5535900500422257, 3.605551275463989
112, 144, 65, 271, 69, 273, -4, -2, -2.677945044588987, 4.47213595499958
112, 145, 87, 130, 92, 132, -5, -2, -2.761086276477428, 5.385164807134504
112, 146, 88, 207, 93, 209, -5, -2, -2.761086276477428, 5.385164807134504
112, 147, 237, 228, 241, 231, -4, -3, -2.498091544796509, 5.0
112, 148, 94, 138, 98, 140, -4, -2, -2.677945044588987, 4.47213595499958
112, 149, 599, 266, 598, 267, 1, -1, -0.7853981633974483, 1.4142135623730951
112, 151, 578, 191, 577, 194, 1, -3, -1.2490457723982544, 3.1622776601683795
112, 152, 268, 142, 271, 143, -3, -1, -2.819842099193151, 3.1622776601683795
112, 153, 154, 227, 159, 229, -5, -2, -2.761086276477428, 5.385164807134504
113, 1, 225, 185, 228, 188, -3, -3, -2.356194490192345, 4.242640687119285
113, 2, 212, 293, 218, 294, -6, -1, -2.976443976175166, 6.082762530298219
113, 3, 312, 155, 314, 159, -2, -4, -2.0344439357957027, 4.47213595499958
113, 5, 95, 190, 100, 192, -5, -2, -2.761086276477428, 5.385164807134504
113, 6, 114, 331, 118, 332, -4, -1, -2.896613990462929, 4.123105625617661
113, 9, 408, 157, 412, 159, -4, -2, -2.677945044588987, 4.47213595499958
113, 15, 129, 125, 131, 125, -2, 0, 3.141592653589793, 2.0
113, 17, 293, 306, 298, 308, -5, -2, -2.761086276477428, 5.385164807134504
113, 18, 317, 365, 322, 365, -5, 0, 3.141592653589793, 5.0
113, 21, 162, 118, 164, 119, -2, -1, -2.677945044588987, 2.23606797749979
113, 24, 595, 162, 595, 164, 0, -2, -1.5707963267948966, 2.0
113, 25, 186, 284, 190, 285, -4, -1, -2.896613990462929, 4.123105625617661
113, 26, 144, 107, 146, 108, -2, -1, -2.677945044588987, 2.23606797749979
113, 27, 355, 249, 360, 253, -5, -4, -2.4668517113662407, 6.4031242374328485
113, 31, 52, 132, 54, 133, -2, -1, -2.677945044588987, 2.23606797749979
113, 32, 261, 164, 266, 166, -5, -2, -2.761086276477428, 5.385164807134504
113, 35, 592, 211, 591, 213, 1, -2, -1.1071487177940904, 2.23606797749979
113, 40, 235, 192, 240, 196, -5, -4, -2.4668517113662407, 6.4031242374328485
113, 41, 450, 366, 452, 366, -2, 0, 3.141592653589793, 2.0
113, 42, 302, 247, 305, 250, -3, -3, -2.356194490192345, 4.242640687119285
113, 43, 255, 194, 259, 195, -4, -1, -2.896613990462929, 4.123105625617661
113, 45, 578, 357, 576, 358, 2, -1, -0.4636476090008061, 2.23606797749979
113, 46, 225, 118, 227, 119, -2, -1, -2.677945044588987, 2.23606797749979
113, 47, 364, 364, 367, 365, -3, -1, -2.819842099193151, 3.1622776601683795
113, 48, 124, 365, 126, 366, -2, -1, -2.677945044588987, 2.23606797749979
113, 50, 90, 109, 92, 110, -2, -1, -2.677945044588987, 2.23606797749979
113, 52, 478, 146, 481, 149, -3, -3, -2.356194490192345, 4.242640687119285
113, 53, 56, 191, 58, 192, -2, -1, -2.677945044588987, 2.23606797749979
113, 55, 512, 185, 512, 190, 0, -5, -1.5707963267948966, 5.0
113, 56, 83, 227, 87, 229, -4, -2, -2.677945044588987, 4.47213595499958
113, 57, 52, 296, 54, 296, -2, 0, 3.141592653589793, 2.0
113, 58, 97, 246, 102, 248, -5, -2, -2.761086276477428, 5.385164807134504
113, 62, 336, 171, 339, 174, -3, -3, -2.356194490192345, 4.242640687119285
113, 63, 74, 124, 77, 125, -3, -1, -2.819842099193151, 3.1622776601683795
113, 65, 575, 226, 572, 229, 3, -3, -0.7853981633974483, 4.242640687119285
113, 66, 506, 124, 506, 126, 0, -2, -1.5707963267948966, 2.0
113, 70, 149, 288, 155, 289, -6, -1, -2.976443976175166, 6.082762530298219
113, 71, 176, 257, 178, 258, -2, -1, -2.677945044588987, 2.23606797749979
113, 72, 287, 133, 290, 135, -3, -2, -2.5535900500422257, 3.605551275463989
113, 73, 527, 130, 527, 135, 0, -5, -1.5707963267948966, 5.0
113, 75, 115, 349, 118, 350, -3, -1, -2.819842099193151, 3.1622776601683795
113, 76, 104, 309, 109, 311, -5, -2, -2.761086276477428, 5.385164807134504
113, 77, 103, 328, 106, 329, -3, -1, -2.819842099193151, 3.1622776601683795
113, 79, 584, 166, 586, 166, -2, 0, 3.141592653589793, 2.0
113, 80, 62, 160, 63, 162, -1, -2, -2.0344439357957027, 2.23606797749979
113, 81, 278, 127, 280, 128, -2, -1, -2.677945044588987, 2.23606797749979
113, 82, 143, 181, 145, 183, -2, -2, -2.356194490192345, 2.8284271247461903
113, 87, 597, 215, 597, 217, 0, -2, -1.5707963267948966, 2.0
113, 88, 570, 224, 567, 228, 3, -4, -0.9272952180016122, 5.0
113, 90, 111, 149, 113, 151, -2, -2, -2.356194490192345, 2.8284271247461903
113, 91, 137, 318, 144, 318, -7, 0, 3.141592653589793, 7.0
113, 92, 223, 267, 227, 269, -4, -2, -2.677945044588987, 4.47213595499958
113, 93, 153, 147, 156, 148, -3, -1, -2.819842099193151, 3.1622776601683795
113, 95, 71, 350, 73, 351, -2, -1, -2.677945044588987, 2.23606797749979
113, 96, 415, 144, 418, 145, -3, -1, -2.819842099193151, 3.1622776601683795
113, 97, 299, 185, 302, 186, -3, -1, -2.819842099193151, 3.1622776601683795
113, 98, 569, 355, 567, 355, 2, 0, 0.0, 2.0
113, 99, 462, 122, 463, 124, -1, -2, -2.0344439357957027, 2.23606797749979
113, 100, 578, 151, 577, 154, 1, -3, -1.2490457723982544, 3.1622776601683795
113, 102, 163, 194, 166, 196, -3, -2, -2.5535900500422257, 3.605551275463989
113, 103, 98, 139, 103, 142, -5, -3, -2.601173153319209, 5.830951894845301
113, 105, 245, 341, 249, 342, -4, -1, -2.896613990462929, 4.123105625617661
113, 106, 308, 337, 314, 337, -6, 0, 3.141592653589793, 6.0
113, 107, 219, 294, 226, 295, -7, -1, -2.999695598985629, 7.0710678118654755
113, 108, 73, 176, 77, 178, -4, -2, -2.677945044588987, 4.47213595499958
113, 109, 315, 235, 319, 237, -4, -2, -2.677945044588987, 4.47213595499958
113, 110, 325, 161, 328, 163, -3, -2, -2.5535900500422257, 3.605551275463989
113, 113, 125, 301, 125, 303, 0, -2, -1.5707963267948966, 2.0
113, 114, 281, 313, 287, 314, -6, -1, -2.976443976175166, 6.082762530298219
113, 115, 228, 362, 231, 362, -3, 0, 3.141592653589793, 3.0
113, 116, 132, 252, 135, 253, -3, -1, -2.819842099193151, 3.1622776601683795
113, 117, 99, 362, 103, 363, -4, -1, -2.896613990462929, 4.123105625617661
113, 118, 202, 203, 203, 205, -1, -2, -2.0344439357957027, 2.23606797749979
113, 119, 428, 187, 429, 191, -1, -4, -1.8157749899217608, 4.123105625617661
113, 121, 330, 357, 333, 358, -3, -1, -2.819842099193151, 3.1622776601683795
113, 122, 266, 367, 269, 367, -3, 0, 3.141592653589793, 3.0
113, 123, 84, 258, 86, 258, -2, 0, 3.141592653589793, 2.0
113, 124, 166, 140, 168, 142, -2, -2, -2.356194490192345, 2.8284271247461903
113, 126, 268, 231, 271, 233, -3, -2, -2.5535900500422257, 3.605551275463989
113, 129, 84, 129, 87, 130, -3, -1, -2.819842099193151, 3.1622776601683795
113, 130, 85, 205, 88, 207, -3, -2, -2.5535900500422257, 3.605551275463989
113, 131, 234, 226, 237, 228, -3, -2, -2.5535900500422257, 3.605551275463989
113, 132, 89, 136, 94, 138, -5, -2, -2.761086276477428, 5.385164807134504
113, 135, 578, 188, 578, 191, 0, -3, -1.5707963267948966, 3.0
113, 136, 265, 142, 268, 142, -3, 0, 3.141592653589793, 3.0
113, 137, 150, 226, 154, 227, -4, -1, -2.896613990462929, 4.123105625617661
114, 1, 221, 182, 225, 185, -4, -3, -2.498091544796509, 5.0
114, 3, 309, 152, 312, 155, -3, -3, -2.356194490192345, 4.242640687119285
114, 5, 92, 188, 95, 190, -3, -2, -2.5535900500422257, 3.605551275463989
114, 6, 110, 330, 114, 331, -4, -1, -2.896613990462929, 4.123105625617661
114, 9, 406, 156, 408, 157, -2, -1, -2.677945044588987, 2.23606797749979
114, 10, 518, 365, 517, 366, 1, -1, -0.7853981633974483, 1.4142135623730951
114, 14, 127, 125, 129, 125, -2, 0, 3.141592653589793, 2.0
114, 16, 291, 303, 293, 306, -2, -3, -2.158798930342464, 3.605551275463989
114, 17, 313, 365, 317, 365, -4, 0, 3.141592653589793, 4.0
114, 18, 398, 135, 400, 136, -2, -1, -2.677945044588987, 2.23606797749979
114, 20, 160, 117, 162, 118, -2, -1, -2.677945044588987, 2.23606797749979
114, 23, 595, 160, 595, 162, 0, -2, -1.5707963267948966, 2.0
114, 24, 180, 284, 186, 284, -6, 0, 3.141592653589793, 6.0
114, 25, 142, 107, 144, 107, -2, 0, 3.141592653589793, 2.0
114, 26, 352, 247, 355, 249, -3, -2, -2.5535900500422257, 3.605551275463989
114, 30, 260, 158, 261, 164, -1, -6, -1.7359450042095235, 6.082762530298219
114, 32, 593, 208, 592, 211, 1, -3, -1.2490457723982544, 3.1622776601683795
114, 33, 543, 131, 542, 132, 1, -1, -0.7853981633974483, 1.4142135623730951
114, 34, 566, 366, 565, 367, 1, -1, -0.7853981633974483, 1.4142135623730951
114, 37, 229, 188, 235, 192, -6, -4, -2.5535900500422257, 7.211102550927978
114, 38, 448, 366, 450, 366, -2, 0, 3.141592653589793, 2.0
114, 39, 299, 244, 302, 247, -3, -3, -2.356194490192345, 4.242640687119285
114, 40, 253, 192, 255, 194, -2, -2, -2.356194490192345, 2.8284271247461903
114, 42, 580, 356, 578, 357, 2, -1, -0.4636476090008061, 2.23606797749979
114, 43, 223, 117, 225, 118, -2, -1, -2.677945044588987, 2.23606797749979
114, 44, 362, 364, 364, 364, -2, 0, 3.141592653589793, 2.0
114, 45, 121, 365, 124, 365, -3, 0, 3.141592653589793, 3.0
114, 46, 88, 108, 90, 109, -2, -1, -2.677945044588987, 2.23606797749979
114, 48, 478, 143, 478, 146, 0, -3, -1.5707963267948966, 3.0
114, 49, 54, 191, 56, 191, -2, 0, 3.141592653589793, 2.0
114, 50, 512, 182, 512, 185, 0, -3, -1.5707963267948966, 3.0
114, 51, 79, 225, 83, 227, -4, -2, -2.677945044588987, 4.47213595499958
114, 52, 50, 295, 52, 296, -2, -1, -2.677945044588987, 2.23606797749979
114, 53, 93, 245, 97, 246, -4, -1, -2.896613990462929, 4.123105625617661
114, 56, 333, 168, 336, 171, -3, -3, -2.356194490192345, 4.242640687119285
114, 57, 70, 124, 74, 124, -4, 0, 3.141592653589793, 4.0
114, 59, 577, 222, 575, 226, 2, -4, -1.1071487177940904, 4.47213595499958
114, 64, 146, 288, 149, 288, -3, 0, 3.141592653589793, 3.0
114, 65, 174, 256, 176, 257, -2, -1, -2.677945044588987, 2.23606797749979
114, 66, 284, 132, 287, 133, -3, -1, -2.819842099193151, 3.1622776601683795
114, 69, 112, 348, 115, 349, -3, -1, -2.819842099193151, 3.1622776601683795
114, 70, 101, 306, 104, 309, -3, -3, -2.356194490192345, 4.242640687119285
114, 71, 101, 327, 103, 328, -2, -1, -2.677945044588987, 2.23606797749979
114, 73, 60, 158, 62, 160, -2, -2, -2.356194490192345, 2.8284271247461903
114, 75, 141, 178, 143, 181, -2, -3, -2.158798930342464, 3.605551275463989
114, 76, 111, 109, 113, 109, -2, 0, 3.141592653589793, 2.0
114, 78, 597, 213, 597, 215, 0, -2, -1.5707963267948966, 2.0
114, 79, 574, 221, 570, 224, 4, -3, -0.6435011087932844, 5.0
114, 81, 109, 148, 111, 149, -2, -1, -2.677945044588987, 2.23606797749979
114, 82, 131, 318, 137, 318, -6, 0, 3.141592653589793, 6.0
114, 83, 220, 267, 223, 267, -3, 0, 3.141592653589793, 3.0
114, 84, 149, 147, 153, 147, -4, 0, 3.141592653589793, 4.0
114, 86, 69, 350, 71, 350, -2, 0, 3.141592653589793, 2.0
114, 88, 297, 182, 299, 185, -2, -3, -2.158798930342464, 3.605551275463989
114, 90, 578, 148, 578, 151, 0, -3, -1.5707963267948966, 3.0
114, 92, 94, 137, 98, 139, -4, -2, -2.677945044588987, 4.47213595499958
114, 93, 512, 120, 511, 121, 1, -1, -0.7853981633974483, 1.4142135623730951
114, 94, 243, 339, 245, 341, -2, -2, -2.356194490192345, 2.8284271247461903
114, 95, 305, 337, 308, 337, -3, 0, 3.141592653589793, 3.0
114, 96, 213, 292, 219, 294, -6, -2, -2.819842099193151, 6.324555320336759
114, 97, 69, 174, 73, 176, -4, -2, -2.677945044588987, 4.47213595499958
114, 98, 312, 232, 315, 235, -3, -3, -2.356194490192345, 4.242640687119285
114, 99, 320, 158, 325, 161, -5, -3, -2.601173153319209, 5.830951894845301
114, 102, 123, 299, 125, 301, -2, -2, -2.356194490192345, 2.8284271247461903
114, 103, 279, 313, 281, 313, -2, 0, 3.141592653589793, 2.0
114, 104, 225, 362, 228, 362, -3, 0, 3.141592653589793, 3.0
114, 105, 129, 251, 132, 252, -3, -1, -2.819842099193151, 3.1622776601683795
114, 106, 95, 362, 99, 362, -4, 0, 3.141592653589793, 4.0
114, 107, 201, 198, 202, 203, -1, -5, -1.7681918866447774, 5.0990195135927845
114, 108, 427, 180, 428, 187, -1, -7, -1.7126933813990606, 7.0710678118654755
114, 110, 325, 357, 330, 357, -5, 0, 3.141592653589793, 5.0
114, 111, 264, 367, 266, 367, -2, 0, 3.141592653589793, 2.0
114, 112, 82, 257, 84, 258, -2, -1, -2.677945044588987, 2.23606797749979
114, 113, 163, 138, 166, 140, -3, -2, -2.5535900500422257, 3.605551275463989
114, 114, 58, 278, 60, 278, -2, 0, 3.141592653589793, 2.0
114, 115, 263, 228, 268, 231, -5, -3, -2.601173153319209, 5.830951894845301
114, 118, 80, 128, 84, 129, -4, -1, -2.896613990462929, 4.123105625617661
114, 119, 82, 203, 85, 205, -3, -2, -2.5535900500422257, 3.605551275463989
114, 120, 86, 135, 89, 136, -3, -1, -2.819842099193151, 3.1622776601683795
114, 121, 600, 264, 599, 265, 1, -1, -0.7853981633974483, 1.4142135623730951
114, 122, 262, 142, 265, 142, -3, 0, 3.141592653589793, 3.0
114, 123, 145, 224, 150, 226, -5, -2, -2.761086276477428, 5.385164807134504
115, 3, 68, 142, 69, 144, -1, -2, -2.0344439357957027, 2.23606797749979
115, 4, 176, 117, 178, 119, -2, -2, -2.356194490192345, 2.8284271247461903
115, 8, 224, 185, 230, 189, -6, -4, -2.5535900500422257, 7.211102550927978
115, 12, 306, 113, 308, 114, -2, -1, -2.677945044588987, 2.23606797749979
115, 13, 113, 334, 119, 335, -6, -1, -2.976443976175166, 6.082762530298219
115, 14, 310, 158, 315, 163, -5, -5, -2.356194490192345, 7.0710678118654755
115, 17, 58, 192, 61, 194, -3, -2, -2.5535900500422257, 3.605551275463989
115, 18, 48, 107, 49, 109, -1, -2, -2.0344439357957027, 2.23606797749979
115, 19, 366, 367, 369, 367, -3, 0, 3.141592653589793, 3.0
115, 24, 595, 164, 595, 166, 0, -2, -1.5707963267948966, 2.0
115, 26, 291, 309, 296, 310, -5, -1, -2.9441970937399127, 5.0990195135927845
115, 28, 214, 295, 220, 296, -6, -1, -2.976443976175166, 6.082762530298219
115, 30, 378, 270, 378, 272, 0, -2, -1.5707963267948966, 2.0
115, 33, 301, 248, 305, 250, -4, -2, -2.677945044588987, 4.47213595499958
115, 36, 397, 138, 400, 142, -3, -4, -2.214297435588181, 5.0
115, 37, 224, 117, 226, 118, -2, -1, -2.677945044588987, 2.23606797749979
115, 38, 412, 157, 414, 161, -2, -4, -2.0344439357957027, 4.47213595499958
115, 39, 352, 131, 356, 135, -4, -4, -2.356194490192345, 5.656854249492381
115, 40, 320, 364, 325, 365, -5, -1, -2.9441970937399127, 5.0990195135927845
115, 41, 100, 188, 105, 190, -5, -2, -2.761086276477428, 5.385164807134504
115, 42, 463, 123, 464, 125, -1, -2, -2.0344439357957027, 2.23606797749979
115, 46, 133, 123, 135, 124, -2, -1, -2.677945044588987, 2.23606797749979
115, 48, 264, 163, 269, 168, -5, -5, -2.356194490192345, 7.0710678118654755
115, 49, 187, 282, 194, 284, -7, -2, -2.8632929945846817, 7.280109889280518
115, 50, 358, 254, 360, 256, -2, -2, -2.356194490192345, 2.8284271247461903
115, 53, 163, 120, 165, 121, -2, -1, -2.677945044588987, 2.23606797749979
115, 54, 577, 154, 578, 157, -1, -3, -1.892546881191539, 3.1622776601683795
115, 55, 357, 368, 359, 368, -2, 0, 3.141592653589793, 2.0
115, 56, 175, 256, 180, 258, -5, -2, -2.761086276477428, 5.385164807134504
115, 60, 525, 132, 525, 136, 0, -4, -1.5707963267948966, 4.0
115, 63, 598, 216, 598, 218, 0, -2, -1.5707963267948966, 2.0
115, 65, 254, 192, 260, 197, -6, -5, -2.44685437739309, 7.810249675906654
115, 66, 129, 367, 131, 367, -2, 0, 3.141592653589793, 2.0
115, 67, 110, 149, 115, 152, -5, -3, -2.601173153319209, 5.830951894845301
115, 68, 592, 212, 592, 214, 0, -2, -1.5707963267948966, 2.0
115, 69, 578, 225, 575, 230, 3, -5, -1.0303768265243125, 5.830951894845301
115, 70, 589, 313, 588, 314, 1, -1, -0.7853981633974483, 1.4142135623730951
115, 72, 147, 110, 149, 110, -2, 0, 3.141592653589793, 2.0
115, 74, 77, 125, 80, 126, -3, -1, -2.819842099193151, 3.1622776601683795
115, 76, 80, 114, 84, 116, -4, -2, -2.677945044588987, 4.47213595499958
115, 81, 193, 119, 195, 119, -2, 0, 3.141592653589793, 2.0
115, 82, 373, 134, 377, 138, -4, -4, -2.356194490192345, 5.656854249492381
115, 85, 141, 180, 147, 183, -6, -3, -2.677945044588987, 6.708203932499369
115, 86, 242, 342, 247, 343, -5, -1, -2.9441970937399127, 5.0990195135927845
115, 92, 548, 133, 547, 134, 1, -1, -0.7853981633974483, 1.4142135623730951
115, 93, 385, 178, 389, 182, -4, -4, -2.356194490192345, 5.656854249492381
115, 94, 56, 304, 59, 305, -3, -1, -2.819842099193151, 3.1622776601683795
115, 97, 280, 130, 283, 132, -3, -2, -2.5535900500422257, 3.605551275463989
115, 98, 117, 352, 121, 352, -4, 0, 3.141592653589793, 4.0
115, 101, 268, 367, 272, 368, -4, -1, -2.896613990462929, 4.123105625617661
115, 105, 305, 338, 314, 337, -9, 1, 3.0309354324158977, 9.055385138137417
115, 106, 36, 178, 34, 180, 2, -2, -0.7853981633974483, 2.8284271247461903
115, 107, 62, 176, 67, 178, -5, -2, -2.761086276477428, 5.385164807134504
115, 109, 60, 278, 62, 278, -2, 0, 3.141592653589793, 2.0
115, 110, 76, 257, 80, 258, -4, -1, -2.896613990462929, 4.123105625617661
115, 112, 484, 142, 485, 149, -1, -7, -1.7126933813990606, 7.0710678118654755
115, 115, 84, 228, 89, 230, -5, -2, -2.761086276477428, 5.385164807134504
115, 116, 517, 186, 515, 190, 2, -4, -1.1071487177940904, 4.47213595499958
115, 117, 60, 200, 62, 201, -2, -1, -2.677945044588987, 2.23606797749979
115, 118, 149, 225, 153, 227, -4, -2, -2.677945044588987, 4.47213595499958
115, 119, 161, 195, 167, 198, -6, -3, -2.677945044588987, 6.708203932499369
115, 120, 579, 191, 579, 194, 0, -3, -1.5707963267948966, 3.0
115, 121, 233, 134, 235, 134, -2, 0, 3.141592653589793, 2.0
115, 122, 567, 226, 564, 230, 3, -4, -0.9272952180016122, 5.0
115, 123, 588, 152, 588, 154, 0, -2, -1.5707963267948966, 2.0
115, 124, 57, 179, 56, 180, 1, -1, -0.7853981633974483, 1.4142135623730951
115, 127, 330, 360, 334, 360, -4, 0, 3.141592653589793, 4.0
115, 128, 341, 130, 345, 132, -4, -2, -2.677945044588987, 4.47213595499958
115, 129, 315, 186, 320, 190, -5, -4, -2.4668517113662407, 6.4031242374328485
115, 130, 266, 146, 269, 146, -3, 0, 3.141592653589793, 3.0
115, 133, 120, 333, 126, 333, -6, 0, 3.141592653589793, 6.0
115, 135, 342, 202, 346, 205, -4, -3, -2.498091544796509, 5.0
115, 136, 588, 167, 588, 169, 0, -2, -1.5707963267948966, 2.0
116, 3, 175, 115, 176, 117, -1, -2, -2.0344439357957027, 2.23606797749979
116, 7, 220, 182, 224, 185, -4, -3, -2.498091544796509, 5.0
116, 10, 304, 113, 306, 113, -2, 0, 3.141592653589793, 2.0
116, 11, 107, 334, 113, 334, -6, 0, 3.141592653589793, 6.0
116, 12, 305, 153, 310, 158, -5, -5, -2.356194490192345, 7.0710678118654755
116, 15, 55, 190, 58, 192, -3, -2, -2.5535900500422257, 3.605551275463989
116, 17, 363, 367, 366, 367, -3, 0, 3.141592653589793, 3.0
116, 20, 450, 367, 452, 368, -2, -1, -2.677945044588987, 2.23606797749979
116, 21, 595, 162, 595, 164, 0, -2, -1.5707963267948966, 2.0
116, 23, 287, 307, 291, 309, -4, -2, -2.677945044588987, 4.47213595499958
116, 25, 208, 294, 214, 295, -6, -1, -2.976443976175166, 6.082762530298219
116, 26, 376, 271, 378, 270, -2, 1, 2.677945044588987, 2.23606797749979
116, 29, 297, 246, 301, 248, -4, -2, -2.677945044588987, 4.47213595499958
116, 30, 568, 366, 567, 367, 1, -1, -0.7853981633974483, 1.4142135623730951
116, 32, 395, 135, 397, 138, -2, -3, -2.158798930342464, 3.605551275463989
116, 33, 222, 116, 224, 117, -2, -1, -2.677945044588987, 2.23606797749979
116, 34, 410, 152, 412, 157, -2, -5, -1.9513027039072615, 5.385164807134504
116, 35, 349, 130, 352, 131, -3, -1, -2.819842099193151, 3.1622776601683795
116, 36, 315, 363, 320, 364, -5, -1, -2.9441970937399127, 5.0990195135927845
116, 37, 95, 185, 100, 188, -5, -3, -2.601173153319209, 5.830951894845301
116, 41, 131, 123, 133, 123, -2, 0, 3.141592653589793, 2.0
116, 43, 260, 159, 264, 163, -4, -4, -2.356194490192345, 5.656854249492381
116, 44, 180, 280, 187, 282, -7, -2, -2.8632929945846817, 7.280109889280518
116, 45, 356, 252, 358, 254, -2, -2, -2.356194490192345, 2.8284271247461903
116, 48, 161, 119, 163, 120, -2, -1, -2.677945044588987, 2.23606797749979
116, 49, 576, 152, 577, 154, -1, -2, -2.0344439357957027, 2.23606797749979
116, 50, 354, 368, 357, 368, -3, 0, 3.141592653589793, 3.0
116, 51, 170, 255, 175, 256, -5, -1, -2.9441970937399127, 5.0990195135927845
116, 54, 525, 129, 525, 132, 0, -3, -1.5707963267948966, 3.0
116, 56, 598, 214, 598, 216, 0, -2, -1.5707963267948966, 2.0
116, 58, 249, 188, 254, 192, -5, -4, -2.4668517113662407, 6.4031242374328485
116, 59, 126, 366, 129, 367, -3, -1, -2.819842099193151, 3.1622776601683795
116, 60, 105, 146, 110, 149, -5, -3, -2.601173153319209, 5.830951894845301
116, 62, 582, 221, 578, 225, 4, -4, -0.7853981633974483, 5.656854249492381
116, 65, 145, 110, 147, 110, -2, 0, 3.141592653589793, 2.0
116, 67, 74, 124, 77, 125, -3, -1, -2.819842099193151, 3.1622776601683795
116, 69, 78, 113, 80, 114, -2, -1, -2.677945044588987, 2.23606797749979
116, 72, 191, 118, 193, 119, -2, -1, -2.677945044588987, 2.23606797749979
116, 73, 371, 131, 373, 134, -2, -3, -2.158798930342464, 3.605551275463989
116, 74, 203, 134, 204, 133, -1, 1, 2.356194490192345, 1.4142135623730951
116, 76, 134, 177, 141, 180, -7, -3, -2.7367008673047097, 7.615773105863909
116, 77, 238, 340, 242, 342, -4, -2, -2.677945044588987, 4.47213595499958
116, 82, 381, 174, 385, 178, -4, -4, -2.356194490192345, 5.656854249492381
116, 83, 54, 303, 56, 304, -2, -1, -2.677945044588987, 2.23606797749979
116, 85, 278, 129, 280, 130, -2, -1, -2.677945044588987, 2.23606797749979
116, 86, 113, 351, 117, 352, -4, -1, -2.896613990462929, 4.123105625617661
116, 88, 505, 192, 506, 194, -1, -2, -2.0344439357957027, 2.23606797749979
116, 89, 264, 366, 268, 367, -4, -1, -2.896613990462929, 4.123105625617661
116, 91, 571, 357, 569, 356, 2, 1, 0.4636476090008061, 2.23606797749979
116, 92, 297, 339, 305, 338, -8, 1, 3.017237659043032, 8.06225774829855
116, 94, 59, 175, 62, 176, -3, -1, -2.819842099193151, 3.1622776601683795
116, 96, 58, 277, 60, 278, -2, -1, -2.677945044588987, 2.23606797749979
116, 97, 74, 256, 76, 257, -2, -1, -2.677945044588987, 2.23606797749979
116, 99, 484, 136, 484, 142, 0, -6, -1.5707963267948966, 6.0
116, 102, 79, 227, 84, 228, -5, -1, -2.9441970937399127, 5.0990195135927845
116, 103, 519, 183, 517, 186, 2, -3, -0.982793723247329, 3.605551275463989
116, 104, 59, 198, 60, 200, -1, -2, -2.0344439357957027, 2.23606797749979
116, 105, 144, 223, 149, 225, -5, -2, -2.761086276477428, 5.385164807134504
116, 106, 156, 192, 161, 195, -5, -3, -2.601173153319209, 5.830951894845301
116, 107, 579, 188, 579, 191, 0, -3, -1.5707963267948966, 3.0
116, 108, 231, 134, 233, 134, -2, 0, 3.141592653589793, 2.0
116, 109, 570, 221, 567, 226, 3, -5, -1.0303768265243125, 5.830951894845301
116, 110, 588, 150, 588, 152, 0, -2, -1.5707963267948966, 2.0
116, 112, 326, 360, 330, 360, -4, 0, 3.141592653589793, 4.0
116, 113, 338, 128, 341, 130, -3, -2, -2.5535900500422257, 3.605551275463989
116, 114, 312, 182, 315, 186, -3, -4, -2.214297435588181, 5.0
116, 115, 264, 146, 266, 146, -2, 0, 3.141592653589793, 2.0
116, 117, 97, 119, 99, 119, -2, 0, 3.141592653589793, 2.0
116, 118, 116, 333, 120, 333, -4, 0, 3.141592653589793, 4.0
116, 120, 340, 200, 342, 202, -2, -2, -2.356194490192345, 2.8284271247461903
116, 121, 588, 165, 588, 167, 0, -2, -1.5707963267948966, 2.0
117, 1, 50, 249, 51, 251, -1, -2, -2.0344439357957027, 2.23606797749979
117, 2, 173, 115, 175, 115, -2, 0, 3.141592653589793, 2.0
117, 5, 215, 178, 220, 182, -5, -4, -2.4668517113662407, 6.4031242374328485
117, 9, 102, 333, 107, 334, -5, -1, -2.9441970937399127, 5.0990195135927845
117, 10, 301, 149, 305, 153, -4, -4, -2.356194490192345, 5.656854249492381
117, 12, 53, 189, 55, 190, -2, -1, -2.677945044588987, 2.23606797749979
117, 14, 360, 367, 363, 367, -3, 0, 3.141592653589793, 3.0
117, 19, 284, 306, 287, 307, -3, -1, -2.819842099193151, 3.1622776601683795
117, 21, 202, 292, 208, 294, -6, -2, -2.819842099193151, 6.324555320336759
117, 22, 373, 271, 376, 271, -3, 0, 3.141592653589793, 3.0
117, 25, 295, 245, 297, 246, -2, -1, -2.677945044588987, 2.23606797749979
117, 28, 220, 115, 222, 116, -2, -1, -2.677945044588987, 2.23606797749979
117, 29, 407, 148, 410, 152, -3, -4, -2.214297435588181, 5.0
117, 30, 347, 129, 349, 130, -2, -1, -2.677945044588987, 2.23606797749979
117, 31, 310, 361, 315, 363, -5, -2, -2.761086276477428, 5.385164807134504
117, 32, 90, 182, 95, 185, -5, -3, -2.601173153319209, 5.830951894845301
117, 36, 129, 124, 131, 123, -2, 1, 2.677945044588987, 2.23606797749979
117, 38, 258, 156, 260, 159, -2, -3, -2.158798930342464, 3.605551275463989
117, 39, 176, 278, 180, 280, -4, -2, -2.677945044588987, 4.47213595499958
117, 40, 352, 249, 356, 252, -4, -3, -2.498091544796509, 5.0
117, 42, 158, 118, 161, 119, -3, -1, -2.819842099193151, 3.1622776601683795
117, 43, 575, 150, 576, 152, -1, -2, -2.0344439357957027, 2.23606797749979
117, 44, 351, 368, 354, 368, -3, 0, 3.141592653589793, 3.0
117, 45, 165, 254, 170, 255, -5, -1, -2.9441970937399127, 5.0990195135927845
117, 48, 524, 126, 525, 129, -1, -3, -1.892546881191539, 3.1622776601683795
117, 52, 247, 187, 249, 188, -2, -1, -2.677945044588987, 2.23606797749979
117, 53, 124, 365, 126, 366, -2, -1, -2.677945044588987, 2.23606797749979
117, 54, 99, 145, 105, 146, -6, -1, -2.976443976175166, 6.082762530298219
117, 56, 582, 219, 582, 221, 0, -2, -1.5707963267948966, 2.0
117, 57, 143, 108, 145, 110, -2, -2, -2.356194490192345, 2.8284271247461903
117, 59, 71, 123, 74, 124, -3, -1, -2.819842099193151, 3.1622776601683795
117, 62, 189, 118, 191, 118, -2, 0, 3.141592653589793, 2.0
117, 63, 369, 128, 371, 131, -2, -3, -2.158798930342464, 3.605551275463989
117, 64, 201, 134, 203, 134, -2, 0, 3.141592653589793, 2.0
117, 65, 274, 117, 276, 117, -2, 0, 3.141592653589793, 2.0
117, 66, 132, 176, 134, 177, -2, -1, -2.677945044588987, 2.23606797749979
117, 67, 239, 333, 238, 340, 1, -7, -1.4288992721907328, 7.0710678118654755
117, 70, 379, 171, 381, 174, -2, -3, -2.158798930342464, 3.605551275463989
117, 72, 275, 127, 278, 129, -3, -2, -2.5535900500422257, 3.605551275463989
117, 73, 109, 350, 113, 351, -4, -1, -2.896613990462929, 4.123105625617661
117, 74, 505, 190, 505, 192, 0, -2, -1.5707963267948966, 2.0
117, 75, 260, 366, 264, 366, -4, 0, 3.141592653589793, 4.0
117, 78, 292, 337, 297, 339, -5, -2, -2.761086276477428, 5.385164807134504
117, 79, 56, 276, 58, 277, -2, -1, -2.677945044588987, 2.23606797749979
117, 80, 71, 255, 74, 256, -3, -1, -2.819842099193151, 3.1622776601683795
117, 81, 485, 131, 484, 136, 1, -5, -1.373400766945016, 5.0990195135927845
117, 83, 75, 225, 79, 227, -4, -2, -2.677945044588987, 4.47213595499958
117, 84, 520, 182, 519, 183, 1, -1, -0.7853981633974483, 1.4142135623730951
117, 85, 57, 197, 59, 198, -2, -1, -2.677945044588987, 2.23606797749979
117, 86, 139, 222, 144, 223, -5, -1, -2.9441970937399127, 5.0990195135927845
117, 87, 152, 191, 156, 192, -4, -1, -2.896613990462929, 4.123105625617661
117, 88, 579, 186, 579, 188, 0, -2, -1.5707963267948966, 2.0
117, 89, 229, 134, 231, 134, -2, 0, 3.141592653589793, 2.0
117, 90, 573, 217, 570, 221, 3, -4, -0.9272952180016122, 5.0
117, 91, 587, 148, 588, 150, -1, -2, -2.0344439357957027, 2.23606797749979
117, 92, 322, 359, 326, 360, -4, -1, -2.896613990462929, 4.123105625617661
117, 93, 336, 127, 338, 128, -2, -1, -2.677945044588987, 2.23606797749979
117, 94, 309, 179, 312, 182, -3, -3, -2.356194490192345, 4.242640687119285
117, 95, 261, 146, 264, 146, -3, 0, 3.141592653589793, 3.0
117, 97, 95, 119, 97, 119, -2, 0, 3.141592653589793, 2.0
117, 98, 110, 333, 116, 333, -6, 0, 3.141592653589793, 6.0
117, 100, 337, 198, 340, 200, -3, -2, -2.5535900500422257, 3.605551275463989
117, 101, 588, 162, 588, 165, 0, -3, -1.5707963267948966, 3.0
118, 0, 562, 119, 565, 119, -3, 0, 3.141592653589793, 3.0
118, 2, 171, 115, 173, 115, -2, 0, 3.141592653589793, 2.0
118, 4, 211, 176, 215, 178, -4, -2, -2.677945044588987, 4.47213595499958
118, 5, 519, 365, 518, 366, 1, -1, -0.7853981633974483, 1.4142135623730951
118, 8, 98, 331, 102, 333, -4, -2, -2.677945044588987, 4.47213595499958
118, 9, 299, 146, 301, 149, -2, -3, -2.158798930342464, 3.605551275463989
118, 13, 357, 366, 360, 367, -3, -1, -2.819842099193151, 3.1622776601683795
118, 15, 595, 159, 595, 161, 0, -2, -1.5707963267948966, 2.0
118, 17, 281, 305, 284, 306, -3, -1, -2.819842099193151, 3.1622776601683795
118, 18, 199, 290, 202, 292, -3, -2, -2.5535900500422257, 3.605551275463989
118, 19, 371, 270, 373, 271, -2, -1, -2.677945044588987, 2.23606797749979
118, 22, 292, 243, 295, 245, -3, -2, -2.5535900500422257, 3.605551275463989
118, 25, 217, 114, 220, 115, -3, -1, -2.819842099193151, 3.1622776601683795
118, 26, 406, 143, 407, 148, -1, -5, -1.7681918866447774, 5.0990195135927845
118, 27, 344, 128, 347, 129, -3, -1, -2.819842099193151, 3.1622776601683795
118, 28, 305, 361, 310, 361, -5, 0, 3.141592653589793, 5.0
118, 29, 87, 179, 90, 182, -3, -3, -2.356194490192345, 4.242640687119285
118, 33, 127, 123, 129, 124, -2, -1, -2.677945044588987, 2.23606797749979
118, 34, 497, 115, 497, 117, 0, -2, -1.5707963267948966, 2.0
118, 35, 255, 153, 258, 156, -3, -3, -2.356194490192345, 4.242640687119285
118, 36, 172, 277, 176, 278, -4, -1, -2.896613990462929, 4.123105625617661
118, 37, 350, 250, 352, 249, -2, 1, 2.677945044588987, 2.23606797749979
118, 38, 156, 116, 158, 118, -2, -2, -2.356194490192345, 2.8284271247461903
118, 39, 575, 148, 575, 150, 0, -2, -1.5707963267948966, 2.0
118, 40, 348, 368, 351, 368, -3, 0, 3.141592653589793, 3.0
118, 41, 161, 253, 165, 254, -4, -1, -2.896613990462929, 4.123105625617661
118, 46, 244, 185, 247, 187, -3, -2, -2.5535900500422257, 3.605551275463989
118, 47, 121, 364, 124, 365, -3, -1, -2.819842099193151, 3.1622776601683795
118, 48, 96, 144, 99, 145, -3, -1, -2.819842099193151, 3.1622776601683795
118, 50, 583, 217, 582, 219, 1, -2, -1.1071487177940904, 2.23606797749979
118, 53, 68, 122, 71, 123, -3, -1, -2.819842099193151, 3.1622776601683795
118, 56, 187, 118, 189, 118, -2, 0, 3.141592653589793, 2.0
118, 57, 368, 129, 369, 128, -1, 1, 2.356194490192345, 1.4142135623730951
118, 58, 199, 134, 201, 134, -2, 0, 3.141592653589793, 2.0
118, 61, 238, 331, 239, 333, -1, -2, -2.0344439357957027, 2.23606797749979
118, 64, 376, 168, 379, 171, -3, -3, -2.356194490192345, 4.242640687119285
118, 65, 273, 126, 275, 127, -2, -1, -2.677945044588987, 2.23606797749979
118, 66, 105, 351, 109, 350, -4, 1, 2.896613990462929, 4.123105625617661
118, 67, 504, 184, 505, 190, -1, -6, -1.7359450042095235, 6.082762530298219
118, 68, 257, 366, 260, 366, -3, 0, 3.141592653589793, 3.0
118, 69, 47, 321, 49, 321, -2, 0, 3.141592653589793, 2.0
118, 71, 287, 335, 292, 337, -5, -2, -2.761086276477428, 5.385164807134504
118, 72, 54, 275, 56, 276, -2, -1, -2.677945044588987, 2.23606797749979
118, 73, 68, 253, 71, 255, -3, -2, -2.5535900500422257, 3.605551275463989
118, 74, 484, 129, 485, 131, -1, -2, -2.0344439357957027, 2.23606797749979
118, 76, 71, 224, 75, 225, -4, -1, -2.896613990462929, 4.123105625617661
118, 78, 136, 223, 139, 222, -3, 1, 2.819842099193151, 3.1622776601683795
118, 79, 148, 190, 152, 191, -4, -1, -2.896613990462929, 4.123105625617661
118, 80, 579, 182, 579, 186, 0, -4, -1.5707963267948966, 4.0
118, 81, 227, 133, 229, 134, -2, -1, -2.677945044588987, 2.23606797749979
118, 83, 318, 359, 322, 359, -4, 0, 3.141592653589793, 4.0
118, 84, 333, 126, 336, 127, -3, -1, -2.819842099193151, 3.1622776601683795
118, 85, 307, 177, 309, 179, -2, -2, -2.356194490192345, 2.8284271247461903
118, 86, 258, 146, 261, 146, -3, 0, 3.141592653589793, 3.0
118, 88, 92, 119, 95, 119, -3, 0, 3.141592653589793, 3.0
118, 89, 104, 333, 110, 333, -6, 0, 3.141592653589793, 6.0
119, 4, 209, 175, 211, 176, -2, -1, -2.677945044588987, 2.23606797749979
119, 7, 94, 331, 98, 331, -4, 0, 3.141592653589793, 4.0
119, 8, 297, 144, 299, 146, -2, -2, -2.356194490192345, 2.8284271247461903
119, 11, 354, 366, 357, 366, -3, 0, 3.141592653589793, 3.0
119, 15, 276, 304, 281, 305, -5, -1, -2.9441970937399127, 5.0990195135927845
119, 16, 195, 289, 199, 290, -4, -1, -2.896613990462929, 4.123105625617661
119, 17, 368, 267, 371, 270, -3, -3, -2.356194490192345, 4.242640687119285
119, 20, 288, 240, 292, 243, -4, -3, -2.498091544796509, 5.0
119, 24, 404, 140, 406, 143, -2, -3, -2.158798930342464, 3.605551275463989
119, 25, 342, 126, 344, 128, -2, -2, -2.356194490192345, 2.8284271247461903
119, 26, 299, 361, 305, 361, -6, 0, 3.141592653589793, 6.0
119, 27, 86, 177, 87, 179, -1, -2, -2.0344439357957027, 2.23606797749979
119, 31, 125, 122, 127, 123, -2, -1, -2.677945044588987, 2.23606797749979
119, 32, 497, 113, 497, 115, 0, -2, -1.5707963267948966, 2.0
119, 33, 252, 150, 255, 153, -3, -3, -2.356194490192345, 4.242640687119285
119, 34, 170, 276, 172, 277, -2, -1, -2.677945044588987, 2.23606797749979
119, 36, 154, 115, 156, 116, -2, -1, -2.677945044588987, 2.23606797749979
119, 37, 346, 367, 348, 368, -2, -1, -2.677945044588987, 2.23606797749979
119, 38, 159, 253, 161, 253, -2, 0, 3.141592653589793, 2.0
119, 42, 241, 184, 244, 185, -3, -1, -2.819842099193151, 3.1622776601683795
119, 43, 119, 364, 121, 364, -2, 0, 3.141592653589793, 2.0
119, 44, 94, 143, 96, 144, -2, -1, -2.677945044588987, 2.23606797749979
119, 46, 584, 214, 583, 217, 1, -3, -1.2490457723982544, 3.1622776601683795
119, 49, 65, 121, 68, 122, -3, -1, -2.819842099193151, 3.1622776601683795
119, 52, 185, 117, 187, 118, -2, -1, -2.677945044588987, 2.23606797749979
119, 53, 366, 128, 368, 129, -2, -1, -2.677945044588987, 2.23606797749979
119, 54, 197, 134, 199, 134, -2, 0, 3.141592653589793, 2.0
119, 56, 125, 173, 131, 176, -6, -3, -2.677945044588987, 6.708203932499369
119, 57, 237, 333, 238, 331, -1, 2, 2.0344439357957027, 2.23606797749979
119, 59, 376, 165, 376, 168, 0, -3, -1.5707963267948966, 3.0
119, 60, 271, 125, 273, 126, -2, -1, -2.677945044588987, 2.23606797749979
119, 61, 100, 349, 105, 351, -5, -2, -2.761086276477428, 5.385164807134504
119, 62, 504, 178, 504, 184, 0, -6, -1.5707963267948966, 6.0
119, 66, 52, 275, 54, 275, -2, 0, 3.141592653589793, 2.0
119, 67, 65, 252, 68, 253, -3, -1, -2.819842099193151, 3.1622776601683795
119, 68, 485, 128, 484, 129, 1, -1, -0.7853981633974483, 1.4142135623730951
119, 69, 69, 223, 71, 224, -2, -1, -2.677945044588987, 2.23606797749979
119, 70, 522, 178, 520, 182, 2, -4, -1.1071487177940904, 4.47213595499958
119, 71, 133, 223, 136, 223, -3, 0, 3.141592653589793, 3.0
119, 72, 145, 189, 148, 190, -3, -1, -2.819842099193151, 3.1622776601683795
119, 73, 578, 178, 579, 182, -1, -4, -1.8157749899217608, 4.123105625617661
119, 74, 224, 132, 227, 133, -3, -1, -2.819842099193151, 3.1622776601683795
119, 76, 316, 358, 318, 359, -2, -1, -2.677945044588987, 2.23606797749979
119, 77, 305, 176, 307, 177, -2, -1, -2.677945044588987, 2.23606797749979
119, 78, 257, 144, 258, 146, -1, -2, -2.0344439357957027, 2.23606797749979
119, 80, 90, 119, 92, 119, -2, 0, 3.141592653589793, 2.0
119, 81, 98, 333, 104, 333, -6, 0, 3.141592653589793, 6.0
120, 1, 213, 177, 219, 180, -6, -3, -2.677945044588987, 6.708203932499369
120, 8, 46, 268, 48, 268, -2, 0, 3.141592653589793, 2.0
120, 10, 603, 336, 602, 337, 1, -1, -0.7853981633974483, 1.4142135623730951
120, 14, 299, 147, 304, 151, -5, -4, -2.4668517113662407, 6.4031242374328485
120, 17, 98, 336, 104, 336, -6, 0, 3.141592653589793, 6.0
120, 18, 86, 182, 91, 184, -5, -2, -2.761086276477428, 5.385164807134504
120, 21, 65, 255, 66, 257, -1, -2, -2.0344439357957027, 2.23606797749979
120, 22, 359, 266, 361, 266, -2, 0, 3.141592653589793, 2.0
120, 24, 406, 145, 407, 148, -1, -3, -1.892546881191539, 3.1622776601683795
120, 28, 235, 108, 237, 109, -2, -1, -2.677945044588987, 2.23606797749979
120, 30, 340, 248, 345, 251, -5, -3, -2.601173153319209, 5.830951894845301
120, 32, 200, 293, 206, 293, -6, 0, 3.141592653589793, 6.0
120, 33, 252, 152, 257, 156, -5, -4, -2.4668517113662407, 6.4031242374328485
120, 34, 521, 366, 520, 367, 1, -1, -0.7853981633974483, 1.4142135623730951
120, 35, 351, 368, 354, 368, -3, 0, 3.141592653589793, 3.0
120, 36, 347, 131, 349, 131, -2, 0, 3.141592653589793, 2.0
120, 39, 447, 366, 449, 368, -2, -2, -2.356194490192345, 2.8284271247461903
120, 43, 274, 307, 281, 308, -7, -1, -2.999695598985629, 7.0710678118654755
120, 48, 241, 184, 247, 189, -6, -5, -2.44685437739309, 7.810249675906654
120, 50, 486, 119, 485, 120, 1, -1, -0.7853981633974483, 1.4142135623730951
120, 51, 159, 117, 161, 119, -2, -2, -2.356194490192345, 2.8284271247461903
120, 52, 362, 367, 364, 367, -2, 0, 3.141592653589793, 2.0
120, 55, 71, 123, 72, 125, -1, -2, -2.0344439357957027, 2.23606797749979
120, 56, 306, 368, 312, 369, -6, -1, -2.976443976175166, 6.082762530298219
120, 57, 124, 365, 126, 366, -2, -1, -2.677945044588987, 2.23606797749979
120, 58, 172, 280, 179, 282, -7, -2, -2.8632929945846817, 7.280109889280518
120, 59, 219, 117, 221, 117, -2, 0, 3.141592653589793, 2.0
120, 60, 580, 183, 580, 187, 0, -4, -1.5707963267948966, 4.0
120, 64, 285, 242, 291, 245, -6, -3, -2.677945044588987, 6.708203932499369
120, 66, 71, 141, 71, 143, 0, -2, -1.5707963267948966, 2.0
120, 67, 368, 133, 370, 134, -2, -1, -2.677945044588987, 2.23606797749979
120, 69, 581, 219, 582, 222, -1, -3, -1.892546881191539, 3.1622776601683795
120, 72, 575, 219, 575, 221, 0, -2, -1.5707963267948966, 2.0
120, 75, 97, 143, 101, 145, -4, -2, -2.677945044588987, 4.47213595499958
120, 76, 524, 128, 525, 130, -1, -2, -2.0344439357957027, 2.23606797749979
120, 78, 126, 173, 133, 176, -7, -3, -2.7367008673047097, 7.615773105863909
120, 81, 158, 253, 165, 256, -7, -3, -2.7367008673047097, 7.615773105863909
120, 82, 150, 189, 156, 192, -6, -3, -2.677945044588987, 6.708203932499369
120, 84, 74, 136, 77, 136, -3, 0, 3.141592653589793, 3.0
120, 85, 276, 130, 278, 131, -2, -1, -2.677945044588987, 2.23606797749979
120, 88, 287, 339, 295, 339, -8, 0, 3.141592653589793, 8.0
120, 89, 523, 168, 520, 173, 3, -5, -1.0303768265243125, 5.830951894845301
120, 90, 103, 350, 108, 351, -5, -1, -2.9441970937399127, 5.0990195135927845
120, 91, 62, 172, 62, 174, 0, -2, -1.5707963267948966, 2.0
120, 96, 403, 150, 406, 155, -3, -5, -2.1112158270654806, 5.830951894845301
120, 99, 85, 206, 89, 208, -4, -2, -2.677945044588987, 4.47213595499958
120, 104, 86, 330, 90, 331, -4, -1, -2.896613990462929, 4.123105625617661
120, 110, 119, 248, 125, 250, -6, -2, -2.819842099193151, 6.324555320336759
120, 111, 73, 224, 78, 227, -5, -3, -2.601173153319209, 5.830951894845301
120, 112, 144, 109, 146, 110, -2, -1, -2.677945044588987, 2.23606797749979
120, 116, 71, 202, 77, 204, -6, -2, -2.819842099193151, 6.324555320336759
120, 119, 95, 364, 99, 365, -4, -1, -2.896613990462929, 4.123105625617661
120, 121, 111, 111, 113, 111, -2, 0, 3.141592653589793, 2.0
120, 123, 446, 130, 447, 133, -1, -3, -1.892546881191539, 3.1622776601683795
120, 124, 512, 169, 511, 172, 1, -3, -1.2490457723982544, 3.1622776601683795
120, 125, 320, 361, 324, 361, -4, 0, 3.141592653589793, 4.0
120, 126, 578, 151, 578, 154, 0, -3, -1.5707963267948966, 3.0
120, 127, 76, 333, 78, 334, -2, -1, -2.677945044588987, 2.23606797749979
120, 130, 439, 144, 440, 149, -1, -5, -1.7681918866447774, 5.0990195135927845
120, 131, 548, 132, 549, 134, -1, -2, -2.0344439357957027, 2.23606797749979
120, 134, 62, 270, 64, 271, -2, -1, -2.677945044588987, 2.23606797749979
120, 136, 220, 218, 224, 221, -4, -3, -2.498091544796509, 5.0
120, 138, 86, 137, 90, 137, -4, 0, 3.141592653589793, 4.0
120, 139, 305, 224, 308, 226, -3, -2, -2.5535900500422257, 3.605551275463989
120, 140, 306, 249, 312, 253, -6, -4, -2.5535900500422257, 7.211102550927978
120, 142, 142, 140, 145, 142, -3, -2, -2.5535900500422257, 3.605551275463989
120, 143, 186, 218, 189, 220, -3, -2, -2.5535900500422257, 3.605551275463989
120, 144, 603, 183, 603, 185, 0, -2, -1.5707963267948966, 2.0
120, 145, 109, 301, 114, 303, -5, -2, -2.761086276477428, 5.385164807134504
120, 147, 582, 252, 584, 254, -2, -2, -2.356194490192345, 2.8284271247461903
120, 148, 42, 168, 44, 169, -2, -1, -2.677945044588987, 2.23606797749979
120, 149, 229, 343, 232, 344, -3, -1, -2.819842099193151, 3.1622776601683795
120, 150, 88, 310, 92, 310, -4, 0, 3.141592653589793, 4.0
120, 152, 327, 163, 330, 166, -3, -3, -2.356194490192345, 4.242640687119285
120, 154, 144, 224, 149, 225, -5, -1, -2.9441970937399127, 5.0990195135927845
120, 155, 229, 184, 231, 187, -2, -3, -2.158798930342464, 3.605551275463989
120, 156, 57, 277, 59, 277, -2, 0, 3.141592653589793, 2.0
120, 157, 78, 355, 80, 354, -2, 1, 2.677945044588987, 2.23606797749979
120, 159, 482, 187, 483, 194, -1, -7, -1.7126933813990606, 7.0710678118654755
120, 161, 273, 144, 275, 145, -2, -1, -2.677945044588987, 2.23606797749979
120, 162, 260, 367, 264, 368, -4, -1, -2.896613990462929, 4.123105625617661
120, 163, 487, 132, 487, 136, 0, -4, -1.5707963267948966, 4.0
120, 164, 95, 120, 97, 120, -2, 0, 3.141592653589793, 2.0
120, 165, 336, 199, 340, 201, -4, -2, -2.677945044588987, 4.47213595499958
120, 167, 208, 267, 213, 269, -5, -2, -2.761086276477428, 5.385164807134504
120, 168, 335, 127, 338, 128, -3, -1, -2.819842099193151, 3.1622776601683795
120, 169, 181, 251, 187, 254, -6, -3, -2.677945044588987, 6.708203932499369
120, 170, 82, 162, 85, 164, -3, -2, -2.5535900500422257, 3.605551275463989
120, 171, 115, 137, 118, 139, -3, -2, -2.5535900500422257, 3.605551275463989
120, 172, 132, 284, 137, 285, -5, -1, -2.9441970937399127, 5.0990195135927845
120, 173, 80, 240, 84, 242, -4, -2, -2.677945044588987, 4.47213595499958
120, 174, 282, 223, 285, 226, -3, -3, -2.356194490192345, 4.242640687119285
120, 175, 123, 318, 126, 318, -3, 0, 3.141592653589793, 3.0
120, 176, 180, 341, 187, 342, -7, -1, -2.999695598985629, 7.0710678118654755
120, 177, 83, 131, 85, 132, -2, -1, -2.677945044588987, 2.23606797749979
120, 178, 304, 153, 307, 158, -3, -5, -2.1112158270654806, 5.830951894845301
121, 1, 207, 173, 213, 177, -6, -4, -2.5535900500422257, 7.211102550927978
121, 2, 429, 115, 431, 114, -2, 1, 2.677945044588987, 2.23606797749979
121, 4, 62, 143, 62, 145, 0, -2, -1.5707963267948966, 2.0
121, 9, 129, 125, 131, 126, -2, -1, -2.677945044588987, 2.23606797749979
121, 13, 295, 144, 299, 147, -4, -3, -2.498091544796509, 5.0
121, 15, 92, 336, 98, 336, -6, 0, 3.141592653589793, 6.0
121, 16, 80, 180, 86, 182, -6, -2, -2.819842099193151, 6.324555320336759
121, 19, 357, 265, 359, 266, -2, -1, -2.677945044588987, 2.23606797749979
121, 21, 403, 140, 406, 145, -3, -5, -2.1112158270654806, 5.830951894845301
121, 24, 337, 247, 340, 248, -3, -1, -2.819842099193151, 3.1622776601683795
121, 25, 51, 309, 53, 309, -2, 0, 3.141592653589793, 2.0
121, 26, 193, 293, 200, 293, -7, 0, 3.141592653589793, 7.0
121, 27, 247, 148, 252, 152, -5, -4, -2.4668517113662407, 6.4031242374328485
121, 28, 522, 365, 521, 366, 1, -1, -0.7853981633974483, 1.4142135623730951
121, 29, 348, 367, 351, 368, -3, -1, -2.819842099193151, 3.1622776601683795
121, 30, 346, 132, 347, 131, -1, 1, 2.356194490192345, 1.4142135623730951
121, 33, 445, 366, 447, 366, -2, 0, 3.141592653589793, 2.0
121, 37, 270, 307, 274, 307, -4, 0, 3.141592653589793, 4.0
121, 42, 236, 180, 241, 184, -5, -4, -2.4668517113662407, 6.4031242374328485
121, 45, 157, 116, 159, 117, -2, -1, -2.677945044588987, 2.23606797749979
121, 46, 359, 367, 362, 367, -3, 0, 3.141592653589793, 3.0
121, 49, 302, 367, 306, 368, -4, -1, -2.896613990462929, 4.123105625617661
121, 50, 121, 364, 124, 365, -3, -1, -2.819842099193151, 3.1622776601683795
121, 51, 164, 278, 172, 280, -8, -2, -2.896613990462929, 8.246211251235321
121, 52, 217, 117, 219, 117, -2, 0, 3.141592653589793, 2.0
121, 53, 580, 180, 580, 183, 0, -3, -1.5707963267948966, 3.0
121, 55, 198, 137, 200, 137, -2, 0, 3.141592653589793, 2.0
121, 56, 281, 240, 285, 242, -4, -2, -2.677945044588987, 4.47213595499958
121, 58, 70, 139, 71, 141, -1, -2, -2.0344439357957027, 2.23606797749979
121, 59, 366, 132, 368, 133, -2, -1, -2.677945044588987, 2.23606797749979
121, 61, 580, 217, 581, 219, -1, -2, -2.0344439357957027, 2.23606797749979
121, 64, 574, 217, 575, 219, -1, -2, -2.0344439357957027, 2.23606797749979
121, 66, 45, 291, 44, 290, 1, 1, 0.7853981633974483, 1.4142135623730951
121, 67, 94, 142, 97, 143, -3, -1, -2.819842099193151, 3.1622776601683795
121, 68, 523, 125, 524, 128, -1, -3, -1.892546881191539, 3.1622776601683795
121, 70, 121, 170, 126, 173, -5, -3, -2.601173153319209, 5.830951894845301
121, 73, 152, 251, 158, 253, -6, -2, -2.819842099193151, 6.324555320336759
121, 74, 146, 186, 150, 189, -4, -3, -2.498091544796509, 5.0
121, 75, 73, 134, 74, 136, -1, -2, -2.0344439357957027, 2.23606797749979
121, 76, 274, 129, 276, 130, -2, -1, -2.677945044588987, 2.23606797749979
121, 78, 279, 339, 287, 339, -8, 0, 3.141592653589793, 8.0
121, 79, 525, 164, 523, 168, 2, -4, -1.1071487177940904, 4.47213595499958
121, 80, 99, 349, 103, 350, -4, -1, -2.896613990462929, 4.123105625617661
121, 81, 63, 170, 62, 172, 1, -2, -1.1071487177940904, 2.23606797749979
121, 84, 400, 145, 403, 150, -3, -5, -2.1112158270654806, 5.830951894845301
121, 87, 81, 204, 85, 206, -4, -2, -2.677945044588987, 4.47213595499958
121, 91, 83, 330, 86, 330, -3, 0, 3.141592653589793, 3.0
121, 94, 116, 247, 119, 248, -3, -1, -2.819842099193151, 3.1622776601683795
121, 95, 69, 222, 73, 224, -4, -2, -2.677945044588987, 4.47213595499958
121, 99, 67, 200, 71, 202, -4, -2, -2.677945044588987, 4.47213595499958
121, 102, 90, 363, 95, 364, -5, -1, -2.9441970937399127, 5.0990195135927845
121, 104, 109, 110, 111, 111, -2, -1, -2.677945044588987, 2.23606797749979
121, 105, 446, 127, 446, 130, 0, -3, -1.5707963267948966, 3.0
121, 106, 513, 166, 512, 169, 1, -3, -1.2490457723982544, 3.1622776601683795
121, 107, 316, 361, 320, 361, -4, 0, 3.141592653589793, 4.0
121, 108, 578, 149, 578, 151, 0, -2, -1.5707963267948966, 2.0
121, 109, 73, 333, 76, 333, -3, 0, 3.141592653589793, 3.0
121, 110, 187, 116, 189, 117, -2, -1, -2.677945044588987, 2.23606797749979
121, 112, 438, 142, 439, 144, -1, -2, -2.0344439357957027, 2.23606797749979
121, 116, 60, 270, 62, 270, -2, 0, 3.141592653589793, 2.0
121, 117, 541, 133, 541, 135, 0, -2, -1.5707963267948966, 2.0
121, 118, 215, 216, 220, 218, -5, -2, -2.761086276477428, 5.385164807134504
121, 120, 303, 222, 305, 224, -2, -2, -2.356194490192345, 2.8284271247461903
121, 121, 301, 245, 306, 249, -5, -4, -2.4668517113662407, 6.4031242374328485
121, 123, 139, 138, 142, 140, -3, -2, -2.5535900500422257, 3.605551275463989
121, 124, 182, 217, 186, 218, -4, -1, -2.896613990462929, 4.123105625617661
121, 126, 102, 299, 109, 301, -7, -2, -2.8632929945846817, 7.280109889280518
121, 129, 227, 341, 229, 343, -2, -2, -2.356194490192345, 2.8284271247461903
121, 130, 82, 309, 88, 310, -6, -1, -2.976443976175166, 6.082762530298219
121, 131, 323, 160, 327, 163, -4, -3, -2.498091544796509, 5.0
121, 133, 141, 223, 144, 224, -3, -1, -2.819842099193151, 3.1622776601683795
121, 134, 225, 182, 229, 184, -4, -2, -2.677945044588987, 4.47213595499958
121, 138, 479, 182, 482, 187, -3, -5, -2.1112158270654806, 5.830951894845301
121, 140, 271, 142, 273, 144, -2, -2, -2.356194490192345, 2.8284271247461903
121, 141, 255, 367, 260, 367, -5, 0, 3.141592653589793, 5.0
121, 142, 487, 128, 487, 132, 0, -4, -1.5707963267948966, 4.0
121, 143, 93, 119, 95, 120, -2, -1, -2.677945044588987, 2.23606797749979
121, 144, 333, 195, 336, 199, -3, -4, -2.214297435588181, 5.0
121, 146, 202, 265, 208, 267, -6, -2, -2.819842099193151, 6.324555320336759
121, 147, 333, 125, 335, 127, -2, -2, -2.356194490192345, 2.8284271247461903
121, 148, 174, 248, 181, 251, -7, -3, -2.7367008673047097, 7.615773105863909
121, 149, 79, 161, 82, 162, -3, -1, -2.819842099193151, 3.1622776601683795
121, 150, 111, 135, 115, 137, -4, -2, -2.677945044588987, 4.47213595499958
121, 151, 128, 282, 132, 284, -4, -2, -2.677945044588987, 4.47213595499958
121, 152, 75, 238, 80, 240, -5, -2, -2.761086276477428, 5.385164807134504
121, 153, 276, 221, 282, 223, -6, -2, -2.819842099193151, 6.324555320336759
121, 154, 120, 318, 123, 318, -3, 0, 3.141592653589793, 3.0
121, 155, 173, 340, 180, 341, -7, -1, -2.999695598985629, 7.0710678118654755
121, 156, 81, 129, 83, 131, -2, -2, -2.356194490192345, 2.8284271247461903
121, 157, 299, 148, 304, 153, -5, -5, -2.356194490192345, 7.0710678118654755
122, 0, 202, 170, 207, 173, -5, -3, -2.601173153319209, 5.830951894845301
122, 2, 50, 250, 52, 252, -2, -2, -2.356194490192345, 2.8284271247461903
122, 6, 564, 119, 563, 120, 1, -1, -0.7853981633974483, 1.4142135623730951
122, 7, 126, 124, 129, 125, -3, -1, -2.819842099193151, 3.1622776601683795
122, 10, 292, 142, 295, 144, -3, -2, -2.5535900500422257, 3.605551275463989
122, 12, 87, 335, 92, 336, -5, -1, -2.9441970937399127, 5.0990195135927845
122, 13, 77, 178, 80, 180, -3, -2, -2.5535900500422257, 3.605551275463989
122, 18, 400, 137, 403, 140, -3, -3, -2.356194490192345, 4.242640687119285
122, 20, 543, 120, 542, 121, 1, -1, -0.7853981633974483, 1.4142135623730951
122, 21, 335, 246, 337, 247, -2, -1, -2.677945044588987, 2.23606797749979
122, 23, 189, 292, 193, 293, -4, -1, -2.896613990462929, 4.123105625617661
122, 24, 244, 145, 247, 148, -3, -3, -2.356194490192345, 4.242640687119285
122, 25, 523, 364, 522, 365, 1, -1, -0.7853981633974483, 1.4142135623730951
122, 26, 344, 367, 348, 367, -4, 0, 3.141592653589793, 4.0
122, 34, 267, 307, 270, 307, -3, 0, 3.141592653589793, 3.0
122, 38, 232, 177, 236, 180, -4, -3, -2.498091544796509, 5.0
122, 41, 155, 115, 157, 116, -2, -1, -2.677945044588987, 2.23606797749979
122, 42, 356, 367, 359, 367, -3, 0, 3.141592653589793, 3.0
122, 45, 299, 367, 302, 367, -3, 0, 3.141592653589793, 3.0
122, 46, 118, 363, 121, 364, -3, -1, -2.819842099193151, 3.1622776601683795
122, 47, 160, 277, 164, 278, -4, -1, -2.896613990462929, 4.123105625617661
122, 48, 579, 177, 580, 180, -1, -3, -1.892546881191539, 3.1622776601683795
122, 50, 196, 136, 198, 137, -2, -1, -2.677945044588987, 2.23606797749979
122, 51, 278, 237, 281, 240, -3, -3, -2.356194490192345, 4.242640687119285
122, 53, 69, 137, 70, 139, -1, -2, -2.0344439357957027, 2.23606797749979
122, 54, 364, 132, 366, 132, -2, 0, 3.141592653589793, 2.0
122, 55, 579, 215, 580, 217, -1, -2, -2.0344439357957027, 2.23606797749979
122, 58, 574, 215, 574, 217, 0, -2, -1.5707963267948966, 2.0
122, 61, 92, 141, 94, 142, -2, -1, -2.677945044588987, 2.23606797749979
122, 63, 119, 167, 121, 170, -2, -3, -2.158798930342464, 3.605551275463989
122, 66, 149, 250, 152, 251, -3, -1, -2.819842099193151, 3.1622776601683795
122, 67, 143, 184, 146, 186, -3, -2, -2.5535900500422257, 3.605551275463989
122, 68, 71, 132, 73, 134, -2, -2, -2.356194490192345, 2.8284271247461903
122, 69, 271, 129, 274, 129, -3, 0, 3.141592653589793, 3.0
122, 70, 274, 339, 279, 339, -5, 0, 3.141592653589793, 5.0
122, 71, 527, 160, 525, 164, 2, -4, -1.1071487177940904, 4.47213595499958
122, 72, 95, 349, 99, 349, -4, 0, 3.141592653589793, 4.0
122, 74, 398, 143, 400, 145, -2, -2, -2.356194490192345, 2.8284271247461903
122, 77, 77, 203, 81, 204, -4, -1, -2.896613990462929, 4.123105625617661
122, 80, 80, 329, 83, 330, -3, -1, -2.819842099193151, 3.1622776601683795
122, 81, 45, 178, 46, 180, -1, -2, -2.0344439357957027, 2.23606797749979
122, 83, 113, 246, 116, 247, -3, -1, -2.819842099193151, 3.1622776601683795
122, 84, 67, 221, 69, 222, -2, -1, -2.677945044588987, 2.23606797749979
122, 85, 141, 108, 143, 109, -2, -1, -2.677945044588987, 2.23606797749979
122, 88, 65, 199, 67, 200, -2, -1, -2.677945044588987, 2.23606797749979
122, 90, 88, 362, 90, 363, -2, -1, -2.677945044588987, 2.23606797749979
122, 93, 513, 162, 513, 166, 0, -4, -1.5707963267948966, 4.0
122, 94, 311, 360, 316, 361, -5, -1, -2.9441970937399127, 5.0990195135927845
122, 95, 578, 147, 578, 149, 0, -2, -1.5707963267948966, 2.0
122, 96, 69, 332, 73, 333, -4, -1, -2.896613990462929, 4.123105625617661
122, 97, 185, 116, 187, 116, -2, 0, 3.141592653589793, 2.0
122, 99, 438, 140, 438, 142, 0, -2, -1.5707963267948966, 2.0
122, 104, 211, 215, 215, 216, -4, -1, -2.896613990462929, 4.123105625617661
122, 106, 300, 219, 303, 222, -3, -3, -2.356194490192345, 4.242640687119285
122, 107, 299, 241, 301, 245, -2, -4, -2.0344439357957027, 4.47213595499958
122, 108, 137, 137, 139, 138, -2, -1, -2.677945044588987, 2.23606797749979
122, 109, 178, 215, 182, 217, -4, -2, -2.677945044588987, 4.47213595499958
122, 111, 100, 294, 102, 299, -2, -5, -1.9513027039072615, 5.385164807134504
122, 113, 223, 340, 227, 341, -4, -1, -2.896613990462929, 4.123105625617661
122, 114, 77, 307, 82, 309, -5, -2, -2.761086276477428, 5.385164807134504
122, 115, 319, 156, 323, 160, -4, -4, -2.356194490192345, 5.656854249492381
122, 117, 138, 223, 141, 223, -3, 0, 3.141592653589793, 3.0
122, 118, 221, 179, 225, 182, -4, -3, -2.498091544796509, 5.0
122, 120, 75, 354, 77, 355, -2, -1, -2.677945044588987, 2.23606797749979
122, 121, 479, 177, 479, 182, 0, -5, -1.5707963267948966, 5.0
122, 123, 269, 141, 271, 142, -2, -1, -2.677945044588987, 2.23606797749979
122, 124, 250, 367, 255, 367, -5, 0, 3.141592653589793, 5.0
122, 125, 486, 126, 487, 128, -1, -2, -2.0344439357957027, 2.23606797749979
122, 127, 329, 190, 333, 195, -4, -5, -2.2455372690184494, 6.4031242374328485
122, 129, 197, 263, 202, 265, -5, -2, -2.761086276477428, 5.385164807134504
122, 130, 331, 124, 333, 125, -2, -1, -2.677945044588987, 2.23606797749979
122, 131, 173, 245, 174, 248, -1, -3, -1.892546881191539, 3.1622776601683795
122, 132, 74, 160, 79, 161, -5, -1, -2.9441970937399127, 5.0990195135927845
122, 133, 108, 134, 111, 135, -3, -1, -2.819842099193151, 3.1622776601683795
122, 134, 126, 282, 128, 282, -2, 0, 3.141592653589793, 2.0
122, 135, 72, 238, 75, 238, -3, 0, 3.141592653589793, 3.0
122, 136, 271, 219, 276, 221, -5, -2, -2.761086276477428, 5.385164807134504
122, 137, 117, 317, 120, 318, -3, -1, -2.819842099193151, 3.1622776601683795
122, 138, 168, 342, 173, 340, -5, 2, 2.761086276477428, 5.385164807134504
122, 139, 79, 128, 81, 129, -2, -1, -2.677945044588987, 2.23606797749979
122, 140, 295, 145, 299, 148, -4, -3, -2.498091544796509, 5.0
123, 0, 199, 170, 202, 170, -3, 0, 3.141592653589793, 3.0
123, 6, 124, 124, 126, 124, -2, 0, 3.141592653589793, 2.0
123, 9, 288, 140, 292, 142, -4, -2, -2.677945044588987, 4.47213595499958
123, 11, 82, 334, 87, 335, -5, -1, -2.9441970937399127, 5.0990195135927845
123, 12, 76, 176, 77, 178, -1, -2, -2.0344439357957027, 2.23606797749979
123, 15, 356, 262, 357, 264, -1, -2, -2.0344439357957027, 2.23606797749979
123, 19, 331, 244, 335, 246, -4, -2, -2.677945044588987, 4.47213595499958
123, 21, 185, 291, 189, 292, -4, -1, -2.896613990462929, 4.123105625617661
123, 22, 240, 144, 244, 145, -4, -1, -2.896613990462929, 4.123105625617661
123, 24, 341, 367, 344, 367, -3, 0, 3.141592653589793, 3.0
123, 28, 442, 366, 444, 366, -2, 0, 3.141592653589793, 2.0
123, 30, 264, 305, 267, 307, -3, -2, -2.5535900500422257, 3.605551275463989
123, 36, 153, 115, 155, 115, -2, 0, 3.141592653589793, 2.0
123, 37, 353, 367, 356, 367, -3, 0, 3.141592653589793, 3.0
123, 40, 295, 366, 299, 367, -4, -1, -2.896613990462929, 4.123105625617661
123, 41, 115, 362, 118, 363, -3, -1, -2.819842099193151, 3.1622776601683795
123, 42, 158, 273, 160, 277, -2, -4, -2.0344439357957027, 4.47213595499958
123, 43, 578, 173, 579, 177, -1, -4, -1.8157749899217608, 4.123105625617661
123, 45, 194, 135, 196, 136, -2, -1, -2.677945044588987, 2.23606797749979
123, 46, 276, 236, 278, 237, -2, -1, -2.677945044588987, 2.23606797749979
123, 48, 362, 132, 364, 132, -2, 0, 3.141592653589793, 2.0
123, 49, 578, 212, 579, 215, -1, -3, -1.892546881191539, 3.1622776601683795
123, 51, 573, 212, 574, 215, -1, -3, -1.892546881191539, 3.1622776601683795
123, 52, 248, 125, 250, 125, -2, 0, 3.141592653589793, 2.0
123, 53, 44, 288, 45, 290, -1, -2, -2.0344439357957027, 2.23606797749979
123, 54, 90, 140, 92, 141, -2, -1, -2.677945044588987, 2.23606797749979
123, 56, 115, 166, 119, 167, -4, -1, -2.896613990462929, 4.123105625617661
123, 58, 147, 249, 149, 250, -2, -1, -2.677945044588987, 2.23606797749979
123, 59, 138, 181, 143, 184, -5, -3, -2.601173153319209, 5.830951894845301
123, 60, 70, 130, 71, 132, -1, -2, -2.0344439357957027, 2.23606797749979
123, 61, 268, 129, 271, 129, -3, 0, 3.141592653589793, 3.0
123, 62, 272, 339, 274, 339, -2, 0, 3.141592653589793, 2.0
123, 63, 529, 160, 527, 160, 2, 0, 0.0, 2.0
123, 64, 91, 349, 95, 349, -4, 0, 3.141592653589793, 4.0
123, 65, 62, 167, 63, 169, -1, -2, -2.0344439357957027, 2.23606797749979
123, 69, 74, 202, 77, 203, -3, -1, -2.819842099193151, 3.1622776601683795
123, 72, 78, 328, 80, 329, -2, -1, -2.677945044588987, 2.23606797749979
123, 74, 108, 245, 113, 246, -5, -1, -2.9441970937399127, 5.0990195135927845
123, 75, 65, 220, 67, 221, -2, -1, -2.677945044588987, 2.23606797749979
123, 77, 575, 278, 574, 279, 1, -1, -0.7853981633974483, 1.4142135623730951
123, 79, 85, 361, 88, 362, -3, -1, -2.819842099193151, 3.1622776601683795
123, 81, 106, 109, 108, 110, -2, -1, -2.677945044588987, 2.23606797749979
123, 82, 514, 158, 513, 162, 1, -4, -1.3258176636680326, 4.123105625617661
123, 83, 307, 360, 311, 360, -4, 0, 3.141592653589793, 4.0
123, 84, 577, 145, 578, 147, -1, -2, -2.0344439357957027, 2.23606797749979
123, 85, 67, 331, 69, 332, -2, -1, -2.677945044588987, 2.23606797749979
123, 86, 182, 117, 185, 116, -3, 1, 2.819842099193151, 3.1622776601683795
123, 89, 289, 127, 291, 128, -2, -1, -2.677945044588987, 2.23606797749979
123, 91, 205, 215, 211, 215, -6, 0, 3.141592653589793, 6.0
123, 93, 297, 217, 300, 219, -3, -2, -2.5535900500422257, 3.605551275463989
123, 94, 296, 240, 299, 241, -3, -1, -2.819842099193151, 3.1622776601683795
123, 95, 134, 137, 137, 137, -3, 0, 3.141592653589793, 3.0
123, 96, 174, 213, 178, 215, -4, -2, -2.677945044588987, 4.47213595499958
123, 99, 220, 339, 223, 340, -3, -1, -2.819842099193151, 3.1622776601683795
123, 100, 72, 305, 77, 307, -5, -2, -2.761086276477428, 5.385164807134504
123, 101, 314, 153, 319, 156, -5, -3, -2.601173153319209, 5.830951894845301
123, 103, 134, 222, 138, 223, -4, -1, -2.896613990462929, 4.123105625617661
123, 104, 216, 176, 221, 179, -5, -3, -2.601173153319209, 5.830951894845301
123, 107, 478, 174, 479, 177, -1, -3, -1.892546881191539, 3.1622776601683795
123, 109, 248, 367, 250, 367, -2, 0, 3.141592653589793, 2.0
123, 110, 90, 119, 92, 119, -2, 0, 3.141592653589793, 2.0
123, 111, 326, 186, 329, 190, -3, -4, -2.214297435588181, 5.0
123, 113, 192, 261, 197, 263, -5, -2, -2.761086276477428, 5.385164807134504
123, 114, 329, 123, 331, 124, -2, -1, -2.677945044588987, 2.23606797749979
123, 118, 122, 280, 126, 282, -4, -2, -2.677945044588987, 4.47213595499958
123, 119, 69, 236, 72, 238, -3, -2, -2.5535900500422257, 3.605551275463989
123, 120, 265, 215, 271, 219, -6, -4, -2.5535900500422257, 7.211102550927978
123, 121, 115, 317, 117, 317, -2, 0, 3.141592653589793, 2.0
123, 122, 165, 342, 168, 342, -3, 0, 3.141592653589793, 3.0
123, 123, 292, 143, 295, 145, -3, -2, -2.5535900500422257, 3.605551275463989
124, 0, 196, 169, 199, 170, -3, -1, -2.819842099193151, 3.1622776601683795
124, 5, 122, 124, 124, 124, -2, 0, 3.141592653589793, 2.0
124, 8, 285, 140, 288, 140, -3, 0, 3.141592653589793, 3.0
124, 10, 79, 335, 82, 334, -3, 1, 2.819842099193151, 3.1622776601683795
124, 11, 74, 175, 76, 176, -2, -1, -2.677945044588987, 2.23606797749979
124, 14, 354, 262, 356, 262, -2, 0, 3.141592653589793, 2.0
124, 18, 327, 243, 331, 244, -4, -1, -2.896613990462929, 4.123105625617661
124, 20, 180, 291, 185, 291, -5, 0, 3.141592653589793, 5.0
124, 21, 237, 142, 240, 144, -3, -2, -2.5535900500422257, 3.605551275463989
124, 23, 337, 366, 341, 367, -4, -1, -2.896613990462929, 4.123105625617661
124, 27, 440, 366, 442, 366, -2, 0, 3.141592653589793, 2.0
124, 29, 262, 306, 264, 305, -2, 1, 2.677945044588987, 2.23606797749979
124, 32, 229, 174, 232, 176, -3, -2, -2.5535900500422257, 3.605551275463989
124, 35, 151, 114, 153, 115, -2, -1, -2.677945044588987, 2.23606797749979
124, 36, 349, 367, 353, 367, -4, 0, 3.141592653589793, 4.0
124, 38, 292, 367, 295, 366, -3, 1, 2.819842099193151, 3.1622776601683795
124, 39, 112, 361, 115, 362, -3, -1, -2.819842099193151, 3.1622776601683795
124, 40, 151, 272, 158, 273, -7, -1, -2.999695598985629, 7.0710678118654755
124, 43, 192, 135, 194, 135, -2, 0, 3.141592653589793, 2.0
124, 44, 274, 234, 276, 236, -2, -2, -2.356194490192345, 2.8284271247461903
124, 46, 360, 133, 362, 132, -2, 1, 2.677945044588987, 2.23606797749979
124, 47, 578, 209, 578, 212, 0, -3, -1.5707963267948966, 3.0
124, 49, 88, 139, 90, 140, -2, -1, -2.677945044588987, 2.23606797749979
124, 51, 114, 164, 115, 166, -1, -2, -2.0344439357957027, 2.23606797749979
124, 53, 144, 248, 147, 249, -3, -1, -2.819842099193151, 3.1622776601683795
124, 54, 134, 179, 138, 181, -4, -2, -2.677945044588987, 4.47213595499958
124, 55, 266, 128, 268, 129, -2, -1, -2.677945044588987, 2.23606797749979
124, 56, 269, 337, 272, 339, -3, -2, -2.5535900500422257, 3.605551275463989
124, 58, 86, 346, 91, 349, -5, -3, -2.601173153319209, 5.830951894845301
124, 59, 61, 165, 62, 167, -1, -2, -2.0344439357957027, 2.23606797749979
124, 62, 72, 200, 74, 202, -2, -2, -2.356194490192345, 2.8284271247461903
124, 63, 583, 277, 582, 278, 1, -1, -0.7853981633974483, 1.4142135623730951
124, 64, 76, 327, 78, 328, -2, -1, -2.677945044588987, 2.23606797749979
124, 66, 103, 242, 108, 245, -5, -3, -2.601173153319209, 5.830951894845301
124, 67, 63, 220, 65, 220, -2, 0, 3.141592653589793, 2.0
124, 68, 138, 107, 140, 108, -2, -1, -2.677945044588987, 2.23606797749979
124, 70, 84, 359, 85, 361, -1, -2, -2.0344439357957027, 2.23606797749979
124, 72, 104, 109, 106, 109, -2, 0, 3.141592653589793, 2.0
124, 73, 515, 153, 514, 158, 1, -5, -1.373400766945016, 5.0990195135927845
124, 74, 305, 361, 307, 360, -2, 1, 2.677945044588987, 2.23606797749979
124, 75, 64, 331, 67, 331, -3, 0, 3.141592653589793, 3.0
124, 76, 180, 116, 182, 117, -2, -1, -2.677945044588987, 2.23606797749979
124, 79, 202, 215, 205, 215, -3, 0, 3.141592653589793, 3.0
124, 81, 294, 215, 297, 217, -3, -2, -2.5535900500422257, 3.605551275463989
124, 82, 294, 238, 296, 240, -2, -2, -2.356194490192345, 2.8284271247461903
124, 83, 132, 137, 134, 137, -2, 0, 3.141592653589793, 2.0
124, 84, 169, 211, 174, 213, -5, -2, -2.761086276477428, 5.385164807134504
124, 87, 218, 338, 220, 339, -2, -1, -2.677945044588987, 2.23606797749979
124, 88, 73, 304, 72, 305, 1, -1, -0.7853981633974483, 1.4142135623730951
124, 89, 311, 150, 314, 153, -3, -3, -2.356194490192345, 4.242640687119285
124, 91, 129, 221, 134, 222, -5, -1, -2.9441970937399127, 5.0990195135927845
124, 92, 212, 173, 216, 176, -4, -3, -2.498091544796509, 5.0
124, 94, 478, 172, 478, 174, 0, -2, -1.5707963267948966, 2.0
124, 96, 245, 366, 248, 367, -3, -1, -2.819842099193151, 3.1622776601683795
124, 98, 323, 183, 326, 186, -3, -3, -2.356194490192345, 4.242640687119285
124, 100, 190, 258, 192, 261, -2, -3, -2.158798930342464, 3.605551275463989
124, 101, 327, 122, 329, 123, -2, -1, -2.677945044588987, 2.23606797749979
124, 102, 169, 241, 173, 244, -4, -3, -2.498091544796509, 5.0
124, 103, 73, 157, 74, 159, -1, -2, -2.0344439357957027, 2.23606797749979
124, 104, 104, 134, 107, 134, -3, 0, 3.141592653589793, 3.0
124, 105, 118, 280, 122, 280, -4, 0, 3.141592653589793, 4.0
124, 106, 65, 235, 69, 236, -4, -1, -2.896613990462929, 4.123105625617661
124, 107, 260, 212, 265, 215, -5, -3, -2.601173153319209, 5.830951894845301
124, 108, 114, 318, 115, 317, -1, 1, 2.356194490192345, 1.4142135623730951
124, 109, 163, 343, 165, 342, -2, 1, 2.677945044588987, 2.23606797749979
124, 110, 289, 142, 292, 143, -3, -1, -2.819842099193151, 3.1622776601683795
125, 3, 525, 366, 524, 367, 1, -1, -0.7853981633974483, 1.4142135623730951
125, 8, 182, 288, 189, 290, -7, -2, -2.8632929945846817, 7.280109889280518
125, 10, 293, 146, 296, 147, -3, -1, -2.819842099193151, 3.1622776601683795
125, 12, 74, 177, 78, 180, -4, -3, -2.498091544796509, 5.0
125, 13, 170, 117, 172, 118, -2, -1, -2.677945044588987, 2.23606797749979
125, 15, 201, 168, 207, 173, -6, -5, -2.44685437739309, 7.810249675906654
125, 16, 401, 138, 401, 140, 0, -2, -1.5707963267948966, 2.0
125, 26, 125, 126, 127, 126, -2, 0, 3.141592653589793, 2.0
125, 27, 82, 334, 87, 335, -5, -1, -2.9441970937399127, 5.0990195135927845
125, 37, 580, 176, 580, 178, 0, -2, -1.5707963267948966, 2.0
125, 39, 73, 138, 74, 140, -1, -2, -2.0344439357957027, 2.23606797749979
125, 41, 229, 177, 235, 181, -6, -4, -2.5535900500422257, 7.211102550927978
125, 43, 327, 240, 332, 243, -5, -3, -2.601173153319209, 5.830951894845301
125, 44, 342, 367, 346, 368, -4, -1, -2.896613990462929, 4.123105625617661
125, 45, 344, 258, 346, 258, -2, 0, 3.141592653589793, 2.0
125, 46, 331, 123, 333, 124, -2, -1, -2.677945044588987, 2.23606797749979
125, 48, 273, 119, 275, 119, -2, 0, 3.141592653589793, 2.0
125, 55, 293, 368, 299, 369, -6, -1, -2.976443976175166, 6.082762530298219
125, 61, 140, 249, 147, 252, -7, -3, -2.7367008673047097, 7.615773105863909
125, 62, 364, 133, 366, 133, -2, 0, 3.141592653589793, 2.0
125, 64, 138, 142, 140, 141, -2, 1, 2.677945044588987, 2.23606797749979
125, 65, 86, 364, 89, 365, -3, -1, -2.819842099193151, 3.1622776601683795
125, 66, 153, 117, 157, 118, -4, -1, -2.896613990462929, 4.123105625617661
125, 67, 318, 119, 320, 119, -2, 0, 3.141592653589793, 2.0
125, 71, 257, 304, 265, 306, -8, -2, -2.896613990462929, 8.246211251235321
125, 72, 442, 368, 445, 369, -3, -1, -2.819842099193151, 3.1622776601683795
125, 74, 94, 143, 96, 143, -2, 0, 3.141592653589793, 2.0
125, 75, 68, 197, 70, 199, -2, -2, -2.356194490192345, 2.8284271247461903
125, 76, 240, 146, 246, 150, -6, -4, -2.5535900500422257, 7.211102550927978
125, 81, 576, 210, 577, 213, -1, -3, -1.892546881191539, 3.1622776601683795
125, 83, 522, 149, 521, 156, 1, -7, -1.4288992721907328, 7.0710678118654755
125, 84, 272, 235, 278, 238, -6, -3, -2.677945044588987, 6.708203932499369
125, 87, 576, 147, 577, 149, -1, -2, -2.0344439357957027, 2.23606797749979
125, 90, 107, 135, 109, 135, -2, 0, 3.141592653589793, 2.0
125, 91, 113, 364, 116, 364, -3, 0, 3.141592653589793, 3.0
125, 92, 119, 282, 123, 283, -4, -1, -2.896613990462929, 4.123105625617661
125, 93, 586, 280, 585, 281, 1, -1, -0.7853981633974483, 1.4142135623730951
125, 96, 332, 190, 335, 195, -3, -5, -2.1112158270654806, 5.830951894845301
125, 99, 375, 161, 377, 166, -2, -5, -1.9513027039072615, 5.385164807134504
125, 101, 356, 366, 359, 367, -3, -1, -2.819842099193151, 3.1622776601683795
125, 102, 176, 274, 179, 275, -3, -1, -2.819842099193151, 3.1622776601683795
125, 103, 68, 234, 71, 236, -3, -2, -2.5535900500422257, 3.605551275463989
125, 107, 155, 280, 163, 281, -8, -1, -3.017237659043032, 8.06225774829855
125, 108, 575, 278, 574, 280, 1, -2, -1.1071487177940904, 2.23606797749979
125, 111, 525, 123, 525, 125, 0, -2, -1.5707963267948966, 2.0
125, 112, 580, 250, 582, 252, -2, -2, -2.356194490192345, 2.8284271247461903
125, 113, 294, 243, 298, 246, -4, -3, -2.498091544796509, 5.0
125, 114, 114, 170, 120, 173, -6, -3, -2.677945044588987, 6.708203932499369
125, 117, 196, 135, 198, 135, -2, 0, 3.141592653589793, 2.0
125, 118, 183, 119, 185, 119, -2, 0, 3.141592653589793, 2.0
125, 121, 507, 132, 508, 131, -1, 1, 2.356194490192345, 1.4142135623730951
125, 123, 209, 311, 214, 313, -5, -2, -2.761086276477428, 5.385164807134504
125, 124, 247, 368, 253, 368, -6, 0, 3.141592653589793, 6.0
125, 126, 140, 106, 142, 106, -2, 0, 3.141592653589793, 2.0
125, 127, 255, 144, 258, 145, -3, -1, -2.819842099193151, 3.1622776601683795
125, 129, 105, 245, 110, 246, -5, -1, -2.9441970937399127, 5.0990195135927845
125, 130, 90, 349, 95, 350, -5, -1, -2.9441970937399127, 5.0990195135927845
125, 131, 173, 189, 179, 193, -6, -4, -2.5535900500422257, 7.211102550927978
125, 133, 106, 318, 109, 318, -3, 0, 3.141592653589793, 3.0
125, 136, 484, 171, 484, 178, 0, -7, -1.5707963267948966, 7.0
125, 139, 166, 248, 172, 250, -6, -2, -2.819842099193151, 6.324555320336759
125, 140, 214, 176, 217, 178, -3, -2, -2.5535900500422257, 3.605551275463989
125, 141, 414, 158, 416, 162, -2, -4, -2.0344439357957027, 4.47213595499958
125, 145, 138, 182, 143, 186, -5, -4, -2.4668517113662407, 6.4031242374328485
125, 147, 215, 341, 217, 343, -2, -2, -2.356194490192345, 2.8284271247461903
125, 149, 190, 262, 196, 264, -6, -2, -2.819842099193151, 6.324555320336759
125, 150, 93, 332, 97, 332, -4, 0, 3.141592653589793, 4.0
125, 151, 106, 342, 109, 343, -3, -1, -2.819842099193151, 3.1622776601683795
125, 152, 63, 169, 64, 171, -1, -2, -2.0344439357957027, 2.23606797749979
126, 2, 526, 365, 525, 366, 1, -1, -0.7853981633974483, 1.4142135623730951
126, 6, 175, 287, 182, 288, -7, -1, -2.999695598985629, 7.0710678118654755
126, 8, 290, 146, 293, 146, -3, 0, 3.141592653589793, 3.0
126, 10, 72, 175, 74, 177, -2, -2, -2.356194490192345, 2.8284271247461903
126, 11, 168, 117, 170, 117, -2, 0, 3.141592653589793, 2.0
126, 13, 195, 165, 201, 168, -6, -3, -2.677945044588987, 6.708203932499369
126, 16, 302, 114, 304, 114, -2, 0, 3.141592653589793, 2.0
126, 17, 519, 117, 520, 119, -1, -2, -2.0344439357957027, 2.23606797749979
126, 21, 123, 126, 125, 126, -2, 0, 3.141592653589793, 2.0
126, 22, 76, 333, 82, 334, -6, -1, -2.976443976175166, 6.082762530298219
126, 25, 464, 123, 466, 124, -2, -1, -2.677945044588987, 2.23606797749979
126, 30, 580, 174, 580, 176, 0, -2, -1.5707963267948966, 2.0
126, 33, 223, 173, 229, 177, -6, -4, -2.5535900500422257, 7.211102550927978
126, 35, 324, 236, 327, 240, -3, -4, -2.214297435588181, 5.0
126, 36, 339, 366, 342, 367, -3, -1, -2.819842099193151, 3.1622776601683795
126, 37, 341, 255, 344, 258, -3, -3, -2.356194490192345, 4.242640687119285
126, 38, 329, 122, 331, 123, -2, -1, -2.677945044588987, 2.23606797749979
126, 44, 215, 120, 217, 121, -2, -1, -2.677945044588987, 2.23606797749979
126, 45, 287, 367, 293, 368, -6, -1, -2.976443976175166, 6.082762530298219
126, 47, 408, 107, 407, 108, 1, -1, -0.7853981633974483, 1.4142135623730951
126, 51, 137, 248, 140, 249, -3, -1, -2.819842099193151, 3.1622776601683795
126, 52, 362, 133, 364, 133, -2, 0, 3.141592653589793, 2.0
126, 53, 107, 111, 109, 111, -2, 0, 3.141592653589793, 2.0
126, 54, 135, 142, 138, 142, -3, 0, 3.141592653589793, 3.0
126, 57, 316, 118, 318, 119, -2, -1, -2.677945044588987, 2.23606797749979
126, 59, 590, 211, 590, 213, 0, -2, -1.5707963267948966, 2.0
126, 61, 252, 304, 257, 304, -5, 0, 3.141592653589793, 5.0
126, 62, 440, 367, 442, 368, -2, -1, -2.677945044588987, 2.23606797749979
126, 65, 235, 141, 240, 146, -5, -5, -2.356194490192345, 7.0710678118654755
126, 69, 575, 208, 576, 210, -1, -2, -2.0344439357957027, 2.23606797749979
126, 71, 523, 144, 522, 149, 1, -5, -1.373400766945016, 5.0990195135927845
126, 72, 267, 232, 272, 235, -5, -3, -2.601173153319209, 5.830951894845301
126, 75, 575, 145, 576, 147, -1, -2, -2.0344439357957027, 2.23606797749979
126, 78, 106, 136, 107, 135, -1, 1, 2.356194490192345, 1.4142135623730951
126, 79, 109, 364, 113, 364, -4, 0, 3.141592653589793, 4.0
126, 80, 113, 281, 119, 282, -6, -1, -2.976443976175166, 6.082762530298219
126, 84, 328, 184, 332, 190, -4, -6, -2.158798930342464, 7.211102550927978
126, 86, 371, 156, 375, 161, -4, -5, -2.2455372690184494, 6.4031242374328485
126, 87, 353, 365, 356, 366, -3, -1, -2.819842099193151, 3.1622776601683795
126, 88, 173, 273, 176, 274, -3, -1, -2.819842099193151, 3.1622776601683795
126, 89, 66, 232, 68, 234, -2, -2, -2.356194490192345, 2.8284271247461903
126, 92, 148, 278, 155, 280, -7, -2, -2.8632929945846817, 7.280109889280518
126, 97, 579, 248, 580, 250, -1, -2, -2.0344439357957027, 2.23606797749979
126, 98, 290, 240, 294, 243, -4, -3, -2.498091544796509, 5.0
126, 99, 107, 167, 114, 170, -7, -3, -2.7367008673047097, 7.615773105863909
126, 101, 288, 129, 290, 130, -2, -1, -2.677945044588987, 2.23606797749979
126, 102, 194, 135, 196, 135, -2, 0, 3.141592653589793, 2.0
126, 103, 181, 119, 183, 119, -2, 0, 3.141592653589793, 2.0
126, 108, 207, 308, 209, 311, -2, -3, -2.158798930342464, 3.605551275463989
126, 109, 242, 368, 247, 368, -5, 0, 3.141592653589793, 5.0
126, 112, 252, 143, 255, 144, -3, -1, -2.819842099193151, 3.1622776601683795
126, 113, 347, 134, 349, 134, -2, 0, 3.141592653589793, 2.0
126, 114, 101, 245, 105, 245, -4, 0, 3.141592653589793, 4.0
126, 115, 87, 349, 90, 349, -3, 0, 3.141592653589793, 3.0
126, 116, 167, 185, 173, 189, -6, -4, -2.5535900500422257, 7.211102550927978
126, 117, 103, 317, 106, 318, -3, -1, -2.819842099193151, 3.1622776601683795
126, 119, 485, 165, 484, 171, 1, -6, -1.4056476493802699, 6.082762530298219
126, 120, 160, 245, 166, 248, -6, -3, -2.677945044588987, 6.708203932499369
126, 121, 209, 172, 214, 176, -5, -4, -2.4668517113662407, 6.4031242374328485
126, 122, 413, 154, 414, 158, -1, -4, -1.8157749899217608, 4.123105625617661
126, 124, 134, 181, 138, 182, -4, -1, -2.896613990462929, 4.123105625617661
126, 126, 213, 339, 215, 341, -2, -2, -2.356194490192345, 2.8284271247461903
126, 127, 184, 260, 190, 262, -6, -2, -2.819842099193151, 6.324555320336759
126, 128, 86, 332, 93, 332, -7, 0, 3.141592653589793, 7.0
126, 129, 103, 341, 106, 342, -3, -1, -2.819842099193151, 3.1622776601683795
127, 6, 173, 284, 175, 287, -2, -3, -2.158798930342464, 3.605551275463989
127, 7, 288, 145, 290, 146, -2, -1, -2.677945044588987, 2.23606797749979
127, 9, 70, 174, 72, 175, -2, -1, -2.677945044588987, 2.23606797749979
127, 10, 166, 116, 168, 117, -2, -1, -2.677945044588987, 2.23606797749979
127, 12, 191, 164, 195, 165, -4, -1, -2.896613990462929, 4.123105625617661
127, 18, 121, 125, 123, 126, -2, -1, -2.677945044588987, 2.23606797749979
127, 24, 580, 172, 580, 174, 0, -2, -1.5707963267948966, 2.0
127, 27, 322, 234, 324, 236, -2, -2, -2.356194490192345, 2.8284271247461903
127, 28, 336, 365, 339, 366, -3, -1, -2.819842099193151, 3.1622776601683795
127, 29, 338, 254, 341, 255, -3, -1, -2.819842099193151, 3.1622776601683795
127, 31, 270, 118, 272, 119, -2, -1, -2.677945044588987, 2.23606797749979
127, 37, 282, 368, 287, 367, -5, 1, 2.9441970937399127, 5.0990195135927845
127, 40, 133, 247, 137, 248, -4, -1, -2.896613990462929, 4.123105625617661
127, 41, 358, 131, 362, 133, -4, -2, -2.677945044588987, 4.47213595499958
127, 42, 105, 110, 107, 111, -2, -1, -2.677945044588987, 2.23606797749979
127, 45, 150, 116, 152, 117, -2, -1, -2.677945044588987, 2.23606797749979
127, 46, 314, 118, 316, 118, -2, 0, 3.141592653589793, 2.0
127, 49, 247, 304, 252, 304, -5, 0, 3.141592653589793, 5.0
127, 50, 437, 367, 440, 367, -3, 0, 3.141592653589793, 3.0
127, 53, 232, 139, 235, 141, -3, -2, -2.5535900500422257, 3.605551275463989
127, 55, 573, 206, 575, 208, -2, -2, -2.356194490192345, 2.8284271247461903
127, 57, 523, 139, 523, 144, 0, -5, -1.5707963267948966, 5.0
127, 58, 263, 231, 267, 232, -4, -1, -2.896613990462929, 4.123105625617661
127, 62, 106, 364, 109, 364, -3, 0, 3.141592653589793, 3.0
127, 63, 107, 281, 113, 281, -6, 0, 3.141592653589793, 6.0
127, 64, 587, 278, 586, 279, 1, -1, -0.7853981633974483, 1.4142135623730951
127, 65, 324, 180, 328, 184, -4, -4, -2.356194490192345, 5.656854249492381
127, 67, 367, 151, 371, 156, -4, -5, -2.2455372690184494, 6.4031242374328485
127, 68, 350, 364, 353, 365, -3, -1, -2.819842099193151, 3.1622776601683795
127, 69, 170, 272, 173, 273, -3, -1, -2.819842099193151, 3.1622776601683795
127, 71, 145, 278, 148, 278, -3, 0, 3.141592653589793, 3.0
127, 72, 576, 275, 575, 277, 1, -2, -1.1071487177940904, 2.23606797749979
127, 75, 578, 246, 579, 248, -1, -2, -2.0344439357957027, 2.23606797749979
127, 76, 284, 237, 290, 240, -6, -3, -2.677945044588987, 6.708203932499369
127, 77, 103, 165, 107, 167, -4, -2, -2.677945044588987, 4.47213595499958
127, 78, 269, 127, 271, 127, -2, 0, 3.141592653589793, 2.0
127, 80, 192, 135, 194, 135, -2, 0, 3.141592653589793, 2.0
127, 81, 179, 119, 181, 119, -2, 0, 3.141592653589793, 2.0
127, 84, 202, 307, 207, 308, -5, -1, -2.9441970937399127, 5.0990195135927845
127, 85, 235, 367, 242, 368, -7, -1, -2.999695598985629, 7.0710678118654755
127, 88, 249, 142, 252, 143, -3, -1, -2.819842099193151, 3.1622776601683795
127, 89, 345, 134, 347, 134, -2, 0, 3.141592653589793, 2.0
127, 90, 97, 244, 101, 245, -4, -1, -2.896613990462929, 4.123105625617661
127, 91, 85, 349, 87, 349, -2, 0, 3.141592653589793, 2.0
127, 92, 164, 183, 167, 185, -3, -2, -2.5535900500422257, 3.605551275463989
127, 93, 100, 316, 103, 317, -3, -1, -2.819842099193151, 3.1622776601683795
127, 95, 484, 161, 485, 165, -1, -4, -1.8157749899217608, 4.123105625617661
127, 96, 156, 242, 160, 245, -4, -3, -2.498091544796509, 5.0
127, 97, 204, 171, 209, 172, -5, -1, -2.9441970937399127, 5.0990195135927845
127, 98, 411, 150, 413, 154, -2, -4, -2.0344439357957027, 4.47213595499958
127, 100, 130, 179, 134, 181, -4, -2, -2.677945044588987, 4.47213595499958
127, 103, 178, 259, 184, 260, -6, -1, -2.976443976175166, 6.082762530298219
127, 104, 82, 332, 86, 332, -4, 0, 3.141592653589793, 4.0
128, 5, 508, 113, 508, 115, 0, -2, -1.5707963267948966, 2.0
128, 6, 171, 283, 173, 284, -2, -1, -2.677945044588987, 2.23606797749979
128, 7, 286, 144, 288, 145, -2, -1, -2.677945044588987, 2.23606797749979
128, 9, 70, 172, 70, 174, 0, -2, -1.5707963267948966, 2.0
128, 11, 187, 163, 191, 164, -4, -1, -2.896613990462929, 4.123105625617661
128, 16, 119, 124, 121, 125, -2, -1, -2.677945044588987, 2.23606797749979
128, 21, 580, 169, 580, 172, 0, -3, -1.5707963267948966, 3.0
128, 22, 319, 230, 322, 234, -3, -4, -2.214297435588181, 5.0
128, 23, 334, 364, 336, 365, -2, -1, -2.677945044588987, 2.23606797749979
128, 24, 326, 121, 328, 122, -2, -1, -2.677945044588987, 2.23606797749979
128, 27, 212, 119, 214, 120, -2, -1, -2.677945044588987, 2.23606797749979
128, 28, 276, 368, 282, 368, -6, 0, 3.141592653589793, 6.0
128, 30, 131, 247, 133, 247, -2, 0, 3.141592653589793, 2.0
128, 31, 356, 130, 358, 131, -2, -1, -2.677945044588987, 2.23606797749979
128, 34, 82, 364, 84, 364, -2, 0, 3.141592653589793, 2.0
128, 35, 148, 116, 150, 116, -2, 0, 3.141592653589793, 2.0
128, 36, 312, 118, 314, 118, -2, 0, 3.141592653589793, 2.0
128, 38, 590, 208, 590, 210, 0, -2, -1.5707963267948966, 2.0
128, 39, 244, 304, 247, 304, -3, 0, 3.141592653589793, 3.0
128, 40, 435, 366, 437, 367, -2, -1, -2.677945044588987, 2.23606797749979
128, 42, 90, 143, 92, 143, -2, 0, 3.141592653589793, 2.0
128, 43, 229, 137, 232, 139, -3, -2, -2.5535900500422257, 3.605551275463989
128, 45, 573, 204, 573, 206, 0, -2, -1.5707963267948966, 2.0
128, 47, 523, 136, 523, 139, 0, -3, -1.5707963267948966, 3.0
128, 48, 261, 232, 263, 231, -2, 1, 2.677945044588987, 2.23606797749979
128, 51, 103, 136, 105, 136, -2, 0, 3.141592653589793, 2.0
128, 52, 103, 363, 106, 364, -3, -1, -2.819842099193151, 3.1622776601683795
128, 53, 105, 281, 107, 281, -2, 0, 3.141592653589793, 2.0
128, 54, 588, 277, 587, 278, 1, -1, -0.7853981633974483, 1.4142135623730951
128, 55, 321, 176, 324, 180, -3, -4, -2.214297435588181, 5.0
128, 57, 363, 149, 367, 151, -4, -2, -2.677945044588987, 4.47213595499958
128, 58, 348, 363, 350, 364, -2, -1, -2.677945044588987, 2.23606797749979
128, 59, 167, 271, 170, 272, -3, -1, -2.819842099193151, 3.1622776601683795
128, 61, 142, 277, 145, 278, -3, -1, -2.819842099193151, 3.1622776601683795
128, 62, 577, 274, 576, 275, 1, -1, -0.7853981633974483, 1.4142135623730951
128, 65, 577, 244, 578, 246, -1, -2, -2.0344439357957027, 2.23606797749979
128, 66, 278, 235, 284, 237, -6, -2, -2.819842099193151, 6.324555320336759
128, 67, 101, 164, 103, 165, -2, -1, -2.677945044588987, 2.23606797749979
128, 68, 267, 127, 269, 127, -2, 0, 3.141592653589793, 2.0
128, 69, 285, 128, 287, 129, -2, -1, -2.677945044588987, 2.23606797749979
128, 70, 190, 134, 192, 135, -2, -1, -2.677945044588987, 2.23606797749979
128, 71, 177, 119, 179, 119, -2, 0, 3.141592653589793, 2.0
128, 78, 246, 141, 249, 142, -3, -1, -2.819842099193151, 3.1622776601683795
128, 79, 343, 133, 345, 134, -2, -1, -2.677945044588987, 2.23606797749979
128, 80, 91, 242, 97, 244, -6, -2, -2.819842099193151, 6.324555320336759
128, 82, 161, 181, 164, 183, -3, -2, -2.5535900500422257, 3.605551275463989
128, 83, 97, 316, 100, 316, -3, 0, 3.141592653589793, 3.0
128, 85, 483, 157, 484, 161, -1, -4, -1.8157749899217608, 4.123105625617661
128, 86, 154, 240, 156, 242, -2, -2, -2.356194490192345, 2.8284271247461903
128, 87, 199, 169, 204, 171, -5, -2, -2.761086276477428, 5.385164807134504
128, 88, 408, 146, 411, 150, -3, -4, -2.214297435588181, 5.0
128, 90, 124, 175, 130, 179, -6, -4, -2.5535900500422257, 7.211102550927978
128, 92, 208, 338, 212, 339, -4, -1, -2.896613990462929, 4.123105625617661
128, 93, 175, 259, 178, 259, -3, 0, 3.141592653589793, 3.0
128, 94, 79, 332, 82, 332, -3, 0, 3.141592653589793, 3.0
129, 2, 528, 363, 527, 364, 1, -1, -0.7853981633974483, 1.4142135623730951
129, 5, 173, 276, 171, 283, 2, -7, -1.2924966677897853, 7.280109889280518
129, 6, 284, 143, 286, 144, -2, -1, -2.677945044588987, 2.23606797749979
129, 8, 70, 170, 70, 172, 0, -2, -1.5707963267948966, 2.0
129, 9, 185, 162, 187, 163, -2, -1, -2.677945044588987, 2.23606797749979
129, 13, 117, 124, 119, 124, -2, 0, 3.141592653589793, 2.0
129, 18, 579, 167, 580, 169, -1, -2, -2.0344439357957027, 2.23606797749979
129, 19, 316, 228, 319, 230, -3, -2, -2.5535900500422257, 3.605551275463989
129, 21, 210, 119, 212, 119, -2, 0, 3.141592653589793, 2.0
129, 22, 272, 368, 276, 368, -4, 0, 3.141592653589793, 4.0
129, 24, 128, 246, 131, 247, -3, -1, -2.819842099193151, 3.1622776601683795
129, 26, 132, 143, 133, 142, -1, 1, 2.356194490192345, 1.4142135623730951
129, 30, 589, 206, 590, 208, -1, -2, -2.0344439357957027, 2.23606797749979
129, 31, 239, 303, 244, 304, -5, -1, -2.9441970937399127, 5.0990195135927845
129, 32, 433, 365, 435, 366, -2, -1, -2.677945044588987, 2.23606797749979
129, 34, 226, 135, 229, 137, -3, -2, -2.5535900500422257, 3.605551275463989
129, 35, 573, 202, 573, 204, 0, -2, -1.5707963267948966, 2.0
129, 36, 523, 133, 523, 136, 0, -3, -1.5707963267948966, 3.0
129, 37, 257, 229, 261, 232, -4, -3, -2.498091544796509, 5.0
129, 41, 99, 362, 103, 363, -4, -1, -2.896613990462929, 4.123105625617661
129, 42, 103, 280, 105, 281, -2, -1, -2.677945044588987, 2.23606797749979
129, 44, 320, 172, 321, 176, -1, -4, -1.8157749899217608, 4.123105625617661
129, 46, 358, 147, 363, 149, -5, -2, -2.761086276477428, 5.385164807134504
129, 47, 346, 363, 348, 363, -2, 0, 3.141592653589793, 2.0
129, 48, 164, 270, 167, 271, -3, -1, -2.819842099193151, 3.1622776601683795
129, 49, 140, 276, 142, 277, -2, -1, -2.677945044588987, 2.23606797749979
129, 50, 578, 273, 577, 274, 1, -1, -0.7853981633974483, 1.4142135623730951
129, 53, 577, 242, 577, 244, 0, -2, -1.5707963267948966, 2.0
129, 54, 99, 163, 101, 164, -2, -1, -2.677945044588987, 2.23606797749979
129, 55, 264, 126, 267, 127, -3, -1, -2.819842099193151, 3.1622776601683795
129, 56, 283, 128, 285, 128, -2, 0, 3.141592653589793, 2.0
129, 57, 188, 134, 190, 134, -2, 0, 3.141592653589793, 2.0
129, 58, 175, 119, 177, 119, -2, 0, 3.141592653589793, 2.0
129, 61, 230, 367, 234, 367, -4, 0, 3.141592653589793, 4.0
129, 63, 135, 105, 137, 106, -2, -1, -2.677945044588987, 2.23606797749979
129, 64, 244, 141, 246, 141, -2, 0, 3.141592653589793, 2.0
129, 65, 341, 132, 343, 133, -2, -1, -2.677945044588987, 2.23606797749979
129, 66, 89, 241, 91, 242, -2, -1, -2.677945044588987, 2.23606797749979
129, 67, 85, 347, 84, 349, 1, -2, -1.1071487177940904, 2.23606797749979
129, 68, 159, 179, 161, 181, -2, -2, -2.356194490192345, 2.8284271247461903
129, 69, 95, 316, 97, 316, -2, 0, 3.141592653589793, 2.0
129, 71, 483, 155, 483, 157, 0, -2, -1.5707963267948966, 2.0
129, 72, 194, 165, 199, 169, -5, -4, -2.4668517113662407, 6.4031242374328485
129, 74, 121, 173, 124, 175, -3, -2, -2.5535900500422257, 3.605551275463989
129, 76, 204, 338, 208, 338, -4, 0, 3.141592653589793, 4.0
129, 77, 173, 259, 175, 259, -2, 0, 3.141592653589793, 2.0
129, 78, 76, 331, 79, 332, -3, -1, -2.819842099193151, 3.1622776601683795
130, 4, 77, 176, 76, 177, 1, -1, -0.7853981633974483, 1.4142135623730951
130, 5, 74, 335, 76, 336, -2, -1, -2.677945044588987, 2.23606797749979
130, 8, 398, 119, 400, 119, -2, 0, 3.141592653589793, 2.0
130, 12, 391, 136, 393, 137, -2, -1, -2.677945044588987, 2.23606797749979
130, 16, 249, 120, 251, 120, -2, 0, 3.141592653589793, 2.0
130, 21, 166, 289, 172, 290, -6, -1, -2.976443976175166, 6.082762530298219
130, 22, 150, 117, 152, 118, -2, -1, -2.677945044588987, 2.23606797749979
130, 23, 215, 121, 217, 121, -2, 0, 3.141592653589793, 2.0
130, 24, 241, 302, 249, 303, -8, -1, -3.017237659043032, 8.06225774829855
130, 25, 438, 367, 440, 368, -2, -1, -2.677945044588987, 2.23606797749979
130, 32, 573, 366, 572, 367, 1, -1, -0.7853981633974483, 1.4142135623730951
130, 35, 232, 136, 235, 139, -3, -3, -2.356194490192345, 4.242640687119285
130, 40, 317, 229, 322, 233, -5, -4, -2.4668517113662407, 6.4031242374328485
130, 41, 283, 365, 288, 365, -5, 0, 3.141592653589793, 5.0
130, 43, 581, 173, 581, 175, 0, -2, -1.5707963267948966, 2.0
130, 44, 67, 333, 69, 334, -2, -1, -2.677945044588987, 2.23606797749979
130, 45, 189, 160, 194, 163, -5, -3, -2.601173153319209, 5.830951894845301
130, 48, 289, 145, 291, 146, -2, -1, -2.677945044588987, 2.23606797749979
130, 50, 191, 138, 193, 138, -2, 0, 3.141592653589793, 2.0
130, 51, 349, 365, 352, 366, -3, -1, -2.819842099193151, 3.1622776601683795
130, 55, 332, 246, 334, 248, -2, -2, -2.356194490192345, 2.8284271247461903
130, 57, 583, 246, 583, 248, 0, -2, -1.5707963267948966, 2.0
130, 61, 529, 140, 529, 142, 0, -2, -1.5707963267948966, 2.0
130, 62, 92, 145, 94, 145, -2, 0, 3.141592653589793, 2.0
130, 65, 573, 207, 574, 209, -1, -2, -2.0344439357957027, 2.23606797749979
130, 66, 314, 116, 316, 117, -2, -1, -2.677945044588987, 2.23606797749979
130, 70, 67, 308, 69, 308, -2, 0, 3.141592653589793, 2.0
130, 75, 574, 142, 575, 144, -1, -2, -2.0344439357957027, 2.23606797749979
130, 76, 87, 345, 87, 347, 0, -2, -1.5707963267948966, 2.0
130, 80, 258, 226, 264, 231, -6, -5, -2.44685437739309, 7.810249675906654
130, 81, 143, 274, 149, 276, -6, -2, -2.819842099193151, 6.324555320336759
130, 83, 334, 367, 338, 368, -4, -1, -2.896613990462929, 4.123105625617661
130, 86, 129, 242, 135, 245, -6, -3, -2.677945044588987, 6.708203932499369
130, 88, 70, 117, 71, 119, -1, -2, -2.0344439357957027, 2.23606797749979
130, 95, 241, 127, 245, 128, -4, -1, -2.896613990462929, 4.123105625617661
130, 97, 214, 169, 219, 174, -5, -5, -2.356194490192345, 7.0710678118654755
130, 99, 328, 122, 330, 124, -2, -2, -2.356194490192345, 2.8284271247461903
130, 100, 466, 137, 467, 139, -1, -2, -2.0344439357957027, 2.23606797749979
130, 102, 180, 120, 182, 120, -2, 0, 3.141592653589793, 2.0
130, 103, 114, 212, 120, 213, -6, -1, -2.976443976175166, 6.082762530298219
130, 104, 99, 160, 106, 164, -7, -4, -2.62244653934327, 8.06225774829855
130, 105, 590, 277, 588, 279, 2, -2, -0.7853981633974483, 2.8284271247461903
130, 106, 91, 317, 94, 317, -3, 0, 3.141592653589793, 3.0
130, 108, 196, 166, 201, 169, -5, -3, -2.601173153319209, 5.830951894845301
130, 109, 124, 176, 130, 179, -6, -3, -2.677945044588987, 6.708203932499369
130, 113, 286, 129, 289, 130, -3, -1, -2.819842099193151, 3.1622776601683795
130, 115, 266, 128, 269, 128, -3, 0, 3.141592653589793, 3.0
130, 118, 267, 135, 269, 136, -2, -1, -2.677945044588987, 2.23606797749979
130, 120, 257, 342, 259, 343, -2, -1, -2.677945044588987, 2.23606797749979
130, 122, 110, 366, 113, 366, -3, 0, 3.141592653589793, 3.0
130, 127, 271, 157, 274, 159, -3, -2, -2.5535900500422257, 3.605551275463989
130, 128, 297, 366, 301, 365, -4, 1, 2.896613990462929, 4.123105625617661
130, 129, 150, 277, 156, 279, -6, -2, -2.819842099193151, 6.324555320336759
130, 132, 226, 140, 229, 143, -3, -3, -2.356194490192345, 4.242640687119285
131, 5, 72, 334, 74, 335, -2, -1, -2.677945044588987, 2.23606797749979
131, 14, 247, 119, 249, 120, -2, -1, -2.677945044588987, 2.23606797749979
131, 18, 158, 287, 166, 289, -8, -2, -2.896613990462929, 8.246211251235321
131, 20, 213, 121, 215, 121, -2, 0, 3.141592653589793, 2.0
131, 21, 238, 300, 241, 302, -3, -2, -2.5535900500422257, 3.605551275463989
131, 22, 434, 367, 438, 367, -4, 0, 3.141592653589793, 4.0
131, 23, 56, 285, 55, 286, 1, -1, -0.7853981633974483, 1.4142135623730951
131, 26, 75, 127, 75, 129, 0, -2, -1.5707963267948966, 2.0
131, 27, 166, 121, 168, 122, -2, -1, -2.677945044588987, 2.23606797749979
131, 32, 230, 134, 232, 136, -2, -2, -2.356194490192345, 2.8284271247461903
131, 36, 315, 228, 317, 229, -2, -1, -2.677945044588987, 2.23606797749979
131, 37, 277, 363, 283, 365, -6, -2, -2.819842099193151, 6.324555320336759
131, 39, 581, 171, 581, 173, 0, -2, -1.5707963267948966, 2.0
131, 41, 184, 157, 189, 160, -5, -3, -2.601173153319209, 5.830951894845301
131, 44, 286, 143, 289, 145, -3, -2, -2.5535900500422257, 3.605551275463989
131, 46, 187, 137, 191, 138, -4, -1, -2.896613990462929, 4.123105625617661
131, 47, 345, 364, 349, 365, -4, -1, -2.896613990462929, 4.123105625617661
131, 51, 330, 245, 332, 246, -2, -1, -2.677945044588987, 2.23606797749979
131, 53, 582, 243, 583, 246, -1, -3, -1.892546881191539, 3.1622776601683795
131, 57, 530, 139, 529, 140, 1, -1, -0.7853981633974483, 1.4142135623730951
131, 58, 90, 144, 92, 145, -2, -1, -2.677945044588987, 2.23606797749979
131, 61, 572, 204, 573, 207, -1, -3, -1.892546881191539, 3.1622776601683795
131, 62, 312, 115, 314, 116, -2, -1, -2.677945044588987, 2.23606797749979
131, 68, 43, 191, 45, 192, -2, -1, -2.677945044588987, 2.23606797749979
131, 73, 255, 225, 258, 226, -3, -1, -2.819842099193151, 3.1622776601683795
131, 74, 136, 272, 143, 274, -7, -2, -2.8632929945846817, 7.280109889280518
131, 76, 328, 366, 334, 367, -6, -1, -2.976443976175166, 6.082762530298219
131, 78, 123, 240, 129, 242, -6, -2, -2.819842099193151, 6.324555320336759
131, 85, 238, 127, 241, 127, -3, 0, 3.141592653589793, 3.0
131, 87, 211, 166, 214, 169, -3, -3, -2.356194490192345, 4.242640687119285
131, 89, 326, 121, 328, 122, -2, -1, -2.677945044588987, 2.23606797749979
131, 90, 464, 136, 466, 137, -2, -1, -2.677945044588987, 2.23606797749979
131, 91, 110, 210, 114, 212, -4, -2, -2.677945044588987, 4.47213595499958
131, 92, 96, 157, 99, 160, -3, -3, -2.356194490192345, 4.242640687119285
131, 93, 590, 275, 590, 277, 0, -2, -1.5707963267948966, 2.0
131, 94, 88, 317, 91, 317, -3, 0, 3.141592653589793, 3.0
131, 96, 192, 164, 196, 166, -4, -2, -2.677945044588987, 4.47213595499958
131, 97, 120, 174, 124, 176, -4, -2, -2.677945044588987, 4.47213595499958
131, 101, 284, 128, 286, 129, -2, -1, -2.677945044588987, 2.23606797749979
131, 103, 264, 127, 266, 128, -2, -1, -2.677945044588987, 2.23606797749979
131, 105, 265, 134, 267, 135, -2, -1, -2.677945044588987, 2.23606797749979
131, 106, 254, 342, 257, 342, -3, 0, 3.141592653589793, 3.0
131, 107, 107, 366, 110, 366, -3, 0, 3.141592653589793, 3.0
131, 108, 581, 276, 580, 277, 1, -1, -0.7853981633974483, 1.4142135623730951
131, 112, 268, 155, 271, 157, -3, -2, -2.5535900500422257, 3.605551275463989
131, 113, 293, 367, 297, 366, -4, 1, 2.896613990462929, 4.123105625617661
131, 114, 146, 274, 150, 277, -4, -3, -2.498091544796509, 5.0
131, 117, 223, 139, 226, 140, -3, -1, -2.819842099193151, 3.1622776601683795
132, 12, 245, 119, 247, 119, -2, 0, 3.141592653589793, 2.0
132, 16, 154, 287, 158, 287, -4, 0, 3.141592653589793, 4.0
132, 17, 147, 116, 149, 117, -2, -1, -2.677945044588987, 2.23606797749979
132, 19, 235, 300, 238, 300, -3, 0, 3.141592653589793, 3.0
132, 20, 432, 367, 434, 367, -2, 0, 3.141592653589793, 2.0
132, 25, 162, 119, 166, 121, -4, -2, -2.677945044588987, 4.47213595499958
132, 29, 228, 132, 230, 134, -2, -2, -2.356194490192345, 2.8284271247461903
132, 33, 313, 227, 315, 228, -2, -1, -2.677945044588987, 2.23606797749979
132, 34, 274, 362, 277, 363, -3, -1, -2.819842099193151, 3.1622776601683795
132, 36, 580, 169, 581, 171, -1, -2, -2.0344439357957027, 2.23606797749979
132, 37, 180, 155, 184, 157, -4, -2, -2.677945044588987, 4.47213595499958
132, 40, 283, 143, 286, 143, -3, 0, 3.141592653589793, 3.0
132, 41, 184, 137, 187, 137, -3, 0, 3.141592653589793, 3.0
132, 42, 341, 363, 345, 364, -4, -1, -2.896613990462929, 4.123105625617661
132, 46, 327, 243, 330, 245, -3, -2, -2.5535900500422257, 3.605551275463989
132, 48, 581, 240, 582, 243, -1, -3, -1.892546881191539, 3.1622776601683795
132, 54, 571, 202, 572, 204, -1, -2, -2.0344439357957027, 2.23606797749979
132, 58, 65, 309, 66, 308, -1, 1, 2.356194490192345, 1.4142135623730951
132, 63, 250, 223, 255, 225, -5, -2, -2.761086276477428, 5.385164807134504
132, 64, 132, 270, 136, 272, -4, -2, -2.677945044588987, 4.47213595499958
132, 66, 325, 364, 328, 366, -3, -2, -2.5535900500422257, 3.605551275463989
132, 68, 118, 238, 123, 240, -5, -2, -2.761086276477428, 5.385164807134504
132, 75, 236, 126, 238, 127, -2, -1, -2.677945044588987, 2.23606797749979
132, 77, 209, 164, 211, 166, -2, -2, -2.356194490192345, 2.8284271247461903
132, 79, 106, 208, 110, 210, -4, -2, -2.677945044588987, 4.47213595499958
132, 80, 94, 154, 96, 157, -2, -3, -2.158798930342464, 3.605551275463989
132, 81, 591, 274, 590, 275, 1, -1, -0.7853981633974483, 1.4142135623730951
132, 82, 84, 317, 88, 317, -4, 0, 3.141592653589793, 4.0
132, 84, 187, 162, 192, 164, -5, -2, -2.761086276477428, 5.385164807134504
132, 85, 115, 171, 120, 174, -5, -3, -2.601173153319209, 5.830951894845301
132, 89, 262, 126, 264, 127, -2, -1, -2.677945044588987, 2.23606797749979
132, 90, 263, 133, 265, 134, -2, -1, -2.677945044588987, 2.23606797749979
132, 91, 251, 342, 254, 342, -3, 0, 3.141592653589793, 3.0
132, 92, 103, 366, 107, 366, -4, 0, 3.141592653589793, 4.0
132, 97, 265, 154, 268, 155, -3, -1, -2.819842099193151, 3.1622776601683795
132, 98, 290, 368, 293, 367, -3, 1, 2.819842099193151, 3.1622776601683795
132, 99, 141, 274, 146, 274, -5, 0, 3.141592653589793, 5.0
132, 102, 222, 137, 223, 139, -1, -2, -2.0344439357957027, 2.23606797749979
133, 7, 530, 364, 529, 365, 1, -1, -0.7853981633974483, 1.4142135623730951
133, 10, 243, 118, 245, 119, -2, -1, -2.677945044588987, 2.23606797749979
133, 13, 147, 286, 154, 287, -7, -1, -2.999695598985629, 7.0710678118654755
133, 15, 210, 121, 212, 121, -2, 0, 3.141592653589793, 2.0
133, 16, 231, 300, 235, 300, -4, 0, 3.141592653589793, 4.0
133, 17, 430, 366, 432, 367, -2, -1, -2.677945044588987, 2.23606797749979
133, 20, 75, 124, 75, 126, 0, -2, -1.5707963267948966, 2.0
133, 21, 160, 118, 162, 119, -2, -1, -2.677945044588987, 2.23606797749979
133, 27, 308, 224, 313, 227, -5, -3, -2.601173153319209, 5.830951894845301
133, 28, 270, 361, 274, 362, -4, -1, -2.896613990462929, 4.123105625617661
133, 30, 579, 167, 580, 169, -1, -2, -2.0344439357957027, 2.23606797749979
133, 31, 174, 152, 180, 155, -6, -3, -2.677945044588987, 6.708203932499369
133, 34, 281, 142, 283, 143, -2, -1, -2.677945044588987, 2.23606797749979
133, 35, 182, 136, 184, 137, -2, -1, -2.677945044588987, 2.23606797749979
133, 36, 337, 362, 341, 363, -4, -1, -2.896613990462929, 4.123105625617661
133, 40, 324, 242, 327, 243, -3, -1, -2.819842099193151, 3.1622776601683795
133, 42, 581, 237, 581, 240, 0, -3, -1.5707963267948966, 3.0
133, 46, 87, 144, 89, 144, -2, 0, 3.141592653589793, 2.0
133, 48, 570, 200, 571, 202, -1, -2, -2.0344439357957027, 2.23606797749979
133, 54, 245, 221, 250, 223, -5, -2, -2.761086276477428, 5.385164807134504
133, 55, 129, 268, 132, 270, -3, -2, -2.5535900500422257, 3.605551275463989
133, 57, 320, 363, 325, 364, -5, -1, -2.9441970937399127, 5.0990195135927845
133, 58, 101, 136, 103, 136, -2, 0, 3.141592653589793, 2.0
133, 59, 114, 236, 118, 238, -4, -2, -2.677945044588987, 4.47213595499958
133, 64, 234, 126, 236, 126, -2, 0, 3.141592653589793, 2.0
133, 66, 208, 162, 209, 164, -1, -2, -2.0344439357957027, 2.23606797749979
133, 68, 103, 205, 106, 208, -3, -3, -2.356194490192345, 4.242640687119285
133, 69, 92, 153, 94, 154, -2, -1, -2.677945044588987, 2.23606797749979
133, 71, 83, 318, 84, 317, -1, 1, 2.356194490192345, 1.4142135623730951
133, 73, 182, 158, 187, 162, -5, -4, -2.4668517113662407, 6.4031242374328485
133, 74, 111, 169, 115, 171, -4, -2, -2.677945044588987, 4.47213595499958
133, 78, 260, 125, 262, 126, -2, -1, -2.677945044588987, 2.23606797749979
133, 79, 261, 132, 263, 133, -2, -1, -2.677945044588987, 2.23606797749979
133, 80, 246, 341, 251, 342, -5, -1, -2.9441970937399127, 5.0990195135927845
133, 81, 99, 366, 103, 366, -4, 0, 3.141592653589793, 4.0
133, 82, 584, 272, 581, 275, 3, -3, -0.7853981633974483, 4.242640687119285
133, 85, 263, 153, 265, 154, -2, -1, -2.677945044588987, 2.23606797749979
133, 86, 287, 368, 290, 368, -3, 0, 3.141592653589793, 3.0
133, 87, 134, 272, 141, 274, -7, -2, -2.8632929945846817, 7.280109889280518
133, 90, 220, 136, 222, 137, -2, -1, -2.677945044588987, 2.23606797749979
134, 9, 241, 117, 243, 118, -2, -1, -2.677945044588987, 2.23606797749979
134, 14, 208, 120, 210, 121, -2, -1, -2.677945044588987, 2.23606797749979
134, 15, 224, 298, 231, 300, -7, -2, -2.8632929945846817, 7.280109889280518
134, 16, 427, 365, 430, 366, -3, -1, -2.819842099193151, 3.1622776601683795
134, 20, 158, 117, 160, 118, -2, -1, -2.677945044588987, 2.23606797749979
134, 26, 304, 221, 308, 224, -4, -3, -2.498091544796509, 5.0
134, 27, 267, 360, 270, 361, -3, -1, -2.819842099193151, 3.1622776601683795
134, 29, 579, 165, 579, 167, 0, -2, -1.5707963267948966, 2.0
134, 30, 172, 151, 174, 152, -2, -1, -2.677945044588987, 2.23606797749979
134, 31, 50, 310, 53, 310, -3, 0, 3.141592653589793, 3.0
134, 33, 279, 141, 281, 142, -2, -1, -2.677945044588987, 2.23606797749979
134, 34, 179, 135, 182, 136, -3, -1, -2.819842099193151, 3.1622776601683795
134, 35, 335, 361, 337, 362, -2, -1, -2.677945044588987, 2.23606797749979
134, 39, 321, 242, 324, 242, -3, 0, 3.141592653589793, 3.0
134, 40, 580, 235, 581, 237, -1, -2, -2.0344439357957027, 2.23606797749979
134, 44, 85, 143, 87, 144, -2, -1, -2.677945044588987, 2.23606797749979
134, 49, 243, 220, 245, 221, -2, -1, -2.677945044588987, 2.23606797749979
134, 50, 125, 266, 129, 268, -4, -2, -2.677945044588987, 4.47213595499958
134, 51, 317, 364, 320, 363, -3, 1, 2.819842099193151, 3.1622776601683795
134, 52, 110, 234, 114, 236, -4, -2, -2.677945044588987, 4.47213595499958
134, 57, 232, 125, 234, 126, -2, -1, -2.677945044588987, 2.23606797749979
134, 58, 204, 159, 208, 162, -4, -3, -2.498091544796509, 5.0
134, 60, 100, 205, 103, 205, -3, 0, 3.141592653589793, 3.0
134, 61, 91, 151, 92, 153, -1, -2, -2.0344439357957027, 2.23606797749979
134, 63, 80, 318, 83, 318, -3, 0, 3.141592653589793, 3.0
134, 64, 176, 155, 182, 158, -6, -3, -2.677945044588987, 6.708203932499369
134, 68, 258, 124, 260, 125, -2, -1, -2.677945044588987, 2.23606797749979
134, 69, 259, 131, 261, 132, -2, -1, -2.677945044588987, 2.23606797749979
134, 70, 240, 341, 246, 341, -6, 0, 3.141592653589793, 6.0
134, 74, 260, 152, 263, 153, -3, -1, -2.819842099193151, 3.1622776601683795
134, 75, 283, 368, 287, 368, -4, 0, 3.141592653589793, 4.0
134, 76, 128, 271, 134, 272, -6, -1, -2.976443976175166, 6.082762530298219
134, 78, 218, 134, 220, 136, -2, -2, -2.356194490192345, 2.8284271247461903
135, 1, 284, 142, 286, 143, -2, -1, -2.677945044588987, 2.23606797749979
135, 8, 534, 365, 533, 366, 1, -1, -0.7853981633974483, 1.4142135623730951
135, 9, 175, 151, 181, 154, -6, -3, -2.677945044588987, 6.708203932499369
135, 15, 53, 309, 52, 310, 1, -1, -0.7853981633974483, 1.4142135623730951
135, 18, 243, 120, 245, 120, -2, 0, 3.141592653589793, 2.0
135, 20, 118, 126, 120, 126, -2, 0, 3.141592653589793, 2.0
135, 21, 303, 223, 308, 227, -5, -4, -2.4668517113662407, 6.4031242374328485
135, 27, 147, 286, 154, 287, -7, -1, -2.999695598985629, 7.0710678118654755
135, 30, 204, 162, 209, 166, -5, -4, -2.4668517113662407, 6.4031242374328485
135, 33, 270, 363, 274, 364, -4, -1, -2.896613990462929, 4.123105625617661
135, 35, 323, 366, 328, 367, -5, -1, -2.9441970937399127, 5.0990195135927845
135, 38, 163, 120, 165, 121, -2, -1, -2.677945044588987, 2.23606797749979
135, 41, 341, 366, 345, 367, -4, -1, -2.896613990462929, 4.123105625617661
135, 42, 527, 138, 526, 139, 1, -1, -0.7853981633974483, 1.4142135623730951
135, 46, 94, 158, 96, 158, -2, 0, 3.141592653589793, 2.0
135, 47, 316, 239, 319, 242, -3, -3, -2.356194490192345, 4.242640687119285
135, 50, 356, 131, 358, 132, -2, -1, -2.677945044588987, 2.23606797749979
135, 55, 326, 121, 328, 121, -2, 0, 3.141592653589793, 2.0
135, 57, 242, 221, 249, 225, -7, -4, -2.62244653934327, 8.06225774829855
135, 61, 433, 369, 435, 369, -2, 0, 3.141592653589793, 2.0
135, 62, 221, 298, 231, 300, -10, -2, -2.9441970937399127, 10.198039027185569
135, 64, 80, 236, 83, 238, -3, -2, -2.5535900500422257, 3.605551275463989
135, 71, 88, 145, 90, 145, -2, 0, 3.141592653589793, 2.0
135, 73, 599, 177, 599, 179, 0, -2, -1.5707963267948966, 2.0
135, 76, 177, 119, 179, 120, -2, -1, -2.677945044588987, 2.23606797749979
135, 78, 583, 165, 584, 167, -1, -2, -2.0344439357957027, 2.23606797749979
135, 79, 592, 275, 591, 276, 1, -1, -0.7853981633974483, 1.4142135623730951
135, 80, 573, 204, 573, 206, 0, -2, -1.5707963267948966, 2.0
135, 81, 112, 236, 119, 239, -7, -3, -2.7367008673047097, 7.615773105863909
135, 86, 282, 126, 284, 127, -2, -1, -2.677945044588987, 2.23606797749979
135, 89, 236, 127, 239, 128, -3, -1, -2.819842099193151, 3.1622776601683795
135, 96, 148, 117, 150, 117, -2, 0, 3.141592653589793, 2.0
135, 98, 589, 206, 590, 208, -1, -2, -2.0344439357957027, 2.23606797749979
135, 99, 403, 145, 403, 147, 0, -2, -1.5707963267948966, 2.0
135, 100, 264, 134, 266, 135, -2, -1, -2.677945044588987, 2.23606797749979
135, 101, 264, 156, 267, 157, -3, -1, -2.819842099193151, 3.1622776601683795
135, 103, 262, 125, 264, 126, -2, -1, -2.677945044588987, 2.23606797749979
135, 105, 184, 136, 186, 137, -2, -1, -2.677945044588987, 2.23606797749979
135, 109, 92, 204, 94, 206, -2, -2, -2.356194490192345, 2.8284271247461903
135, 110, 186, 108, 188, 109, -2, -1, -2.677945044588987, 2.23606797749979
135, 111, 579, 203, 580, 206, -1, -3, -1.892546881191539, 3.1622776601683795
135, 113, 284, 367, 288, 367, -4, 0, 3.141592653589793, 4.0
135, 115, 341, 128, 343, 129, -2, -1, -2.677945044588987, 2.23606797749979
135, 117, 89, 276, 93, 278, -4, -2, -2.677945044588987, 4.47213595499958
135, 118, 282, 150, 285, 151, -3, -1, -2.819842099193151, 3.1622776601683795
135, 121, 181, 201, 185, 203, -4, -2, -2.677945044588987, 4.47213595499958
135, 122, 582, 239, 583, 242, -1, -3, -1.892546881191539, 3.1622776601683795
135, 123, 111, 170, 116, 173, -5, -3, -2.601173153319209, 5.830951894845301
135, 124, 75, 319, 79, 320, -4, -1, -2.896613990462929, 4.123105625617661
135, 125, 145, 265, 148, 266, -3, -1, -2.819842099193151, 3.1622776601683795
135, 127, 128, 271, 134, 273, -6, -2, -2.819842099193151, 6.324555320336759
135, 130, 242, 143, 245, 144, -3, -1, -2.819842099193151, 3.1622776601683795
135, 134, 541, 127, 540, 128, 1, -1, -0.7853981633974483, 1.4142135623730951
135, 136, 185, 144, 188, 145, -3, -1, -2.819842099193151, 3.1622776601683795
136, 1, 281, 140, 284, 142, -3, -2, -2.5535900500422257, 3.605551275463989
136, 4, 387, 137, 389, 137, -2, 0, 3.141592653589793, 2.0
136, 9, 170, 149, 175, 151, -5, -2, -2.761086276477428, 5.385164807134504
136, 15, 241, 120, 243, 120, -2, 0, 3.141592653589793, 2.0
136, 17, 116, 126, 118, 126, -2, 0, 3.141592653589793, 2.0
136, 18, 299, 220, 303, 223, -4, -3, -2.498091544796509, 5.0
136, 19, 90, 341, 89, 342, 1, -1, -0.7853981633974483, 1.4142135623730951
136, 23, 141, 285, 147, 286, -6, -1, -2.976443976175166, 6.082762530298219
136, 26, 199, 158, 204, 162, -5, -4, -2.4668517113662407, 6.4031242374328485
136, 29, 267, 362, 270, 363, -3, -1, -2.819842099193151, 3.1622776601683795
136, 31, 319, 365, 323, 366, -4, -1, -2.896613990462929, 4.123105625617661
136, 34, 160, 119, 163, 120, -3, -1, -2.819842099193151, 3.1622776601683795
136, 35, 337, 366, 341, 366, -4, 0, 3.141592653589793, 4.0
136, 41, 312, 237, 316, 239, -4, -2, -2.677945044588987, 4.47213595499958
136, 44, 354, 130, 356, 131, -2, -1, -2.677945044588987, 2.23606797749979
136, 51, 238, 218, 242, 221, -4, -3, -2.498091544796509, 5.0
136, 54, 430, 369, 433, 369, -3, 0, 3.141592653589793, 3.0
136, 55, 218, 297, 221, 298, -3, -1, -2.819842099193151, 3.1622776601683795
136, 56, 207, 122, 209, 122, -2, 0, 3.141592653589793, 2.0
136, 57, 78, 235, 80, 236, -2, -1, -2.677945044588987, 2.23606797749979
136, 60, 597, 206, 597, 208, 0, -2, -1.5707963267948966, 2.0
136, 66, 266, 118, 268, 119, -2, -1, -2.677945044588987, 2.23606797749979
136, 69, 582, 161, 583, 165, -1, -4, -1.8157749899217608, 4.123105625617661
136, 70, 592, 273, 592, 275, 0, -2, -1.5707963267948966, 2.0
136, 71, 572, 202, 573, 204, -1, -2, -2.0344439357957027, 2.23606797749979
136, 72, 105, 233, 112, 236, -7, -3, -2.7367008673047097, 7.615773105863909
136, 77, 234, 126, 236, 127, -2, -1, -2.677945044588987, 2.23606797749979
136, 79, 87, 367, 88, 366, -1, 1, 2.356194490192345, 1.4142135623730951
136, 84, 146, 116, 148, 117, -2, -1, -2.677945044588987, 2.23606797749979
136, 86, 589, 204, 589, 206, 0, -2, -1.5707963267948966, 2.0
136, 87, 402, 143, 403, 145, -1, -2, -2.0344439357957027, 2.23606797749979
136, 88, 262, 133, 264, 134, -2, -1, -2.677945044588987, 2.23606797749979
136, 89, 261, 156, 264, 156, -3, 0, 3.141592653589793, 3.0
136, 91, 260, 124, 262, 125, -2, -1, -2.677945044588987, 2.23606797749979
136, 92, 182, 135, 184, 136, -2, -1, -2.677945044588987, 2.23606797749979
136, 95, 90, 201, 92, 204, -2, -3, -2.158798930342464, 3.605551275463989
136, 96, 184, 108, 186, 108, -2, 0, 3.141592653589793, 2.0
136, 97, 579, 200, 579, 203, 0, -3, -1.5707963267948966, 3.0
136, 99, 280, 366, 284, 367, -4, -1, -2.896613990462929, 4.123105625617661
136, 101, 339, 128, 341, 128, -2, 0, 3.141592653589793, 2.0
136, 102, 86, 276, 89, 276, -3, 0, 3.141592653589793, 3.0
136, 103, 279, 149, 282, 150, -3, -1, -2.819842099193151, 3.1622776601683795
136, 106, 177, 199, 181, 201, -4, -2, -2.677945044588987, 4.47213595499958
136, 107, 582, 235, 582, 239, 0, -4, -1.5707963267948966, 4.0
136, 108, 106, 168, 111, 170, -5, -2, -2.761086276477428, 5.385164807134504
136, 109, 73, 318, 75, 319, -2, -1, -2.677945044588987, 2.23606797749979
136, 110, 142, 264, 145, 265, -3, -1, -2.819842099193151, 3.1622776601683795
136, 111, 122, 270, 128, 271, -6, -1, -2.976443976175166, 6.082762530298219
136, 114, 239, 143, 242, 143, -3, 0, 3.141592653589793, 3.0
136, 116, 345, 139, 347, 139, -2, 0, 3.141592653589793, 2.0
136, 119, 182, 144, 185, 144, -3, 0, 3.141592653589793, 3.0
137, 0, 278, 139, 281, 140, -3, -1, -2.819842099193151, 3.1622776601683795
137, 3, 385, 138, 387, 137, -2, 1, 2.677945044588987, 2.23606797749979
137, 4, 74, 335, 76, 336, -2, -1, -2.677945044588987, 2.23606797749979
137, 7, 166, 147, 170, 149, -4, -2, -2.677945044588987, 4.47213595499958
137, 14, 114, 125, 116, 126, -2, -1, -2.677945044588987, 2.23606797749979
137, 15, 296, 218, 299, 220, -3, -2, -2.5535900500422257, 3.605551275463989
137, 20, 138, 284, 141, 285, -3, -1, -2.819842099193151, 3.1622776601683795
137, 23, 195, 155, 199, 158, -4, -3, -2.498091544796509, 5.0
137, 26, 264, 361, 267, 362, -3, -1, -2.819842099193151, 3.1622776601683795
137, 28, 315, 364, 319, 365, -4, -1, -2.896613990462929, 4.123105625617661
137, 31, 158, 118, 160, 119, -2, -1, -2.677945044588987, 2.23606797749979
137, 32, 332, 365, 337, 366, -5, -1, -2.9441970937399127, 5.0990195135927845
137, 38, 307, 235, 312, 237, -5, -2, -2.761086276477428, 5.385164807134504
137, 41, 352, 128, 354, 130, -2, -2, -2.356194490192345, 2.8284271247461903
137, 43, 63, 140, 64, 142, -1, -2, -2.0344439357957027, 2.23606797749979
137, 47, 234, 215, 238, 218, -4, -3, -2.498091544796509, 5.0
137, 50, 427, 369, 430, 369, -3, 0, 3.141592653589793, 3.0
137, 51, 214, 295, 218, 297, -4, -2, -2.677945044588987, 4.47213595499958
137, 52, 205, 122, 207, 122, -2, 0, 3.141592653589793, 2.0
137, 53, 77, 233, 78, 235, -1, -2, -2.0344439357957027, 2.23606797749979
137, 56, 597, 204, 597, 206, 0, -2, -1.5707963267948966, 2.0
137, 65, 103, 232, 105, 233, -2, -1, -2.677945044588987, 2.23606797749979
137, 69, 232, 125, 234, 126, -2, -1, -2.677945044588987, 2.23606797749979
137, 74, 144, 116, 146, 116, -2, 0, 3.141592653589793, 2.0
137, 76, 260, 132, 262, 133, -2, -1, -2.677945044588987, 2.23606797749979
137, 77, 258, 155, 261, 156, -3, -1, -2.819842099193151, 3.1622776601683795
137, 79, 258, 123, 260, 124, -2, -1, -2.677945044588987, 2.23606797749979
137, 80, 180, 134, 182, 135, -2, -1, -2.677945044588987, 2.23606797749979
137, 83, 88, 199, 90, 201, -2, -2, -2.356194490192345, 2.8284271247461903
137, 85, 578, 198, 579, 200, -1, -2, -2.0344439357957027, 2.23606797749979
137, 87, 277, 365, 280, 366, -3, -1, -2.819842099193151, 3.1622776601683795
137, 90, 84, 276, 86, 276, -2, 0, 3.141592653589793, 2.0
137, 91, 275, 148, 279, 149, -4, -1, -2.896613990462929, 4.123105625617661
137, 93, 171, 196, 177, 199, -6, -3, -2.677945044588987, 6.708203932499369
137, 94, 582, 231, 582, 235, 0, -4, -1.5707963267948966, 4.0
137, 95, 102, 166, 106, 168, -4, -2, -2.677945044588987, 4.47213595499958
137, 96, 71, 317, 73, 318, -2, -1, -2.677945044588987, 2.23606797749979
137, 97, 140, 263, 142, 264, -2, -1, -2.677945044588987, 2.23606797749979
137, 98, 115, 268, 122, 270, -7, -2, -2.8632929945846817, 7.280109889280518
137, 101, 235, 142, 239, 143, -4, -1, -2.896613990462929, 4.123105625617661
137, 104, 179, 143, 182, 144, -3, -1, -2.819842099193151, 3.1622776601683795
138, 0, 276, 138, 278, 139, -2, -1, -2.677945044588987, 2.23606797749979
138, 4, 536, 363, 535, 364, 1, -1, -0.7853981633974483, 1.4142135623730951
138, 5, 162, 145, 166, 147, -4, -2, -2.677945044588987, 4.47213595499958
138, 11, 112, 124, 114, 125, -2, -1, -2.677945044588987, 2.23606797749979
138, 12, 293, 216, 296, 218, -3, -2, -2.5535900500422257, 3.605551275463989
138, 15, 133, 282, 138, 284, -5, -2, -2.761086276477428, 5.385164807134504
138, 18, 192, 154, 195, 155, -3, -1, -2.819842099193151, 3.1622776601683795
138, 20, 261, 359, 264, 361, -3, -2, -2.5535900500422257, 3.605551275463989
138, 22, 312, 363, 315, 364, -3, -1, -2.819842099193151, 3.1622776601683795
138, 26, 331, 363, 332, 365, -1, -2, -2.0344439357957027, 2.23606797749979
138, 32, 304, 234, 307, 235, -3, -1, -2.819842099193151, 3.1622776601683795
138, 35, 350, 127, 352, 128, -2, -1, -2.677945044588987, 2.23606797749979
138, 40, 233, 213, 234, 215, -1, -2, -2.0344439357957027, 2.23606797749979
138, 42, 425, 368, 427, 369, -2, -1, -2.677945044588987, 2.23606797749979
138, 43, 210, 294, 214, 295, -4, -1, -2.896613990462929, 4.123105625617661
138, 44, 204, 123, 205, 122, -1, 1, 2.356194490192345, 1.4142135623730951
138, 53, 592, 270, 592, 272, 0, -2, -1.5707963267948966, 2.0
138, 54, 100, 232, 103, 232, -3, 0, 3.141592653589793, 3.0
138, 55, 56, 170, 55, 171, 1, -1, -0.7853981633974483, 1.4142135623730951
138, 58, 230, 124, 232, 125, -2, -1, -2.677945044588987, 2.23606797749979
138, 61, 142, 116, 144, 116, -2, 0, 3.141592653589793, 2.0
138, 63, 256, 155, 258, 155, -2, 0, 3.141592653589793, 2.0
138, 65, 256, 122, 258, 123, -2, -1, -2.677945044588987, 2.23606797749979
138, 66, 177, 133, 180, 134, -3, -1, -2.819842099193151, 3.1622776601683795
138, 69, 85, 197, 88, 199, -3, -2, -2.5535900500422257, 3.605551275463989
138, 70, 181, 108, 183, 108, -2, 0, 3.141592653589793, 2.0
138, 71, 578, 196, 578, 198, 0, -2, -1.5707963267948966, 2.0
138, 73, 274, 364, 277, 365, -3, -1, -2.819842099193151, 3.1622776601683795
138, 76, 272, 147, 275, 148, -3, -1, -2.819842099193151, 3.1622776601683795
138, 78, 166, 193, 171, 196, -5, -3, -2.601173153319209, 5.830951894845301
138, 79, 581, 228, 582, 231, -1, -3, -1.892546881191539, 3.1622776601683795
138, 82, 138, 262, 140, 263, -2, -1, -2.677945044588987, 2.23606797749979
138, 83, 113, 264, 115, 268, -2, -4, -2.0344439357957027, 4.47213595499958
138, 85, 233, 141, 235, 142, -2, -1, -2.677945044588987, 2.23606797749979
138, 88, 177, 142, 179, 143, -2, -1, -2.677945044588987, 2.23606797749979
139, 0, 274, 137, 276, 138, -2, -1, -2.677945044588987, 2.23606797749979
139, 5, 159, 144, 162, 145, -3, -1, -2.819842099193151, 3.1622776601683795
139, 11, 110, 124, 112, 124, -2, 0, 3.141592653589793, 2.0
139, 12, 291, 214, 293, 216, -2, -2, -2.356194490192345, 2.8284271247461903
139, 14, 130, 278, 133, 282, -3, -4, -2.214297435588181, 5.0
139, 17, 190, 155, 192, 154, -2, 1, 2.677945044588987, 2.23606797749979
139, 19, 256, 358, 261, 359, -5, -1, -2.9441970937399127, 5.0990195135927845
139, 21, 309, 363, 312, 363, -3, 0, 3.141592653589793, 3.0
139, 24, 155, 117, 157, 118, -2, -1, -2.677945044588987, 2.23606797749979
139, 25, 328, 361, 331, 363, -3, -2, -2.5535900500422257, 3.605551275463989
139, 30, 301, 232, 304, 234, -3, -2, -2.5535900500422257, 3.605551275463989
139, 34, 230, 212, 233, 213, -3, -1, -2.819842099193151, 3.1622776601683795
139, 35, 422, 368, 425, 368, -3, 0, 3.141592653589793, 3.0
139, 36, 206, 293, 210, 294, -4, -1, -2.896613990462929, 4.123105625617661
139, 37, 202, 124, 204, 123, -2, 1, 2.677945044588987, 2.23606797749979
139, 39, 596, 201, 597, 203, -1, -2, -2.0344439357957027, 2.23606797749979
139, 45, 97, 230, 100, 232, -3, -2, -2.5535900500422257, 3.605551275463989
139, 52, 140, 116, 142, 116, -2, 0, 3.141592653589793, 2.0
139, 54, 253, 155, 256, 155, -3, 0, 3.141592653589793, 3.0
139, 56, 254, 121, 256, 122, -2, -1, -2.677945044588987, 2.23606797749979
139, 57, 174, 133, 177, 133, -3, 0, 3.141592653589793, 3.0
139, 60, 84, 195, 85, 197, -1, -2, -2.0344439357957027, 2.23606797749979
139, 62, 577, 194, 578, 196, -1, -2, -2.0344439357957027, 2.23606797749979
139, 63, 272, 363, 274, 364, -2, -1, -2.677945044588987, 2.23606797749979
139, 65, 270, 147, 272, 147, -2, 0, 3.141592653589793, 2.0
139, 67, 164, 192, 166, 193, -2, -1, -2.677945044588987, 2.23606797749979
139, 68, 581, 226, 581, 228, 0, -2, -1.5707963267948966, 2.0
139, 69, 101, 165, 102, 167, -1, -2, -2.0344439357957027, 2.23606797749979
139, 70, 68, 316, 70, 317, -2, -1, -2.677945044588987, 2.23606797749979
139, 71, 136, 261, 138, 262, -2, -1, -2.677945044588987, 2.23606797749979
139, 72, 108, 262, 113, 264, -5, -2, -2.761086276477428, 5.385164807134504
139, 74, 231, 140, 233, 141, -2, -1, -2.677945044588987, 2.23606797749979
139, 77, 174, 142, 177, 142, -3, 0, 3.141592653589793, 3.0
140, 3, 400, 134, 402, 135, -2, -1, -2.677945044588987, 2.23606797749979
140, 7, 280, 142, 282, 143, -2, -1, -2.677945044588987, 2.23606797749979
140, 8, 79, 337, 78, 336, 1, 1, 0.7853981633974483, 1.4142135623730951
140, 12, 162, 146, 167, 148, -5, -2, -2.761086276477428, 5.385164807134504
140, 15, 130, 284, 136, 285, -6, -1, -2.976443976175166, 6.082762530298219
140, 16, 383, 139, 385, 140, -2, -1, -2.677945044588987, 2.23606797749979
140, 21, 158, 118, 160, 119, -2, -1, -2.677945044588987, 2.23606797749979
140, 26, 258, 124, 260, 124, -2, 0, 3.141592653589793, 2.0
140, 30, 292, 214, 297, 218, -5, -4, -2.4668517113662407, 6.4031242374328485
140, 34, 83, 276, 85, 277, -2, -1, -2.677945044588987, 2.23606797749979
140, 45, 57, 296, 56, 297, 1, -1, -0.7853981633974483, 1.4142135623730951
140, 46, 266, 368, 269, 368, -3, 0, 3.141592653589793, 3.0
140, 48, 106, 367, 105, 368, 1, -1, -0.7853981633974483, 1.4142135623730951
140, 49, 228, 214, 235, 217, -7, -3, -2.7367008673047097, 7.615773105863909
140, 58, 352, 129, 354, 130, -2, -1, -2.677945044588987, 2.23606797749979
140, 59, 233, 126, 235, 126, -2, 0, 3.141592653589793, 2.0
140, 66, 426, 368, 429, 368, -3, 0, 3.141592653589793, 3.0
140, 68, 602, 341, 600, 342, 2, -1, -0.4636476090008061, 2.23606797749979
140, 69, 330, 367, 335, 367, -5, 0, 3.141592653589793, 5.0
140, 70, 96, 232, 104, 234, -8, -2, -2.896613990462929, 8.246211251235321
140, 71, 594, 145, 594, 147, 0, -2, -1.5707963267948966, 2.0
140, 73, 278, 126, 280, 126, -2, 0, 3.141592653589793, 2.0
140, 74, 311, 368, 317, 368, -6, 0, 3.141592653589793, 6.0
140, 75, 208, 295, 215, 296, -7, -1, -2.999695598985629, 7.0710678118654755
140, 79, 174, 119, 176, 119, -2, 0, 3.141592653589793, 2.0
140, 81, 208, 118, 210, 118, -2, 0, 3.141592653589793, 2.0
140, 82, 181, 134, 183, 136, -2, -2, -2.356194490192345, 2.8284271247461903
140, 86, 193, 152, 199, 155, -6, -3, -2.677945044588987, 6.708203932499369
140, 90, 580, 162, 580, 165, 0, -3, -1.5707963267948966, 3.0
140, 97, 574, 195, 575, 197, -1, -2, -2.0344439357957027, 2.23606797749979
140, 98, 204, 125, 207, 126, -3, -1, -2.819842099193151, 3.1622776601683795
140, 100, 302, 231, 305, 233, -3, -2, -2.5535900500422257, 3.605551275463989
140, 103, 75, 327, 78, 328, -3, -1, -2.819842099193151, 3.1622776601683795
140, 107, 94, 168, 96, 168, -2, 0, 3.141592653589793, 2.0
140, 108, 277, 366, 280, 367, -3, -1, -2.819842099193151, 3.1622776601683795
140, 109, 183, 108, 185, 109, -2, -1, -2.677945044588987, 2.23606797749979
140, 110, 57, 331, 59, 332, -2, -1, -2.677945044588987, 2.23606797749979
140, 113, 146, 150, 152, 151, -6, -1, -2.976443976175166, 6.082762530298219
140, 116, 260, 157, 262, 157, -2, 0, 3.141592653589793, 2.0
140, 120, 355, 137, 357, 138, -2, -1, -2.677945044588987, 2.23606797749979
140, 122, 167, 195, 171, 197, -4, -2, -2.677945044588987, 4.47213595499958
140, 125, 108, 234, 111, 234, -3, 0, 3.141592653589793, 3.0
140, 127, 142, 249, 148, 251, -6, -2, -2.819842099193151, 6.324555320336759
140, 129, 298, 154, 301, 156, -3, -2, -2.5535900500422257, 3.605551275463989
140, 132, 257, 135, 260, 136, -3, -1, -2.819842099193151, 3.1622776601683795
140, 135, 206, 365, 209, 366, -3, -1, -2.819842099193151, 3.1622776601683795
140, 138, 246, 256, 249, 256, -3, 0, 3.141592653589793, 3.0
140, 139, 584, 231, 583, 234, 1, -3, -1.2490457723982544, 3.1622776601683795
140, 144, 123, 269, 125, 268, -2, 1, 2.677945044588987, 2.23606797749979
140, 145, 590, 202, 590, 204, 0, -2, -1.5707963267948966, 2.0
140, 146, 251, 220, 257, 224, -6, -4, -2.5535900500422257, 7.211102550927978
140, 147, 130, 261, 133, 262, -3, -1, -2.819842099193151, 3.1622776601683795
140, 150, 93, 338, 94, 340, -1, -2, -2.0344439357957027, 2.23606797749979
140, 151, 176, 154, 180, 156, -4, -2, -2.677945044588987, 4.47213595499958
140, 152, 73, 265, 76, 265, -3, 0, 3.141592653589793, 3.0
141, 6, 278, 141, 280, 142, -2, -1, -2.677945044588987, 2.23606797749979
141, 9, 41, 267, 41, 269, 0, -2, -1.5707963267948966, 2.0
141, 11, 157, 144, 162, 146, -5, -2, -2.761086276477428, 5.385164807134504
141, 14, 125, 283, 130, 284, -5, -1, -2.9441970937399127, 5.0990195135927845
141, 15, 381, 138, 383, 139, -2, -1, -2.677945044588987, 2.23606797749979
141, 19, 156, 117, 158, 118, -2, -1, -2.677945044588987, 2.23606797749979
141, 24, 256, 124, 258, 124, -2, 0, 3.141592653589793, 2.0
141, 27, 287, 211, 292, 214, -5, -3, -2.601173153319209, 5.830951894845301
141, 31, 114, 125, 116, 126, -2, -1, -2.677945044588987, 2.23606797749979
141, 39, 264, 368, 266, 368, -2, 0, 3.141592653589793, 2.0
141, 42, 223, 211, 228, 214, -5, -3, -2.601173153319209, 5.830951894845301
141, 50, 231, 125, 233, 126, -2, -1, -2.677945044588987, 2.23606797749979
141, 54, 422, 367, 426, 368, -4, -1, -2.896613990462929, 4.123105625617661
141, 57, 324, 366, 330, 367, -6, -1, -2.976443976175166, 6.082762530298219
141, 58, 91, 230, 96, 232, -5, -2, -2.761086276477428, 5.385164807134504
141, 60, 276, 125, 278, 126, -2, -1, -2.677945044588987, 2.23606797749979
141, 61, 305, 368, 311, 368, -6, 0, 3.141592653589793, 6.0
141, 62, 205, 296, 208, 295, -3, 1, 2.819842099193151, 3.1622776601683795
141, 64, 172, 118, 174, 119, -2, -1, -2.677945044588987, 2.23606797749979
141, 66, 206, 118, 208, 118, -2, 0, 3.141592653589793, 2.0
141, 67, 179, 133, 181, 134, -2, -1, -2.677945044588987, 2.23606797749979
141, 70, 190, 151, 193, 152, -3, -1, -2.819842099193151, 3.1622776601683795
141, 74, 579, 160, 580, 162, -1, -2, -2.0344439357957027, 2.23606797749979
141, 78, 143, 117, 145, 117, -2, 0, 3.141592653589793, 2.0
141, 80, 573, 192, 574, 195, -1, -3, -1.892546881191539, 3.1622776601683795
141, 81, 202, 124, 204, 125, -2, -1, -2.677945044588987, 2.23606797749979
141, 83, 297, 228, 302, 231, -5, -3, -2.601173153319209, 5.830951894845301
141, 86, 73, 327, 75, 327, -2, 0, 3.141592653589793, 2.0
141, 89, 275, 365, 277, 366, -2, -1, -2.677945044588987, 2.23606797749979
141, 93, 142, 150, 146, 150, -4, 0, 3.141592653589793, 4.0
141, 97, 162, 193, 167, 195, -5, -2, -2.761086276477428, 5.385164807134504
141, 100, 104, 234, 108, 234, -4, 0, 3.141592653589793, 4.0
141, 102, 135, 246, 142, 249, -7, -3, -2.7367008673047097, 7.615773105863909
141, 104, 296, 152, 298, 154, -2, -2, -2.356194490192345, 2.8284271247461903
141, 105, 254, 134, 257, 135, -3, -1, -2.819842099193151, 3.1622776601683795
141, 108, 203, 364, 206, 365, -3, -1, -2.819842099193151, 3.1622776601683795
141, 111, 243, 254, 246, 256, -3, -2, -2.5535900500422257, 3.605551275463989
141, 112, 584, 228, 584, 231, 0, -3, -1.5707963267948966, 3.0
141, 115, 120, 271, 123, 269, -3, 2, 2.5535900500422257, 3.605551275463989
141, 116, 245, 216, 251, 220, -6, -4, -2.5535900500422257, 7.211102550927978
141, 117, 128, 260, 130, 261, -2, -1, -2.677945044588987, 2.23606797749979
141, 118, 192, 304, 194, 304, -2, 0, 3.141592653589793, 2.0
141, 119, 91, 337, 93, 338, -2, -1, -2.677945044588987, 2.23606797749979
141, 120, 172, 152, 176, 154, -4, -2, -2.677945044588987, 4.47213595499958
142, 5, 276, 140, 278, 141, -2, -1, -2.677945044588987, 2.23606797749979
142, 9, 155, 143, 157, 144, -2, -1, -2.677945044588987, 2.23606797749979
142, 12, 120, 282, 125, 283, -5, -1, -2.9441970937399127, 5.0990195135927845
142, 17, 154, 116, 156, 117, -2, -1, -2.677945044588987, 2.23606797749979
142, 22, 254, 124, 256, 124, -2, 0, 3.141592653589793, 2.0
142, 25, 283, 209, 287, 211, -4, -2, -2.677945044588987, 4.47213595499958
142, 30, 240, 117, 242, 117, -2, 0, 3.141592653589793, 2.0
142, 35, 261, 368, 264, 368, -3, 0, 3.141592653589793, 3.0
142, 38, 220, 209, 223, 211, -3, -2, -2.5535900500422257, 3.605551275463989
142, 45, 229, 124, 231, 125, -2, -1, -2.677945044588987, 2.23606797749979
142, 49, 419, 366, 422, 367, -3, -1, -2.819842099193151, 3.1622776601683795
142, 51, 319, 366, 324, 366, -5, 0, 3.141592653589793, 5.0
142, 52, 87, 229, 91, 230, -4, -1, -2.896613990462929, 4.123105625617661
142, 54, 274, 124, 276, 125, -2, -1, -2.677945044588987, 2.23606797749979
142, 55, 302, 368, 305, 368, -3, 0, 3.141592653589793, 3.0
142, 56, 199, 294, 205, 296, -6, -2, -2.819842099193151, 6.324555320336759
142, 57, 170, 118, 172, 118, -2, 0, 3.141592653589793, 2.0
142, 60, 177, 132, 179, 133, -2, -1, -2.677945044588987, 2.23606797749979
142, 63, 187, 150, 190, 151, -3, -1, -2.819842099193151, 3.1622776601683795
142, 64, 99, 165, 100, 164, -1, 1, 2.356194490192345, 1.4142135623730951
142, 70, 141, 117, 143, 117, -2, 0, 3.141592653589793, 2.0
142, 72, 572, 189, 573, 192, -1, -3, -1.892546881191539, 3.1622776601683795
142, 75, 294, 226, 297, 228, -3, -2, -2.5535900500422257, 3.605551275463989
142, 78, 69, 327, 73, 327, -4, 0, 3.141592653589793, 4.0
142, 81, 272, 365, 275, 365, -3, 0, 3.141592653589793, 3.0
142, 84, 139, 149, 142, 150, -3, -1, -2.819842099193151, 3.1622776601683795
142, 88, 156, 190, 162, 193, -6, -3, -2.677945044588987, 6.708203932499369
142, 90, 100, 232, 104, 234, -4, -2, -2.677945044588987, 4.47213595499958
142, 92, 129, 245, 135, 246, -6, -1, -2.976443976175166, 6.082762530298219
142, 94, 294, 150, 296, 152, -2, -2, -2.356194490192345, 2.8284271247461903
142, 95, 252, 133, 254, 134, -2, -1, -2.677945044588987, 2.23606797749979
142, 98, 201, 364, 203, 364, -2, 0, 3.141592653589793, 2.0
142, 101, 241, 254, 243, 254, -2, 0, 3.141592653589793, 2.0
142, 102, 585, 225, 584, 228, 1, -3, -1.2490457723982544, 3.1622776601683795
142, 104, 115, 270, 120, 271, -5, -1, -2.9441970937399127, 5.0990195135927845
142, 105, 242, 213, 245, 216, -3, -3, -2.356194490192345, 4.242640687119285
142, 106, 126, 260, 128, 260, -2, 0, 3.141592653589793, 2.0
142, 107, 190, 303, 192, 304, -2, -1, -2.677945044588987, 2.23606797749979
142, 108, 169, 151, 172, 152, -3, -1, -2.819842099193151, 3.1622776601683795
143, 8, 152, 141, 155, 143, -3, -2, -2.5535900500422257, 3.605551275463989
143, 11, 114, 280, 120, 282, -6, -2, -2.819842099193151, 6.324555320336759
143, 12, 378, 138, 380, 138, -2, 0, 3.141592653589793, 2.0
143, 20, 252, 123, 254, 124, -2, -1, -2.677945044588987, 2.23606797749979
143, 22, 280, 207, 283, 209, -3, -2, -2.5535900500422257, 3.605551275463989
143, 24, 111, 124, 113, 125, -2, -1, -2.677945044588987, 2.23606797749979
143, 30, 259, 368, 261, 368, -2, 0, 3.141592653589793, 2.0
143, 33, 217, 207, 220, 209, -3, -2, -2.5535900500422257, 3.605551275463989
143, 43, 415, 366, 419, 366, -4, 0, 3.141592653589793, 4.0
143, 46, 84, 227, 87, 229, -3, -2, -2.5535900500422257, 3.605551275463989
143, 48, 272, 123, 274, 124, -2, -1, -2.677945044588987, 2.23606797749979
143, 49, 298, 367, 302, 368, -4, -1, -2.896613990462929, 4.123105625617661
143, 50, 192, 293, 199, 294, -7, -1, -2.999695598985629, 7.0710678118654755
143, 51, 168, 118, 170, 118, -2, 0, 3.141592653589793, 2.0
143, 53, 203, 117, 205, 118, -2, -1, -2.677945044588987, 2.23606797749979
143, 54, 175, 131, 177, 132, -2, -1, -2.677945044588987, 2.23606797749979
143, 56, 182, 148, 187, 150, -5, -2, -2.761086276477428, 5.385164807134504
143, 59, 579, 157, 579, 159, 0, -2, -1.5707963267948966, 2.0
143, 61, 77, 314, 76, 315, 1, -1, -0.7853981633974483, 1.4142135623730951
143, 64, 573, 186, 572, 189, 1, -3, -1.2490457723982544, 3.1622776601683795
143, 66, 288, 223, 294, 226, -6, -3, -2.677945044588987, 6.708203932499369
143, 71, 270, 365, 272, 365, -2, 0, 3.141592653589793, 2.0
143, 74, 137, 149, 139, 149, -2, 0, 3.141592653589793, 2.0
143, 78, 150, 190, 156, 190, -6, 0, 3.141592653589793, 6.0
143, 80, 96, 231, 100, 232, -4, -1, -2.896613990462929, 4.123105625617661
143, 85, 250, 132, 252, 133, -2, -1, -2.677945044588987, 2.23606797749979
143, 91, 239, 254, 241, 254, -2, 0, 3.141592653589793, 2.0
143, 92, 585, 223, 585, 225, 0, -2, -1.5707963267948966, 2.0
143, 94, 110, 268, 115, 270, -5, -2, -2.761086276477428, 5.385164807134504
143, 95, 242, 210, 242, 213, 0, -3, -1.5707963267948966, 3.0
143, 96, 123, 259, 126, 260, -3, -1, -2.819842099193151, 3.1622776601683795
143, 97, 188, 302, 190, 303, -2, -1, -2.677945044588987, 2.23606797749979
143, 98, 164, 150, 169, 151, -5, -1, -2.9441970937399127, 5.0990195135927845
144, 6, 150, 140, 152, 141, -2, -1, -2.677945044588987, 2.23606797749979
144, 8, 109, 279, 114, 280, -5, -1, -2.9441970937399127, 5.0990195135927845
144, 17, 250, 122, 252, 123, -2, -1, -2.677945044588987, 2.23606797749979
144, 19, 277, 206, 280, 207, -3, -1, -2.819842099193151, 3.1622776601683795
144, 25, 256, 366, 259, 368, -3, -2, -2.5535900500422257, 3.605551275463989
144, 28, 214, 205, 217, 207, -3, -2, -2.5535900500422257, 3.605551275463989
144, 34, 226, 123, 228, 124, -2, -1, -2.677945044588987, 2.23606797749979
144, 39, 316, 366, 318, 366, -2, 0, 3.141592653589793, 2.0
144, 41, 295, 367, 298, 367, -3, 0, 3.141592653589793, 3.0
144, 42, 189, 292, 192, 293, -3, -1, -2.819842099193151, 3.1622776601683795
144, 43, 166, 117, 168, 118, -2, -1, -2.677945044588987, 2.23606797749979
144, 45, 173, 131, 175, 131, -2, 0, 3.141592653589793, 2.0
144, 47, 180, 147, 182, 148, -2, -1, -2.677945044588987, 2.23606797749979
144, 53, 572, 184, 573, 186, -1, -2, -2.0344439357957027, 2.23606797749979
144, 55, 286, 222, 288, 223, -2, -1, -2.677945044588987, 2.23606797749979
144, 60, 268, 365, 270, 365, -2, 0, 3.141592653589793, 2.0
144, 62, 135, 148, 137, 149, -2, -1, -2.677945044588987, 2.23606797749979
144, 68, 90, 228, 96, 231, -6, -3, -2.677945044588987, 6.708203932499369
144, 70, 122, 245, 128, 245, -6, 0, 3.141592653589793, 6.0
144, 72, 247, 132, 250, 132, -3, 0, 3.141592653589793, 3.0
144, 76, 237, 254, 239, 254, -2, 0, 3.141592653589793, 2.0
144, 77, 585, 221, 585, 223, 0, -2, -1.5707963267948966, 2.0
144, 78, 104, 266, 110, 268, -6, -2, -2.819842099193151, 6.324555320336759
144, 79, 240, 209, 242, 210, -2, -1, -2.677945044588987, 2.23606797749979
144, 80, 120, 258, 123, 259, -3, -1, -2.819842099193151, 3.1622776601683795
144, 81, 185, 302, 188, 302, -3, 0, 3.141592653589793, 3.0
144, 82, 161, 148, 164, 150, -3, -2, -2.5535900500422257, 3.605551275463989
145, 1, 276, 141, 278, 142, -2, -1, -2.677945044588987, 2.23606797749979
145, 6, 90, 346, 89, 347, 1, -1, -0.7853981633974483, 1.4142135623730951
145, 8, 155, 144, 159, 146, -4, -2, -2.677945044588987, 4.47213595499958
145, 9, 152, 117, 154, 118, -2, -1, -2.677945044588987, 2.23606797749979
145, 12, 382, 138, 384, 139, -2, -1, -2.677945044588987, 2.23606797749979
145, 18, 94, 166, 93, 165, 1, 1, 0.7853981633974483, 1.4142135623730951
145, 35, 262, 364, 265, 364, -3, 0, 3.141592653589793, 3.0
145, 36, 140, 117, 142, 118, -2, -1, -2.677945044588987, 2.23606797749979
145, 37, 113, 283, 119, 284, -6, -1, -2.976443976175166, 6.082762530298219
145, 40, 88, 333, 89, 335, -1, -2, -2.0344439357957027, 2.23606797749979
145, 45, 87, 227, 91, 229, -4, -2, -2.677945044588987, 4.47213595499958
145, 55, 418, 368, 422, 369, -4, -1, -2.896613990462929, 4.123105625617661
145, 56, 169, 151, 172, 152, -3, -1, -2.819842099193151, 3.1622776601683795
145, 57, 574, 189, 574, 191, 0, -2, -1.5707963267948966, 2.0
145, 60, 580, 194, 580, 196, 0, -2, -1.5707963267948966, 2.0
145, 62, 192, 289, 199, 292, -7, -3, -2.7367008673047097, 7.615773105863909
145, 66, 200, 366, 203, 366, -3, 0, 3.141592653589793, 3.0
145, 67, 584, 244, 585, 246, -1, -2, -2.0344439357957027, 2.23606797749979
145, 68, 271, 366, 273, 366, -2, 0, 3.141592653589793, 2.0
145, 69, 229, 141, 231, 141, -2, 0, 3.141592653589793, 2.0
145, 72, 82, 198, 82, 200, 0, -2, -1.5707963267948966, 2.0
145, 76, 170, 120, 172, 120, -2, 0, 3.141592653589793, 2.0
145, 79, 277, 204, 282, 207, -5, -3, -2.601173153319209, 5.830951894845301
145, 87, 181, 147, 187, 150, -6, -3, -2.677945044588987, 6.708203932499369
145, 88, 284, 221, 290, 226, -6, -5, -2.44685437739309, 7.810249675906654
145, 91, 96, 269, 103, 271, -7, -2, -2.8632929945846817, 7.280109889280518
145, 101, 87, 234, 89, 237, -2, -3, -2.158798930342464, 3.605551275463989
145, 103, 174, 133, 177, 134, -3, -1, -2.819842099193151, 3.1622776601683795
145, 106, 585, 225, 584, 227, 1, -2, -1.1071487177940904, 2.23606797749979
145, 107, 214, 205, 220, 208, -6, -3, -2.677945044588987, 6.708203932499369
145, 109, 270, 151, 273, 152, -3, -1, -2.819842099193151, 3.1622776601683795
145, 122, 237, 213, 243, 216, -6, -3, -2.677945044588987, 6.708203932499369
145, 129, 318, 366, 324, 367, -6, -1, -2.976443976175166, 6.082762530298219
145, 130, 295, 154, 297, 155, -2, -1, -2.677945044588987, 2.23606797749979
145, 133, 174, 143, 176, 144, -2, -1, -2.677945044588987, 2.23606797749979
145, 134, 568, 196, 568, 199, 0, -3, -1.5707963267948966, 3.0
145, 138, 254, 155, 257, 156, -3, -1, -2.819842099193151, 3.1622776601683795
145, 139, 154, 187, 157, 189, -3, -2, -2.5535900500422257, 3.605551275463989
145, 146, 190, 364, 192, 364, -2, 0, 3.141592653589793, 2.0
145, 148, 302, 366, 307, 367, -5, -1, -2.9441970937399127, 5.0990195135927845
145, 150, 339, 151, 341, 151, -2, 0, 3.141592653589793, 2.0
145, 151, 118, 145, 120, 146, -2, -1, -2.677945044588987, 2.23606797749979
145, 152, 113, 255, 117, 256, -4, -1, -2.896613990462929, 4.123105625617661
145, 156, 149, 342, 150, 344, -1, -2, -2.0344439357957027, 2.23606797749979
145, 164, 125, 282, 129, 283, -4, -1, -2.896613990462929, 4.123105625617661
145, 166, 180, 155, 185, 157, -5, -2, -2.761086276477428, 5.385164807134504
145, 167, 138, 130, 140, 131, -2, -1, -2.677945044588987, 2.23606797749979
145, 168, 252, 137, 254, 137, -2, 0, 3.141592653589793, 2.0
146, 1, 274, 140, 276, 141, -2, -1, -2.677945044588987, 2.23606797749979
146, 7, 152, 143, 155, 144, -3, -1, -2.819842099193151, 3.1622776601683795
146, 8, 150, 116, 152, 117, -2, -1, -2.677945044588987, 2.23606797749979
146, 11, 381, 139, 382, 138, -1, 1, 2.356194490192345, 1.4142135623730951
146, 29, 259, 363, 262, 364, -3, -1, -2.819842099193151, 3.1622776601683795
146, 30, 105, 282, 113, 283, -8, -1, -3.017237659043032, 8.06225774829855
146, 32, 204, 118, 206, 119, -2, -1, -2.677945044588987, 2.23606797749979
146, 36, 84, 226, 87, 227, -3, -1, -2.819842099193151, 3.1622776601683795
146, 43, 414, 368, 418, 368, -4, 0, 3.141592653589793, 4.0
146, 44, 166, 150, 169, 151, -3, -1, -2.819842099193151, 3.1622776601683795
146, 45, 574, 187, 574, 189, 0, -2, -1.5707963267948966, 2.0
146, 47, 580, 192, 580, 194, 0, -2, -1.5707963267948966, 2.0
146, 48, 185, 287, 192, 289, -7, -2, -2.8632929945846817, 7.280109889280518
146, 52, 198, 366, 200, 366, -2, 0, 3.141592653589793, 2.0
146, 53, 583, 242, 584, 244, -1, -2, -2.0344439357957027, 2.23606797749979
146, 54, 269, 366, 271, 366, -2, 0, 3.141592653589793, 2.0
146, 55, 227, 141, 229, 141, -2, 0, 3.141592653589793, 2.0
146, 57, 82, 196, 82, 198, 0, -2, -1.5707963267948966, 2.0
146, 62, 273, 202, 277, 204, -4, -2, -2.677945044588987, 4.47213595499958
146, 63, 219, 136, 221, 137, -2, -1, -2.677945044588987, 2.23606797749979
146, 70, 176, 145, 181, 147, -5, -2, -2.761086276477428, 5.385164807134504
146, 71, 280, 219, 284, 221, -4, -2, -2.677945044588987, 4.47213595499958
146, 74, 90, 267, 96, 269, -6, -2, -2.819842099193151, 6.324555320336759
146, 81, 84, 232, 87, 234, -3, -2, -2.5535900500422257, 3.605551275463989
146, 82, 130, 105, 132, 106, -2, -1, -2.677945044588987, 2.23606797749979
146, 83, 171, 132, 174, 133, -3, -1, -2.819842099193151, 3.1622776601683795
146, 86, 586, 223, 585, 225, 1, -2, -1.1071487177940904, 2.23606797749979
146, 87, 208, 203, 214, 205, -6, -2, -2.819842099193151, 6.324555320336759
146, 89, 268, 150, 270, 151, -2, -1, -2.677945044588987, 2.23606797749979
146, 100, 231, 208, 237, 213, -6, -5, -2.44685437739309, 7.810249675906654
146, 105, 313, 365, 318, 366, -5, -1, -2.9441970937399127, 5.0990195135927845
146, 106, 293, 153, 295, 154, -2, -1, -2.677945044588987, 2.23606797749979
146, 108, 172, 142, 174, 143, -2, -1, -2.677945044588987, 2.23606797749979
146, 109, 568, 193, 568, 196, 0, -3, -1.5707963267948966, 3.0
146, 113, 251, 154, 254, 155, -3, -1, -2.819842099193151, 3.1622776601683795
146, 114, 152, 186, 154, 187, -2, -1, -2.677945044588987, 2.23606797749979
146, 118, 188, 364, 190, 364, -2, 0, 3.141592653589793, 2.0
146, 120, 296, 365, 302, 366, -6, -1, -2.976443976175166, 6.082762530298219
146, 122, 337, 151, 339, 151, -2, 0, 3.141592653589793, 2.0
146, 123, 109, 255, 113, 255, -4, 0, 3.141592653589793, 4.0
146, 126, 146, 342, 149, 342, -3, 0, 3.141592653589793, 3.0
146, 132, 336, 181, 335, 182, 1, -1, -0.7853981633974483, 1.4142135623730951
146, 133, 120, 281, 125, 282, -5, -1, -2.9441970937399127, 5.0990195135927845
146, 135, 176, 152, 180, 155, -4, -3, -2.498091544796509, 5.0
146, 136, 136, 130, 138, 130, -2, 0, 3.141592653589793, 2.0
146, 137, 250, 136, 252, 137, -2, -1, -2.677945044588987, 2.23606797749979
146, 138, 577, 353, 577, 355, 0, -2, -1.5707963267948966, 2.0
147, 1, 272, 139, 274, 140, -2, -1, -2.677945044588987, 2.23606797749979
147, 7, 149, 141, 152, 143, -3, -2, -2.5535900500422257, 3.605551275463989
147, 8, 147, 114, 150, 116, -3, -2, -2.5535900500422257, 3.605551275463989
147, 11, 379, 139, 381, 139, -2, 0, 3.141592653589793, 2.0
147, 13, 112, 124, 113, 126, -1, -2, -2.0344439357957027, 2.23606797749979
147, 24, 310, 115, 312, 116, -2, -1, -2.677945044588987, 2.23606797749979
147, 28, 256, 362, 259, 363, -3, -1, -2.819842099193151, 3.1622776601683795
147, 29, 101, 282, 105, 282, -4, 0, 3.141592653589793, 4.0
147, 31, 202, 117, 204, 118, -2, -1, -2.677945044588987, 2.23606797749979
147, 34, 82, 224, 84, 226, -2, -2, -2.356194490192345, 2.8284271247461903
147, 40, 411, 367, 414, 368, -3, -1, -2.819842099193151, 3.1622776601683795
147, 41, 164, 149, 166, 150, -2, -1, -2.677945044588987, 2.23606797749979
147, 42, 574, 185, 574, 187, 0, -2, -1.5707963267948966, 2.0
147, 44, 581, 191, 580, 192, 1, -1, -0.7853981633974483, 1.4142135623730951
147, 45, 180, 283, 185, 287, -5, -4, -2.4668517113662407, 6.4031242374328485
147, 49, 196, 366, 198, 366, -2, 0, 3.141592653589793, 2.0
147, 50, 582, 240, 583, 242, -1, -2, -2.0344439357957027, 2.23606797749979
147, 51, 266, 366, 269, 366, -3, 0, 3.141592653589793, 3.0
147, 52, 225, 140, 227, 141, -2, -1, -2.677945044588987, 2.23606797749979
147, 54, 83, 194, 82, 196, 1, -2, -1.1071487177940904, 2.23606797749979
147, 59, 270, 200, 273, 202, -3, -2, -2.5535900500422257, 3.605551275463989
147, 61, 337, 120, 339, 120, -2, 0, 3.141592653589793, 2.0
147, 64, 174, 144, 176, 145, -2, -1, -2.677945044588987, 2.23606797749979
147, 65, 276, 218, 280, 219, -4, -1, -2.896613990462929, 4.123105625617661
147, 68, 87, 267, 90, 267, -3, 0, 3.141592653589793, 3.0
147, 70, 64, 333, 66, 332, -2, 1, 2.677945044588987, 2.23606797749979
147, 74, 82, 230, 84, 232, -2, -2, -2.356194490192345, 2.8284271247461903
147, 76, 169, 131, 171, 132, -2, -1, -2.677945044588987, 2.23606797749979
147, 78, 587, 222, 586, 223, 1, -1, -0.7853981633974483, 1.4142135623730951
147, 79, 205, 203, 208, 203, -3, 0, 3.141592653589793, 3.0
147, 81, 265, 149, 268, 150, -3, -1, -2.819842099193151, 3.1622776601683795
147, 89, 227, 205, 231, 208, -4, -3, -2.498091544796509, 5.0
147, 94, 308, 364, 313, 365, -5, -1, -2.9441970937399127, 5.0990195135927845
147, 95, 290, 153, 293, 153, -3, 0, 3.141592653589793, 3.0
147, 97, 169, 141, 172, 142, -3, -1, -2.819842099193151, 3.1622776601683795
147, 101, 249, 153, 251, 154, -2, -1, -2.677945044588987, 2.23606797749979
147, 102, 150, 185, 152, 186, -2, -1, -2.677945044588987, 2.23606797749979
147, 105, 186, 364, 188, 364, -2, 0, 3.141592653589793, 2.0
147, 107, 292, 364, 296, 365, -4, -1, -2.896613990462929, 4.123105625617661
147, 109, 335, 151, 337, 151, -2, 0, 3.141592653589793, 2.0
147, 110, 106, 254, 109, 255, -3, -1, -2.819842099193151, 3.1622776601683795
147, 112, 525, 141, 525, 143, 0, -2, -1.5707963267948966, 2.0
147, 113, 144, 341, 146, 342, -2, -1, -2.677945044588987, 2.23606797749979
147, 119, 112, 279, 120, 281, -8, -2, -2.896613990462929, 8.246211251235321
147, 120, 498, 367, 497, 368, 1, -1, -0.7853981633974483, 1.4142135623730951
147, 121, 173, 151, 176, 152, -3, -1, -2.819842099193151, 3.1622776601683795
147, 122, 134, 128, 136, 130, -2, -2, -2.356194490192345, 2.8284271247461903
147, 123, 247, 135, 250, 136, -3, -1, -2.819842099193151, 3.1622776601683795
147, 124, 577, 351, 577, 353, 0, -2, -1.5707963267948966, 2.0
148, 5, 147, 139, 149, 141, -2, -2, -2.356194490192345, 2.8284271247461903
148, 23, 253, 361, 256, 362, -3, -1, -2.819842099193151, 3.1622776601683795
148, 24, 99, 282, 101, 282, -2, 0, 3.141592653589793, 2.0
148, 25, 200, 116, 202, 117, -2, -1, -2.677945044588987, 2.23606797749979
148, 27, 80, 223, 82, 224, -2, -1, -2.677945044588987, 2.23606797749979
148, 33, 407, 366, 411, 367, -4, -1, -2.896613990462929, 4.123105625617661
148, 34, 161, 148, 164, 149, -3, -1, -2.819842099193151, 3.1622776601683795
148, 36, 581, 189, 581, 191, 0, -2, -1.5707963267948966, 2.0
148, 37, 176, 282, 180, 283, -4, -1, -2.896613990462929, 4.123105625617661
148, 41, 194, 365, 196, 366, -2, -1, -2.677945044588987, 2.23606797749979
148, 42, 582, 238, 582, 240, 0, -2, -1.5707963267948966, 2.0
148, 43, 263, 365, 266, 366, -3, -1, -2.819842099193151, 3.1622776601683795
148, 48, 268, 199, 270, 200, -2, -1, -2.677945044588987, 2.23606797749979
148, 51, 172, 143, 174, 144, -2, -1, -2.677945044588987, 2.23606797749979
148, 52, 275, 216, 276, 218, -1, -2, -2.0344439357957027, 2.23606797749979
148, 54, 85, 266, 87, 267, -2, -1, -2.677945044588987, 2.23606797749979
148, 59, 81, 228, 82, 230, -1, -2, -2.0344439357957027, 2.23606797749979
148, 61, 167, 129, 169, 131, -2, -2, -2.356194490192345, 2.8284271247461903
148, 64, 203, 201, 205, 203, -2, -2, -2.356194490192345, 2.8284271247461903
148, 66, 263, 148, 265, 149, -2, -1, -2.677945044588987, 2.23606797749979
148, 70, 225, 204, 227, 205, -2, -1, -2.677945044588987, 2.23606797749979
148, 74, 303, 363, 308, 364, -5, -1, -2.9441970937399127, 5.0990195135927845
148, 75, 288, 152, 290, 153, -2, -1, -2.677945044588987, 2.23606797749979
148, 77, 167, 140, 169, 141, -2, -1, -2.677945044588987, 2.23606797749979
148, 81, 246, 153, 249, 153, -3, 0, 3.141592653589793, 3.0
148, 82, 148, 184, 150, 185, -2, -1, -2.677945044588987, 2.23606797749979
148, 85, 184, 364, 186, 364, -2, 0, 3.141592653589793, 2.0
148, 87, 289, 363, 292, 364, -3, -1, -2.819842099193151, 3.1622776601683795
148, 89, 332, 151, 335, 151, -3, 0, 3.141592653589793, 3.0
148, 90, 102, 253, 106, 254, -4, -1, -2.896613990462929, 4.123105625617661
148, 92, 525, 139, 525, 141, 0, -2, -1.5707963267948966, 2.0
148, 93, 142, 343, 144, 341, -2, 2, 2.356194490192345, 2.8284271247461903
148, 98, 106, 282, 112, 279, -6, 3, 2.677945044588987, 6.708203932499369
148, 100, 170, 150, 173, 151, -3, -1, -2.819842099193151, 3.1622776601683795
148, 101, 245, 134, 247, 135, -2, -1, -2.677945044588987, 2.23606797749979
149, 7, 376, 139, 378, 139, -2, 0, 3.141592653589793, 2.0
149, 20, 251, 359, 253, 361, -2, -2, -2.356194490192345, 2.8284271247461903
149, 21, 95, 281, 99, 282, -4, -1, -2.896613990462929, 4.123105625617661
149, 22, 198, 115, 200, 116, -2, -1, -2.677945044588987, 2.23606797749979
149, 24, 79, 221, 80, 223, -1, -2, -2.0344439357957027, 2.23606797749979
149, 30, 404, 366, 407, 366, -3, 0, 3.141592653589793, 3.0
149, 31, 158, 147, 161, 148, -3, -1, -2.819842099193151, 3.1622776601683795
149, 33, 582, 187, 581, 189, 1, -2, -1.1071487177940904, 2.23606797749979
149, 34, 174, 281, 176, 282, -2, -1, -2.677945044588987, 2.23606797749979
149, 38, 192, 364, 194, 365, -2, -1, -2.677945044588987, 2.23606797749979
149, 39, 583, 235, 582, 238, 1, -3, -1.2490457723982544, 3.1622776601683795
149, 40, 260, 365, 263, 365, -3, 0, 3.141592653589793, 3.0
149, 45, 265, 196, 268, 199, -3, -3, -2.356194490192345, 4.242640687119285
149, 47, 168, 142, 172, 143, -4, -1, -2.896613990462929, 4.123105625617661
149, 48, 272, 214, 275, 216, -3, -2, -2.5535900500422257, 3.605551275463989
149, 54, 127, 103, 129, 104, -2, -1, -2.677945044588987, 2.23606797749979
149, 56, 588, 218, 587, 221, 1, -3, -1.2490457723982544, 3.1622776601683795
149, 57, 200, 199, 203, 201, -3, -2, -2.5535900500422257, 3.605551275463989
149, 59, 258, 145, 263, 148, -5, -3, -2.601173153319209, 5.830951894845301
149, 62, 220, 204, 225, 204, -5, 0, 3.141592653589793, 5.0
149, 66, 300, 362, 303, 363, -3, -1, -2.819842099193151, 3.1622776601683795
149, 67, 286, 151, 288, 152, -2, -1, -2.677945044588987, 2.23606797749979
149, 69, 163, 139, 167, 140, -4, -1, -2.896613990462929, 4.123105625617661
149, 73, 244, 152, 246, 153, -2, -1, -2.677945044588987, 2.23606797749979
149, 74, 145, 183, 148, 184, -3, -1, -2.819842099193151, 3.1622776601683795
149, 77, 181, 364, 184, 364, -3, 0, 3.141592653589793, 3.0
149, 79, 286, 362, 289, 363, -3, -1, -2.819842099193151, 3.1622776601683795
149, 81, 329, 151, 332, 151, -3, 0, 3.141592653589793, 3.0
149, 82, 96, 251, 102, 253, -6, -2, -2.819842099193151, 6.324555320336759
149, 85, 136, 343, 142, 343, -6, 0, 3.141592653589793, 6.0
149, 88, 100, 280, 106, 282, -6, -2, -2.819842099193151, 6.324555320336759
149, 89, 499, 365, 498, 366, 1, -1, -0.7853981633974483, 1.4142135623730951
149, 90, 166, 149, 170, 150, -4, -1, -2.896613990462929, 4.123105625617661
149, 91, 239, 132, 245, 134, -6, -2, -2.819842099193151, 6.324555320336759
149, 92, 577, 348, 577, 350, 0, -2, -1.5707963267948966, 2.0
150, 11, 153, 111, 155, 113, -2, -2, -2.356194490192345, 2.8284271247461903
150, 19, 151, 146, 153, 147, -2, -1, -2.677945044588987, 2.23606797749979
150, 20, 89, 262, 93, 263, -4, -1, -2.896613990462929, 4.123105625617661
150, 22, 222, 131, 224, 132, -2, -1, -2.677945044588987, 2.23606797749979
150, 25, 202, 117, 204, 118, -2, -1, -2.677945044588987, 2.23606797749979
150, 35, 256, 364, 260, 365, -4, -1, -2.896613990462929, 4.123105625617661
150, 37, 238, 120, 240, 121, -2, -1, -2.677945044588987, 2.23606797749979
150, 40, 201, 125, 203, 126, -2, -1, -2.677945044588987, 2.23606797749979
150, 44, 98, 280, 102, 281, -4, -1, -2.896613990462929, 4.123105625617661
150, 46, 590, 236, 590, 239, 0, -3, -1.5707963267948966, 3.0
150, 48, 319, 120, 321, 121, -2, -1, -2.677945044588987, 2.23606797749979
150, 49, 463, 125, 462, 124, 1, 1, 0.7853981633974483, 1.4142135623730951
150, 54, 410, 368, 415, 369, -5, -1, -2.9441970937399127, 5.0990195135927845
150, 60, 223, 139, 225, 140, -2, -1, -2.677945044588987, 2.23606797749979
150, 61, 575, 191, 575, 193, 0, -2, -1.5707963267948966, 2.0
150, 68, 263, 196, 270, 201, -7, -5, -2.5213431676069717, 8.602325267042627
150, 69, 272, 138, 274, 138, -2, 0, 3.141592653589793, 2.0
150, 79, 249, 155, 252, 156, -3, -1, -2.819842099193151, 3.1622776601683795
150, 80, 174, 144, 177, 146, -3, -2, -2.5535900500422257, 3.605551275463989
150, 85, 271, 214, 276, 218, -5, -4, -2.4668517113662407, 6.4031242374328485
150, 88, 569, 348, 569, 350, 0, -2, -1.5707963267948966, 2.0
150, 91, 201, 198, 207, 203, -6, -5, -2.44685437739309, 7.810249675906654
150, 92, 89, 271, 91, 272, -2, -1, -2.677945044588987, 2.23606797749979
150, 93, 170, 133, 172, 134, -2, -1, -2.677945044588987, 2.23606797749979
150, 97, 172, 287, 179, 289, -7, -2, -2.8632929945846817, 7.280109889280518
150, 101, 100, 181, 105, 183, -5, -2, -2.761086276477428, 5.385164807134504
150, 106, 160, 149, 164, 149, -4, 0, 3.141592653589793, 4.0
150, 107, 306, 366, 311, 366, -5, 0, 3.141592653589793, 5.0
150, 110, 591, 222, 590, 223, 1, -1, -0.7853981633974483, 1.4142135623730951
150, 111, 189, 364, 191, 364, -2, 0, 3.141592653589793, 2.0
150, 115, 217, 242, 221, 243, -4, -1, -2.896613990462929, 4.123105625617661
150, 116, 251, 167, 255, 169, -4, -2, -2.677945044588987, 4.47213595499958
150, 118, 294, 365, 296, 366, -2, -1, -2.677945044588987, 2.23606797749979
150, 125, 277, 142, 279, 143, -2, -1, -2.677945044588987, 2.23606797749979
150, 126, 224, 205, 230, 208, -6, -3, -2.677945044588987, 6.708203932499369
150, 127, 247, 133, 249, 134, -2, -1, -2.677945044588987, 2.23606797749979
150, 128, 267, 365, 270, 366, -3, -1, -2.819842099193151, 3.1622776601683795
150, 130, 287, 156, 290, 157, -3, -1, -2.819842099193151, 3.1622776601683795
150, 131, 141, 183, 144, 184, -3, -1, -2.819842099193151, 3.1622776601683795
150, 135, 271, 126, 273, 127, -2, -1, -2.677945044588987, 2.23606797749979
150, 143, 132, 364, 131, 365, 1, -1, -0.7853981633974483, 1.4142135623730951
150, 146, 110, 237, 116, 239, -6, -2, -2.819842099193151, 6.324555320336759
150, 147, 130, 343, 134, 344, -4, -1, -2.896613990462929, 4.123105625617661
151, 10, 152, 109, 153, 111, -1, -2, -2.0344439357957027, 2.23606797749979
151, 17, 149, 145, 151, 146, -2, -1, -2.677945044588987, 2.23606797749979
151, 18, 86, 261, 89, 262, -3, -1, -2.819842099193151, 3.1622776601683795
151, 20, 220, 130, 222, 131, -2, -1, -2.677945044588987, 2.23606797749979
151, 23, 200, 116, 202, 117, -2, -1, -2.677945044588987, 2.23606797749979
151, 25, 541, 365, 540, 366, 1, -1, -0.7853981633974483, 1.4142135623730951
151, 27, 345, 114, 346, 116, -1, -2, -2.0344439357957027, 2.23606797749979
151, 32, 252, 363, 256, 364, -4, -1, -2.896613990462929, 4.123105625617661
151, 36, 95, 279, 98, 280, -3, -1, -2.819842099193151, 3.1622776601683795
151, 38, 589, 233, 590, 236, -1, -3, -1.892546881191539, 3.1622776601683795
151, 46, 407, 367, 410, 368, -3, -1, -2.819842099193151, 3.1622776601683795
151, 48, 251, 127, 253, 127, -2, 0, 3.141592653589793, 2.0
151, 51, 577, 350, 577, 352, 0, -2, -1.5707963267948966, 2.0
151, 52, 221, 138, 223, 139, -2, -1, -2.677945044588987, 2.23606797749979
151, 58, 258, 191, 263, 196, -5, -5, -2.356194490192345, 7.0710678118654755
151, 59, 270, 137, 272, 138, -2, -1, -2.677945044588987, 2.23606797749979
151, 66, 246, 155, 249, 155, -3, 0, 3.141592653589793, 3.0
151, 67, 172, 143, 174, 144, -2, -1, -2.677945044588987, 2.23606797749979
151, 72, 267, 212, 271, 214, -4, -2, -2.677945044588987, 4.47213595499958
151, 78, 196, 195, 201, 198, -5, -3, -2.601173153319209, 5.830951894845301
151, 79, 87, 270, 89, 271, -2, -1, -2.677945044588987, 2.23606797749979
151, 80, 168, 132, 170, 133, -2, -1, -2.677945044588987, 2.23606797749979
151, 84, 166, 286, 172, 287, -6, -1, -2.976443976175166, 6.082762530298219
151, 88, 97, 180, 100, 181, -3, -1, -2.819842099193151, 3.1622776601683795
151, 92, 158, 148, 160, 149, -2, -1, -2.677945044588987, 2.23606797749979
151, 93, 301, 366, 306, 366, -5, 0, 3.141592653589793, 5.0
151, 94, 72, 194, 71, 195, 1, -1, -0.7853981633974483, 1.4142135623730951
151, 96, 592, 221, 591, 222, 1, -1, -0.7853981633974483, 1.4142135623730951
151, 97, 187, 363, 189, 364, -2, -1, -2.677945044588987, 2.23606797749979
151, 100, 214, 242, 217, 242, -3, 0, 3.141592653589793, 3.0
151, 101, 248, 165, 251, 167, -3, -2, -2.5535900500422257, 3.605551275463989
151, 103, 292, 365, 294, 365, -2, 0, 3.141592653589793, 2.0
151, 109, 275, 141, 277, 142, -2, -1, -2.677945044588987, 2.23606797749979
151, 110, 218, 201, 224, 205, -6, -4, -2.5535900500422257, 7.211102550927978
151, 111, 245, 132, 247, 133, -2, -1, -2.677945044588987, 2.23606797749979
151, 112, 265, 364, 267, 365, -2, -1, -2.677945044588987, 2.23606797749979
151, 114, 284, 156, 287, 156, -3, 0, 3.141592653589793, 3.0
151, 115, 138, 182, 141, 183, -3, -1, -2.819842099193151, 3.1622776601683795
151, 123, 84, 291, 85, 293, -1, -2, -2.0344439357957027, 2.23606797749979
151, 128, 103, 234, 110, 237, -7, -3, -2.7367008673047097, 7.615773105863909
151, 129, 126, 342, 130, 343, -4, -1, -2.896613990462929, 4.123105625617661
152, 8, 77, 335, 79, 335, -2, 0, 3.141592653589793, 2.0
152, 14, 146, 144, 149, 145, -3, -1, -2.819842099193151, 3.1622776601683795
152, 15, 84, 261, 86, 261, -2, 0, 3.141592653589793, 2.0
152, 16, 218, 129, 220, 130, -2, -1, -2.677945044588987, 2.23606797749979
152, 26, 248, 363, 252, 363, -4, 0, 3.141592653589793, 4.0
152, 30, 589, 230, 589, 233, 0, -3, -1.5707963267948966, 3.0
152, 36, 403, 366, 407, 367, -4, -1, -2.896613990462929, 4.123105625617661
152, 44, 253, 188, 258, 191, -5, -3, -2.601173153319209, 5.830951894845301
152, 45, 268, 136, 270, 137, -2, -1, -2.677945044588987, 2.23606797749979
152, 52, 243, 154, 246, 155, -3, -1, -2.819842099193151, 3.1622776601683795
152, 53, 170, 142, 172, 143, -2, -1, -2.677945044588987, 2.23606797749979
152, 55, 263, 210, 267, 212, -4, -2, -2.677945044588987, 4.47213595499958
152, 58, 569, 345, 569, 347, 0, -2, -1.5707963267948966, 2.0
152, 61, 191, 193, 196, 195, -5, -2, -2.761086276477428, 5.385164807134504
152, 62, 85, 270, 87, 270, -2, 0, 3.141592653589793, 2.0
152, 63, 166, 132, 168, 132, -2, 0, 3.141592653589793, 2.0
152, 65, 159, 284, 166, 286, -7, -2, -2.8632929945846817, 7.280109889280518
152, 68, 95, 179, 97, 180, -2, -1, -2.677945044588987, 2.23606797749979
152, 72, 155, 147, 158, 148, -3, -1, -2.819842099193151, 3.1622776601683795
152, 73, 298, 366, 301, 366, -3, 0, 3.141592653589793, 3.0
152, 77, 185, 363, 187, 363, -2, 0, 3.141592653589793, 2.0
152, 80, 210, 240, 214, 242, -4, -2, -2.677945044588987, 4.47213595499958
152, 81, 245, 164, 248, 165, -3, -1, -2.819842099193151, 3.1622776601683795
152, 86, 273, 140, 275, 141, -2, -1, -2.677945044588987, 2.23606797749979
152, 87, 213, 198, 218, 201, -5, -3, -2.601173153319209, 5.830951894845301
152, 88, 243, 131, 245, 132, -2, -1, -2.677945044588987, 2.23606797749979
152, 89, 263, 363, 265, 364, -2, -1, -2.677945044588987, 2.23606797749979
152, 91, 281, 155, 284, 156, -3, -1, -2.819842099193151, 3.1622776601683795
152, 92, 134, 180, 138, 182, -4, -2, -2.677945044588987, 4.47213595499958
152, 98, 83, 289, 84, 291, -1, -2, -2.0344439357957027, 2.23606797749979
152, 101, 129, 362, 132, 363, -3, -1, -2.819842099193151, 3.1622776601683795
152, 103, 101, 232, 103, 234, -2, -2, -2.356194490192345, 2.8284271247461903
152, 104, 122, 342, 126, 342, -4, 0, 3.141592653589793, 4.0
153, 11, 144, 143, 146, 144, -2, -1, -2.677945044588987, 2.23606797749979
153, 13, 216, 128, 218, 129, -2, -1, -2.677945044588987, 2.23606797749979
153, 20, 244, 361, 248, 363, -4, -2, -2.677945044588987, 4.47213595499958
153, 23, 92, 278, 94, 279, -2, -1, -2.677945044588987, 2.23606797749979
153, 24, 588, 228, 589, 230, -1, -2, -2.0344439357957027, 2.23606797749979
153, 30, 400, 366, 403, 366, -3, 0, 3.141592653589793, 3.0
153, 31, 248, 127, 250, 127, -2, 0, 3.141592653589793, 2.0
153, 33, 578, 347, 577, 349, 1, -2, -1.1071487177940904, 2.23606797749979
153, 37, 247, 185, 253, 188, -6, -3, -2.677945044588987, 6.708203932499369
153, 38, 266, 135, 268, 136, -2, -1, -2.677945044588987, 2.23606797749979
153, 44, 240, 153, 243, 154, -3, -1, -2.819842099193151, 3.1622776601683795
153, 45, 168, 141, 170, 142, -2, -1, -2.677945044588987, 2.23606797749979
153, 47, 258, 207, 263, 210, -5, -3, -2.601173153319209, 5.830951894845301
153, 53, 188, 191, 191, 193, -3, -2, -2.5535900500422257, 3.605551275463989
153, 54, 164, 131, 166, 132, -2, -1, -2.677945044588987, 2.23606797749979
153, 56, 156, 281, 159, 284, -3, -3, -2.356194490192345, 4.242640687119285
153, 62, 152, 145, 155, 147, -3, -2, -2.5535900500422257, 3.605551275463989
153, 63, 296, 365, 298, 366, -2, -1, -2.677945044588987, 2.23606797749979
153, 66, 183, 363, 185, 363, -2, 0, 3.141592653589793, 2.0
153, 69, 207, 239, 210, 240, -3, -1, -2.819842099193151, 3.1622776601683795
153, 70, 242, 164, 245, 164, -3, 0, 3.141592653589793, 3.0
153, 71, 289, 364, 291, 365, -2, -1, -2.677945044588987, 2.23606797749979
153, 75, 271, 140, 273, 140, -2, 0, 3.141592653589793, 2.0
153, 76, 211, 197, 213, 198, -2, -1, -2.677945044588987, 2.23606797749979
153, 79, 54, 173, 55, 172, -1, 1, 2.356194490192345, 1.4142135623730951
153, 80, 277, 154, 281, 155, -4, -1, -2.896613990462929, 4.123105625617661
153, 81, 128, 178, 134, 180, -6, -2, -2.819842099193151, 6.324555320336759
153, 89, 128, 360, 129, 362, -1, -2, -2.0344439357957027, 2.23606797749979
153, 91, 99, 231, 101, 232, -2, -1, -2.677945044588987, 2.23606797749979
153, 92, 120, 341, 122, 342, -2, -1, -2.677945044588987, 2.23606797749979
154, 6, 529, 137, 528, 138, 1, -1, -0.7853981633974483, 1.4142135623730951
154, 9, 142, 143, 144, 143, -2, 0, 3.141592653589793, 2.0
154, 10, 81, 261, 83, 261, -2, 0, 3.141592653589793, 2.0
154, 11, 214, 127, 216, 128, -2, -1, -2.677945044588987, 2.23606797749979
154, 18, 240, 361, 244, 361, -4, 0, 3.141592653589793, 4.0
154, 26, 398, 366, 400, 366, -2, 0, 3.141592653589793, 2.0
154, 27, 246, 126, 248, 127, -2, -1, -2.677945044588987, 2.23606797749979
154, 30, 575, 186, 575, 188, 0, -2, -1.5707963267948966, 2.0
154, 33, 241, 183, 247, 185, -6, -2, -2.819842099193151, 6.324555320336759
154, 39, 238, 153, 240, 153, -2, 0, 3.141592653589793, 2.0
154, 40, 166, 140, 168, 141, -2, -1, -2.677945044588987, 2.23606797749979
154, 42, 256, 205, 258, 207, -2, -2, -2.356194490192345, 2.8284271247461903
154, 45, 569, 342, 569, 344, 0, -2, -1.5707963267948966, 2.0
154, 48, 185, 188, 188, 191, -3, -3, -2.356194490192345, 4.242640687119285
154, 49, 162, 130, 164, 131, -2, -1, -2.677945044588987, 2.23606797749979
154, 51, 153, 279, 156, 281, -3, -2, -2.5535900500422257, 3.605551275463989
154, 57, 150, 144, 152, 145, -2, -1, -2.677945044588987, 2.23606797749979
154, 58, 294, 365, 296, 365, -2, 0, 3.141592653589793, 2.0
154, 60, 591, 217, 592, 219, -1, -2, -2.0344439357957027, 2.23606797749979
154, 61, 181, 362, 183, 363, -2, -1, -2.677945044588987, 2.23606797749979
154, 64, 202, 237, 207, 239, -5, -2, -2.761086276477428, 5.385164807134504
154, 65, 240, 163, 242, 164, -2, -1, -2.677945044588987, 2.23606797749979
154, 66, 286, 363, 289, 364, -3, -1, -2.819842099193151, 3.1622776601683795
154, 69, 269, 139, 271, 140, -2, -1, -2.677945044588987, 2.23606797749979
154, 70, 209, 195, 211, 197, -2, -2, -2.356194490192345, 2.8284271247461903
154, 71, 240, 130, 242, 131, -2, -1, -2.677945044588987, 2.23606797749979
154, 72, 258, 361, 262, 363, -4, -2, -2.677945044588987, 4.47213595499958
154, 74, 274, 153, 277, 154, -3, -1, -2.819842099193151, 3.1622776601683795
154, 75, 124, 176, 128, 178, -4, -2, -2.677945044588987, 4.47213595499958
154, 83, 128, 358, 128, 360, 0, -2, -1.5707963267948966, 2.0
154, 85, 99, 229, 99, 231, 0, -2, -1.5707963267948966, 2.0
154, 86, 120, 339, 120, 341, 0, -2, -1.5707963267948966, 2.0
155, 12, 153, 146, 155, 147, -2, -1, -2.677945044588987, 2.23606797749979
155, 15, 145, 143, 147, 143, -2, 0, 3.141592653589793, 2.0
155, 21, 269, 139, 271, 140, -2, -1, -2.677945044588987, 2.23606797749979
155, 24, 219, 129, 220, 131, -1, -2, -2.0344439357957027, 2.23606797749979
155, 34, 592, 304, 592, 306, 0, -2, -1.5707963267948966, 2.0
155, 36, 393, 136, 395, 137, -2, -1, -2.677945044588987, 2.23606797749979
155, 37, 163, 131, 165, 131, -2, 0, 3.141592653589793, 2.0
155, 38, 172, 149, 174, 149, -2, 0, 3.141592653589793, 2.0
155, 42, 297, 366, 300, 366, -3, 0, 3.141592653589793, 3.0
155, 43, 290, 365, 292, 366, -2, -1, -2.677945044588987, 2.23606797749979
155, 55, 250, 188, 256, 192, -6, -4, -2.5535900500422257, 7.211102550927978
155, 66, 155, 284, 162, 286, -7, -2, -2.8632929945846817, 7.280109889280518
155, 86, 402, 364, 405, 364, -3, 0, 3.141592653589793, 3.0
155, 87, 590, 231, 591, 234, -1, -3, -1.892546881191539, 3.1622776601683795
155, 91, 246, 369, 251, 369, -5, 0, 3.141592653589793, 5.0
155, 93, 253, 206, 261, 210, -8, -4, -2.677945044588987, 8.94427190999916
155, 96, 113, 299, 118, 300, -5, -1, -2.9441970937399127, 5.0990195135927845
155, 97, 193, 367, 195, 367, -2, 0, 3.141592653589793, 2.0
155, 98, 123, 342, 124, 344, -1, -2, -2.0344439357957027, 2.23606797749979
155, 105, 185, 190, 191, 193, -6, -3, -2.677945044588987, 6.708203932499369
155, 107, 250, 128, 252, 128, -2, 0, 3.141592653589793, 2.0
155, 111, 569, 345, 568, 347, 1, -2, -1.1071487177940904, 2.23606797749979
155, 112, 220, 138, 222, 139, -2, -1, -2.677945044588987, 2.23606797749979
155, 124, 243, 155, 246, 156, -3, -1, -2.819842099193151, 3.1622776601683795
155, 125, 262, 365, 265, 366, -3, -1, -2.819842099193151, 3.1622776601683795
155, 130, 136, 150, 138, 151, -2, -1, -2.677945044588987, 2.23606797749979
155, 134, 58, 173, 57, 175, 1, -2, -1.1071487177940904, 2.23606797749979
155, 136, 208, 198, 215, 201, -7, -3, -2.7367008673047097, 7.615773105863909
155, 137, 247, 164, 249, 165, -2, -1, -2.677945044588987, 2.23606797749979
155, 140, 577, 343, 576, 344, 1, -1, -0.7853981633974483, 1.4142135623730951
155, 141, 140, 298, 143, 298, -3, 0, 3.141592653589793, 3.0
155, 142, 202, 237, 207, 238, -5, -1, -2.9441970937399127, 5.0990195135927845
155, 143, 115, 145, 116, 144, -1, 1, 2.356194490192345, 1.4142135623730951
155, 147, 89, 307, 93, 308, -4, -1, -2.896613990462929, 4.123105625617661
155, 149, 154, 157, 158, 159, -4, -2, -2.677945044588987, 4.47213595499958
155, 151, 310, 160, 314, 163, -4, -3, -2.498091544796509, 5.0
155, 154, 257, 147, 260, 148, -3, -1, -2.819842099193151, 3.1622776601683795
155, 157, 160, 164, 162, 165, -2, -1, -2.677945044588987, 2.23606797749979
155, 158, 165, 141, 167, 141, -2, 0, 3.141592653589793, 2.0
155, 160, 251, 361, 255, 362, -4, -1, -2.896613990462929, 4.123105625617661
155, 161, 194, 194, 198, 195, -4, -1, -2.896613990462929, 4.123105625617661
155, 162, 503, 367, 502, 368, 1, -1, -0.7853981633974483, 1.4142135623730951
155, 163, 83, 242, 85, 243, -2, -1, -2.677945044588987, 2.23606797749979
156, 2, 75, 336, 78, 337, -3, -1, -2.819842099193151, 3.1622776601683795
156, 9, 150, 145, 153, 146, -3, -1, -2.819842099193151, 3.1622776601683795
156, 12, 142, 142, 145, 143, -3, -1, -2.819842099193151, 3.1622776601683795
156, 17, 267, 138, 269, 139, -2, -1, -2.677945044588987, 2.23606797749979
156, 20, 217, 128, 219, 129, -2, -1, -2.677945044588987, 2.23606797749979
156, 28, 391, 135, 393, 136, -2, -1, -2.677945044588987, 2.23606797749979
156, 29, 169, 149, 172, 149, -3, 0, 3.141592653589793, 3.0
156, 31, 378, 139, 380, 141, -2, -2, -2.356194490192345, 2.8284271247461903
156, 32, 295, 366, 297, 366, -2, 0, 3.141592653589793, 2.0
156, 33, 288, 364, 290, 365, -2, -1, -2.677945044588987, 2.23606797749979
156, 38, 579, 183, 579, 185, 0, -2, -1.5707963267948966, 2.0
156, 39, 579, 348, 578, 350, 1, -2, -1.1071487177940904, 2.23606797749979
156, 42, 245, 185, 250, 188, -5, -3, -2.601173153319209, 5.830951894845301
156, 50, 149, 284, 155, 284, -6, 0, 3.141592653589793, 6.0
156, 62, 60, 153, 62, 152, -2, 1, 2.677945044588987, 2.23606797749979
156, 64, 398, 364, 402, 364, -4, 0, 3.141592653589793, 4.0
156, 65, 590, 228, 590, 231, 0, -3, -1.5707963267948966, 3.0
156, 69, 240, 368, 246, 369, -6, -1, -2.976443976175166, 6.082762530298219
156, 71, 250, 203, 253, 206, -3, -3, -2.356194490192345, 4.242640687119285
156, 73, 111, 299, 113, 299, -2, 0, 3.141592653589793, 2.0
156, 75, 122, 340, 123, 342, -1, -2, -2.0344439357957027, 2.23606797749979
156, 78, 179, 187, 185, 190, -6, -3, -2.677945044588987, 6.708203932499369
156, 83, 569, 343, 569, 345, 0, -2, -1.5707963267948966, 2.0
156, 84, 218, 137, 220, 138, -2, -1, -2.677945044588987, 2.23606797749979
156, 87, 583, 302, 584, 304, -1, -2, -2.0344439357957027, 2.23606797749979
156, 93, 241, 154, 243, 155, -2, -1, -2.677945044588987, 2.23606797749979
156, 94, 259, 364, 262, 365, -3, -1, -2.819842099193151, 3.1622776601683795
156, 97, 134, 149, 136, 150, -2, -1, -2.677945044588987, 2.23606797749979
156, 98, 242, 136, 244, 136, -2, 0, 3.141592653589793, 2.0
156, 99, 597, 220, 597, 222, 0, -2, -1.5707963267948966, 2.0
156, 101, 203, 195, 208, 198, -5, -3, -2.601173153319209, 5.830951894845301
156, 102, 244, 164, 247, 164, -3, 0, 3.141592653589793, 3.0
156, 106, 197, 235, 202, 237, -5, -2, -2.761086276477428, 5.385164807134504
156, 110, 86, 306, 89, 307, -3, -1, -2.819842099193151, 3.1622776601683795
156, 112, 151, 156, 154, 157, -3, -1, -2.819842099193151, 3.1622776601683795
156, 114, 308, 158, 310, 160, -2, -2, -2.356194490192345, 2.8284271247461903
156, 115, 254, 147, 257, 147, -3, 0, 3.141592653589793, 3.0
156, 117, 157, 163, 160, 164, -3, -1, -2.819842099193151, 3.1622776601683795
156, 118, 163, 141, 165, 141, -2, 0, 3.141592653589793, 2.0
156, 120, 248, 361, 251, 361, -3, 0, 3.141592653589793, 3.0
156, 121, 190, 193, 194, 194, -4, -1, -2.896613990462929, 4.123105625617661
156, 122, 504, 366, 503, 367, 1, -1, -0.7853981633974483, 1.4142135623730951
156, 123, 81, 241, 83, 242, -2, -1, -2.677945044588987, 2.23606797749979
157, 9, 148, 144, 150, 145, -2, -1, -2.677945044588987, 2.23606797749979
157, 14, 265, 138, 267, 138, -2, 0, 3.141592653589793, 2.0
157, 22, 389, 135, 391, 135, -2, 0, 3.141592653589793, 2.0
157, 23, 166, 149, 169, 149, -3, 0, 3.141592653589793, 3.0
157, 26, 292, 366, 295, 366, -3, 0, 3.141592653589793, 3.0
157, 27, 286, 363, 288, 364, -2, -1, -2.677945044588987, 2.23606797749979
157, 32, 580, 181, 579, 183, 1, -2, -1.1071487177940904, 2.23606797749979
157, 36, 242, 182, 245, 185, -3, -3, -2.356194490192345, 4.242640687119285
157, 39, 308, 117, 310, 117, -2, 0, 3.141592653589793, 2.0
157, 43, 144, 282, 149, 284, -5, -2, -2.761086276477428, 5.385164807134504
157, 51, 394, 365, 398, 364, -4, 1, 2.896613990462929, 4.123105625617661
157, 52, 590, 225, 590, 228, 0, -3, -1.5707963267948966, 3.0
157, 55, 236, 368, 240, 368, -4, 0, 3.141592653589793, 4.0
157, 56, 246, 202, 250, 203, -4, -1, -2.896613990462929, 4.123105625617661
157, 58, 109, 298, 111, 299, -2, -1, -2.677945044588987, 2.23606797749979
157, 59, 189, 366, 192, 367, -3, -1, -2.819842099193151, 3.1622776601683795
157, 60, 122, 338, 122, 340, 0, -2, -1.5707963267948966, 2.0
157, 63, 176, 183, 179, 187, -3, -4, -2.214297435588181, 5.0
157, 68, 570, 341, 569, 343, 1, -2, -1.1071487177940904, 2.23606797749979
157, 69, 216, 136, 218, 137, -2, -1, -2.677945044588987, 2.23606797749979
157, 72, 583, 300, 583, 302, 0, -2, -1.5707963267948966, 2.0
157, 73, 78, 316, 79, 315, -1, 1, 2.356194490192345, 1.4142135623730951
157, 77, 238, 153, 241, 154, -3, -1, -2.819842099193151, 3.1622776601683795
157, 78, 256, 364, 259, 364, -3, 0, 3.141592653589793, 3.0
157, 81, 132, 149, 134, 149, -2, 0, 3.141592653589793, 2.0
157, 85, 198, 194, 203, 195, -5, -1, -2.9441970937399127, 5.0990195135927845
157, 86, 241, 164, 244, 164, -3, 0, 3.141592653589793, 3.0
157, 87, 578, 341, 577, 342, 1, -1, -0.7853981633974483, 1.4142135623730951
157, 89, 194, 234, 197, 235, -3, -1, -2.819842099193151, 3.1622776601683795
157, 94, 149, 156, 151, 156, -2, 0, 3.141592653589793, 2.0
157, 96, 305, 156, 308, 158, -3, -2, -2.5535900500422257, 3.605551275463989
157, 97, 251, 146, 254, 147, -3, -1, -2.819842099193151, 3.1622776601683795
157, 99, 154, 162, 157, 163, -3, -1, -2.819842099193151, 3.1622776601683795
157, 100, 161, 140, 163, 141, -2, -1, -2.677945044588987, 2.23606797749979
157, 101, 244, 361, 248, 361, -4, 0, 3.141592653589793, 4.0
157, 102, 185, 190, 190, 193, -5, -3, -2.601173153319209, 5.830951894845301
158, 14, 263, 138, 265, 138, -2, 0, 3.141592653589793, 2.0
158, 21, 164, 149, 166, 149, -2, 0, 3.141592653589793, 2.0
158, 23, 289, 366, 292, 366, -3, 0, 3.141592653589793, 3.0
158, 24, 284, 363, 286, 363, -2, 0, 3.141592653589793, 2.0
158, 28, 580, 179, 580, 181, 0, -2, -1.5707963267948966, 2.0
158, 32, 238, 180, 242, 182, -4, -2, -2.677945044588987, 4.47213595499958
158, 39, 138, 281, 144, 282, -6, -1, -2.976443976175166, 6.082762530298219
158, 44, 389, 365, 394, 365, -5, 0, 3.141592653589793, 5.0
158, 45, 590, 223, 590, 225, 0, -2, -1.5707963267948966, 2.0
158, 48, 233, 367, 236, 368, -3, -1, -2.819842099193151, 3.1622776601683795
158, 49, 242, 200, 246, 202, -4, -2, -2.677945044588987, 4.47213595499958
158, 51, 106, 297, 109, 298, -3, -1, -2.819842099193151, 3.1622776601683795
158, 52, 186, 365, 189, 366, -3, -1, -2.819842099193151, 3.1622776601683795
158, 53, 121, 336, 122, 338, -1, -2, -2.0344439357957027, 2.23606797749979
158, 56, 173, 180, 176, 183, -3, -3, -2.356194490192345, 4.242640687119285
158, 61, 572, 339, 570, 341, 2, -2, -0.7853981633974483, 2.8284271247461903
158, 62, 214, 135, 216, 136, -2, -1, -2.677945044588987, 2.23606797749979
158, 65, 583, 298, 583, 300, 0, -2, -1.5707963267948966, 2.0
158, 70, 236, 152, 238, 153, -2, -1, -2.677945044588987, 2.23606797749979
158, 71, 251, 363, 256, 364, -5, -1, -2.9441970937399127, 5.0990195135927845
158, 73, 130, 148, 132, 149, -2, -1, -2.677945044588987, 2.23606797749979
158, 74, 239, 135, 241, 136, -2, -1, -2.677945044588987, 2.23606797749979
158, 75, 597, 217, 597, 219, 0, -2, -1.5707963267948966, 2.0
158, 77, 195, 193, 198, 194, -3, -1, -2.819842099193151, 3.1622776601683795
158, 78, 238, 164, 241, 164, -3, 0, 3.141592653589793, 3.0
158, 80, 137, 297, 139, 298, -2, -1, -2.677945044588987, 2.23606797749979
158, 81, 191, 233, 194, 234, -3, -1, -2.819842099193151, 3.1622776601683795
158, 84, 146, 155, 149, 156, -3, -1, -2.819842099193151, 3.1622776601683795
158, 86, 303, 155, 305, 156, -2, -1, -2.677945044588987, 2.23606797749979
158, 87, 248, 146, 251, 146, -3, 0, 3.141592653589793, 3.0
158, 89, 151, 161, 154, 162, -3, -1, -2.819842099193151, 3.1622776601683795
158, 90, 158, 139, 161, 140, -3, -1, -2.819842099193151, 3.1622776601683795
158, 91, 240, 361, 244, 361, -4, 0, 3.141592653589793, 4.0
158, 92, 179, 189, 185, 190, -6, -1, -2.976443976175166, 6.082762530298219
158, 93, 506, 365, 505, 366, 1, -1, -0.7853981633974483, 1.4142135623730951
158, 94, 78, 240, 80, 241, -2, -1, -2.677945044588987, 2.23606797749979
159, 10, 261, 138, 263, 138, -2, 0, 3.141592653589793, 2.0
159, 16, 161, 149, 164, 149, -3, 0, 3.141592653589793, 3.0
159, 17, 374, 139, 376, 139, -2, 0, 3.141592653589793, 2.0
159, 18, 287, 366, 289, 366, -2, 0, 3.141592653589793, 2.0
159, 19, 282, 363, 284, 363, -2, 0, 3.141592653589793, 2.0
159, 22, 580, 345, 579, 346, 1, -1, -0.7853981633974483, 1.4142135623730951
159, 25, 233, 178, 238, 180, -5, -2, -2.761086276477428, 5.385164807134504
159, 31, 134, 279, 138, 281, -4, -2, -2.677945044588987, 4.47213595499958
159, 35, 385, 365, 389, 365, -4, 0, 3.141592653589793, 4.0
159, 36, 589, 221, 590, 223, -1, -2, -2.0344439357957027, 2.23606797749979
159, 39, 229, 368, 233, 367, -4, 1, 2.896613990462929, 4.123105625617661
159, 40, 239, 199, 242, 200, -3, -1, -2.819842099193151, 3.1622776601683795
159, 41, 104, 296, 106, 297, -2, -1, -2.677945044588987, 2.23606797749979
159, 42, 183, 364, 186, 365, -3, -1, -2.819842099193151, 3.1622776601683795
159, 43, 121, 334, 121, 336, 0, -2, -1.5707963267948966, 2.0
159, 46, 172, 177, 173, 180, -1, -3, -1.892546881191539, 3.1622776601683795
159, 50, 572, 337, 572, 339, 0, -2, -1.5707963267948966, 2.0
159, 53, 583, 296, 583, 298, 0, -2, -1.5707963267948966, 2.0
159, 57, 234, 151, 236, 152, -2, -1, -2.677945044588987, 2.23606797749979
159, 58, 248, 362, 251, 363, -3, -1, -2.819842099193151, 3.1622776601683795
159, 60, 128, 147, 130, 148, -2, -1, -2.677945044588987, 2.23606797749979
159, 62, 597, 215, 597, 217, 0, -2, -1.5707963267948966, 2.0
159, 64, 192, 192, 195, 193, -3, -1, -2.819842099193151, 3.1622776601683795
159, 66, 135, 297, 137, 297, -2, 0, 3.141592653589793, 2.0
159, 67, 189, 233, 191, 233, -2, 0, 3.141592653589793, 2.0
159, 70, 144, 154, 146, 155, -2, -1, -2.677945044588987, 2.23606797749979
159, 72, 300, 153, 303, 155, -3, -2, -2.5535900500422257, 3.605551275463989
159, 75, 148, 161, 151, 161, -3, 0, 3.141592653589793, 3.0
159, 76, 156, 138, 158, 139, -2, -1, -2.677945044588987, 2.23606797749979
159, 77, 238, 362, 240, 361, -2, 1, 2.677945044588987, 2.23606797749979
159, 78, 172, 187, 179, 189, -7, -2, -2.8632929945846817, 7.280109889280518
160, 7, 169, 147, 171, 147, -2, 0, 3.141592653589793, 2.0
160, 8, 195, 120, 197, 121, -2, -1, -2.677945044588987, 2.23606797749979
160, 9, 265, 139, 267, 139, -2, 0, 3.141592653589793, 2.0
160, 17, 213, 133, 215, 134, -2, -1, -2.677945044588987, 2.23606797749979
160, 30, 233, 116, 235, 117, -2, -1, -2.677945044588987, 2.23606797749979
160, 36, 389, 135, 391, 135, -2, 0, 3.141592653589793, 2.0
160, 39, 236, 365, 242, 365, -6, 0, 3.141592653589793, 6.0
160, 45, 391, 369, 396, 369, -5, 0, 3.141592653589793, 5.0
160, 47, 91, 304, 92, 303, -1, 1, 2.356194490192345, 1.4142135623730951
160, 56, 84, 219, 86, 222, -2, -3, -2.158798930342464, 3.605551275463989
160, 66, 162, 130, 164, 131, -2, -1, -2.677945044588987, 2.23606797749979
160, 75, 247, 127, 249, 128, -2, -1, -2.677945044588987, 2.23606797749979
160, 83, 236, 176, 242, 180, -6, -4, -2.5535900500422257, 7.211102550927978
160, 87, 295, 366, 297, 366, -2, 0, 3.141592653589793, 2.0
160, 91, 224, 123, 226, 124, -2, -1, -2.677945044588987, 2.23606797749979
160, 95, 123, 338, 124, 340, -1, -2, -2.0344439357957027, 2.23606797749979
160, 97, 86, 293, 90, 295, -4, -2, -2.677945044588987, 4.47213595499958
160, 102, 121, 295, 125, 295, -4, 0, 3.141592653589793, 4.0
160, 105, 145, 164, 149, 164, -4, 0, 3.141592653589793, 4.0
160, 109, 285, 367, 287, 367, -2, 0, 3.141592653589793, 2.0
160, 115, 239, 197, 246, 203, -7, -6, -2.432966381462123, 9.219544457292887
160, 130, 136, 279, 143, 281, -7, -2, -2.8632929945846817, 7.280109889280518
160, 131, 151, 147, 154, 148, -3, -1, -2.819842099193151, 3.1622776601683795
160, 132, 306, 159, 308, 159, -2, 0, 3.141592653589793, 2.0
160, 134, 276, 365, 278, 366, -2, -1, -2.677945044588987, 2.23606797749979
160, 137, 170, 183, 177, 187, -7, -4, -2.62244653934327, 8.06225774829855
160, 138, 239, 154, 241, 155, -2, -1, -2.677945044588987, 2.23606797749979
160, 139, 117, 173, 119, 173, -2, 0, 3.141592653589793, 2.0
160, 142, 132, 148, 134, 149, -2, -1, -2.677945044588987, 2.23606797749979
160, 143, 588, 225, 588, 228, 0, -3, -1.5707963267948966, 3.0
160, 144, 53, 325, 55, 326, -2, -1, -2.677945044588987, 2.23606797749979
160, 150, 241, 166, 244, 166, -3, 0, 3.141592653589793, 3.0
160, 151, 184, 158, 187, 160, -3, -2, -2.5535900500422257, 3.605551275463989
160, 152, 240, 137, 242, 137, -2, 0, 3.141592653589793, 2.0
160, 154, 159, 141, 162, 141, -3, 0, 3.141592653589793, 3.0
160, 155, 125, 354, 127, 356, -2, -2, -2.356194490192345, 2.8284271247461903
160, 156, 193, 189, 200, 193, -7, -4, -2.62244653934327, 8.06225774829855
161, 7, 193, 119, 195, 120, -2, -1, -2.677945044588987, 2.23606797749979
161, 16, 211, 133, 213, 133, -2, 0, 3.141592653589793, 2.0
161, 25, 341, 118, 343, 119, -2, -1, -2.677945044588987, 2.23606797749979
161, 32, 231, 364, 236, 365, -5, -1, -2.9441970937399127, 5.0990195135927845
161, 37, 387, 369, 391, 369, -4, 0, 3.141592653589793, 4.0
161, 57, 160, 130, 162, 130, -2, 0, 3.141592653589793, 2.0
161, 69, 583, 345, 582, 346, 1, -1, -0.7853981633974483, 1.4142135623730951
161, 71, 232, 175, 236, 176, -4, -1, -2.896613990462929, 4.123105625617661
161, 75, 293, 365, 295, 366, -2, -1, -2.677945044588987, 2.23606797749979
161, 78, 222, 123, 224, 123, -2, 0, 3.141592653589793, 2.0
161, 81, 121, 335, 123, 338, -2, -3, -2.158798930342464, 3.605551275463989
161, 83, 84, 292, 86, 293, -2, -1, -2.677945044588987, 2.23606797749979
161, 87, 117, 294, 121, 295, -4, -1, -2.896613990462929, 4.123105625617661
161, 90, 143, 164, 145, 164, -2, 0, 3.141592653589793, 2.0
161, 92, 283, 367, 285, 367, -2, 0, 3.141592653589793, 2.0
161, 98, 233, 195, 239, 197, -6, -2, -2.819842099193151, 6.324555320336759
161, 110, 130, 277, 136, 279, -6, -2, -2.819842099193151, 6.324555320336759
161, 112, 304, 159, 306, 159, -2, 0, 3.141592653589793, 2.0
161, 113, 274, 365, 276, 365, -2, 0, 3.141592653589793, 2.0
161, 115, 163, 180, 170, 183, -7, -3, -2.7367008673047097, 7.615773105863909
161, 116, 237, 153, 239, 154, -2, -1, -2.677945044588987, 2.23606797749979
161, 117, 114, 174, 117, 173, -3, 1, 2.819842099193151, 3.1622776601683795
161, 119, 588, 223, 588, 225, 0, -2, -1.5707963267948966, 2.0
161, 123, 238, 166, 241, 166, -3, 0, 3.141592653589793, 3.0
161, 124, 180, 156, 184, 158, -4, -2, -2.677945044588987, 4.47213595499958
161, 126, 157, 140, 159, 141, -2, -1, -2.677945044588987, 2.23606797749979
161, 127, 123, 352, 125, 354, -2, -2, -2.356194490192345, 2.8284271247461903
161, 128, 187, 186, 193, 189, -6, -3, -2.677945044588987, 6.708203932499369
162, 5, 166, 146, 168, 147, -2, -1, -2.677945044588987, 2.23606797749979
162, 6, 262, 138, 264, 139, -2, -1, -2.677945044588987, 2.23606797749979
162, 13, 209, 132, 211, 133, -2, -1, -2.677945044588987, 2.23606797749979
162, 16, 224, 112, 226, 112, -2, 0, 3.141592653589793, 2.0
162, 22, 165, 118, 164, 119, 1, -1, -0.7853981633974483, 1.4142135623730951
162, 23, 386, 135, 388, 135, -2, 0, 3.141592653589793, 2.0
162, 25, 225, 363, 231, 364, -6, -1, -2.976443976175166, 6.082762530298219
162, 30, 382, 368, 387, 369, -5, -1, -2.9441970937399127, 5.0990195135927845
162, 46, 158, 129, 160, 130, -2, -1, -2.677945044588987, 2.23606797749979
162, 56, 584, 344, 583, 345, 1, -1, -0.7853981633974483, 1.4142135623730951
162, 58, 227, 173, 232, 175, -5, -2, -2.761086276477428, 5.385164807134504
162, 62, 291, 364, 293, 365, -2, -1, -2.677945044588987, 2.23606797749979
162, 64, 220, 122, 222, 123, -2, -1, -2.677945044588987, 2.23606797749979
162, 66, 120, 333, 121, 335, -1, -2, -2.0344439357957027, 2.23606797749979
162, 68, 82, 292, 84, 292, -2, 0, 3.141592653589793, 2.0
162, 71, 114, 294, 117, 294, -3, 0, 3.141592653589793, 3.0
162, 73, 140, 164, 143, 164, -3, 0, 3.141592653589793, 3.0
162, 74, 66, 311, 68, 311, -2, 0, 3.141592653589793, 2.0
162, 75, 280, 366, 283, 367, -3, -1, -2.819842099193151, 3.1622776601683795
162, 80, 231, 194, 233, 195, -2, -1, -2.677945044588987, 2.23606797749979
162, 90, 83, 245, 85, 245, -2, 0, 3.141592653589793, 2.0
162, 91, 124, 274, 130, 277, -6, -3, -2.677945044588987, 6.708203932499369
162, 92, 301, 159, 304, 159, -3, 0, 3.141592653589793, 3.0
162, 93, 272, 365, 274, 365, -2, 0, 3.141592653589793, 2.0
162, 95, 162, 176, 163, 180, -1, -4, -1.8157749899217608, 4.123105625617661
162, 96, 235, 152, 237, 153, -2, -1, -2.677945044588987, 2.23606797749979
162, 99, 587, 221, 588, 223, -1, -2, -2.0344439357957027, 2.23606797749979
162, 102, 235, 165, 238, 166, -3, -1, -2.819842099193151, 3.1622776601683795
162, 103, 176, 154, 180, 156, -4, -2, -2.677945044588987, 4.47213595499958
162, 105, 121, 350, 123, 352, -2, -2, -2.356194490192345, 2.8284271247461903
162, 106, 184, 185, 187, 186, -3, -1, -2.819842099193151, 3.1622776601683795
163, 2, 76, 169, 77, 168, -1, 1, 2.356194490192345, 1.4142135623730951
163, 4, 164, 145, 166, 146, -2, -1, -2.677945044588987, 2.23606797749979
163, 5, 261, 139, 262, 138, -1, 1, 2.356194490192345, 1.4142135623730951
163, 9, 93, 166, 95, 167, -2, -1, -2.677945044588987, 2.23606797749979
163, 12, 207, 131, 209, 132, -2, -1, -2.677945044588987, 2.23606797749979
163, 19, 384, 134, 386, 135, -2, -1, -2.677945044588987, 2.23606797749979
163, 20, 220, 363, 225, 363, -5, 0, 3.141592653589793, 5.0
163, 25, 378, 367, 382, 368, -4, -1, -2.896613990462929, 4.123105625617661
163, 46, 585, 343, 584, 344, 1, -1, -0.7853981633974483, 1.4142135623730951
163, 48, 225, 172, 227, 173, -2, -1, -2.677945044588987, 2.23606797749979
163, 52, 289, 363, 291, 364, -2, -1, -2.677945044588987, 2.23606797749979
163, 54, 218, 121, 220, 122, -2, -1, -2.677945044588987, 2.23606797749979
163, 56, 117, 330, 120, 333, -3, -3, -2.356194490192345, 4.242640687119285
163, 57, 80, 292, 82, 292, -2, 0, 3.141592653589793, 2.0
163, 59, 111, 293, 114, 294, -3, -1, -2.819842099193151, 3.1622776601683795
163, 60, 138, 163, 140, 164, -2, -1, -2.677945044588987, 2.23606797749979
163, 62, 277, 365, 280, 366, -3, -1, -2.819842099193151, 3.1622776601683795
163, 64, 228, 192, 231, 194, -3, -2, -2.5535900500422257, 3.605551275463989
163, 71, 78, 292, 80, 292, -2, 0, 3.141592653589793, 2.0
163, 72, 120, 273, 124, 274, -4, -1, -2.896613990462929, 4.123105625617661
163, 73, 299, 159, 301, 159, -2, 0, 3.141592653589793, 2.0
163, 74, 269, 365, 272, 365, -3, 0, 3.141592653589793, 3.0
163, 76, 159, 174, 162, 176, -3, -2, -2.5535900500422257, 3.605551275463989
163, 77, 232, 151, 235, 152, -3, -1, -2.819842099193151, 3.1622776601683795
163, 80, 587, 219, 587, 221, 0, -2, -1.5707963267948966, 2.0
163, 82, 233, 164, 235, 165, -2, -1, -2.677945044588987, 2.23606797749979
163, 83, 174, 153, 176, 154, -2, -1, -2.677945044588987, 2.23606797749979
163, 84, 154, 139, 156, 140, -2, -1, -2.677945044588987, 2.23606797749979
163, 85, 118, 349, 121, 350, -3, -1, -2.819842099193151, 3.1622776601683795
163, 86, 181, 185, 184, 185, -3, 0, 3.141592653589793, 3.0
164, 3, 162, 143, 164, 145, -2, -2, -2.356194490192345, 2.8284271247461903
164, 11, 205, 130, 207, 131, -2, -1, -2.677945044588987, 2.23606797749979
164, 16, 110, 127, 111, 126, -1, 1, 2.356194490192345, 1.4142135623730951
164, 18, 382, 133, 384, 134, -2, -1, -2.677945044588987, 2.23606797749979
164, 22, 379, 366, 378, 367, 1, -1, -0.7853981633974483, 1.4142135623730951
164, 25, 63, 151, 62, 152, 1, -1, -0.7853981633974483, 1.4142135623730951
164, 38, 586, 342, 585, 343, 1, -1, -0.7853981633974483, 1.4142135623730951
164, 40, 222, 169, 225, 172, -3, -3, -2.356194490192345, 4.242640687119285
164, 44, 287, 363, 289, 363, -2, 0, 3.141592653589793, 2.0
164, 47, 116, 327, 117, 330, -1, -3, -1.892546881191539, 3.1622776601683795
164, 50, 109, 293, 111, 293, -2, 0, 3.141592653589793, 2.0
164, 53, 274, 365, 277, 365, -3, 0, 3.141592653589793, 3.0
164, 55, 225, 190, 228, 192, -3, -2, -2.5535900500422257, 3.605551275463989
164, 63, 118, 272, 120, 273, -2, -1, -2.677945044588987, 2.23606797749979
164, 64, 296, 159, 299, 159, -3, 0, 3.141592653589793, 3.0
164, 65, 267, 365, 269, 365, -2, 0, 3.141592653589793, 2.0
164, 70, 229, 163, 233, 164, -4, -1, -2.896613990462929, 4.123105625617661
164, 71, 172, 152, 174, 153, -2, -1, -2.677945044588987, 2.23606797749979
164, 73, 178, 185, 181, 185, -3, 0, 3.141592653589793, 3.0
165, 1, 376, 140, 378, 141, -2, -1, -2.677945044588987, 2.23606797749979
165, 12, 141, 144, 143, 144, -2, 0, 3.141592653589793, 2.0
165, 15, 262, 143, 264, 142, -2, 1, 2.677945044588987, 2.23606797749979
165, 27, 386, 133, 388, 134, -2, -1, -2.677945044588987, 2.23606797749979
165, 29, 586, 345, 585, 346, 1, -1, -0.7853981633974483, 1.4142135623730951
165, 36, 593, 299, 593, 301, 0, -2, -1.5707963267948966, 2.0
165, 38, 227, 119, 229, 120, -2, -1, -2.677945044588987, 2.23606797749979
165, 57, 173, 156, 175, 156, -2, 0, 3.141592653589793, 2.0
165, 68, 236, 154, 237, 153, -1, 1, 2.356194490192345, 1.4142135623730951
165, 71, 223, 170, 229, 175, -6, -5, -2.44685437739309, 7.810249675906654
165, 72, 223, 365, 229, 365, -6, 0, 3.141592653589793, 6.0
165, 73, 289, 366, 291, 367, -2, -1, -2.677945044588987, 2.23606797749979
165, 74, 245, 128, 247, 128, -2, 0, 3.141592653589793, 2.0
165, 75, 379, 369, 384, 369, -5, 0, 3.141592653589793, 5.0
165, 79, 163, 145, 165, 146, -2, -1, -2.677945044588987, 2.23606797749979
165, 81, 224, 190, 230, 195, -6, -5, -2.44685437739309, 7.810249675906654
165, 92, 280, 366, 282, 367, -2, -1, -2.677945044588987, 2.23606797749979
165, 95, 144, 155, 146, 157, -2, -2, -2.356194490192345, 2.8284271247461903
165, 115, 161, 366, 165, 366, -4, 0, 3.141592653589793, 4.0
165, 121, 120, 276, 126, 278, -6, -2, -2.819842099193151, 6.324555320336759
165, 122, 244, 144, 247, 145, -3, -1, -2.819842099193151, 3.1622776601683795
165, 128, 241, 364, 246, 365, -5, -1, -2.9441970937399127, 5.0990195135927845
165, 129, 156, 176, 162, 179, -6, -3, -2.677945044588987, 6.708203932499369
165, 131, 172, 224, 177, 226, -5, -2, -2.761086276477428, 5.385164807134504
165, 132, 391, 140, 393, 141, -2, -1, -2.677945044588987, 2.23606797749979
165, 133, 65, 228, 66, 230, -1, -2, -2.0344439357957027, 2.23606797749979
165, 134, 233, 166, 237, 167, -4, -1, -2.896613990462929, 4.123105625617661
165, 140, 301, 160, 304, 160, -3, 0, 3.141592653589793, 3.0
165, 146, 119, 332, 121, 335, -2, -3, -2.158798930342464, 3.605551275463989
165, 150, 175, 366, 180, 367, -5, -1, -2.9441970937399127, 5.0990195135927845
166, 13, 259, 143, 262, 143, -3, 0, 3.141592653589793, 3.0
166, 24, 384, 132, 386, 133, -2, -1, -2.677945044588987, 2.23606797749979
166, 32, 597, 282, 597, 284, 0, -2, -1.5707963267948966, 2.0
166, 55, 234, 153, 236, 154, -2, -1, -2.677945044588987, 2.23606797749979
166, 58, 217, 166, 223, 170, -6, -4, -2.5535900500422257, 7.211102550927978
166, 59, 218, 364, 223, 365, -5, -1, -2.9441970937399127, 5.0990195135927845
166, 60, 287, 365, 289, 366, -2, -1, -2.677945044588987, 2.23606797749979
166, 61, 376, 369, 379, 369, -3, 0, 3.141592653589793, 3.0
166, 63, 161, 145, 163, 145, -2, 0, 3.141592653589793, 2.0
166, 64, 220, 187, 224, 190, -4, -3, -2.498091544796509, 5.0
166, 73, 278, 365, 280, 366, -2, -1, -2.677945044588987, 2.23606797749979
166, 91, 158, 366, 161, 366, -3, 0, 3.141592653589793, 3.0
166, 96, 111, 273, 120, 276, -9, -3, -2.819842099193151, 9.486832980505138
166, 97, 242, 143, 244, 144, -2, -1, -2.677945044588987, 2.23606797749979
166, 101, 237, 364, 241, 364, -4, 0, 3.141592653589793, 4.0
166, 102, 150, 175, 156, 176, -6, -1, -2.976443976175166, 6.082762530298219
166, 104, 168, 223, 172, 224, -4, -1, -2.896613990462929, 4.123105625617661
166, 105, 389, 138, 391, 140, -2, -2, -2.356194490192345, 2.8284271247461903
166, 107, 229, 165, 233, 166, -4, -1, -2.896613990462929, 4.123105625617661
166, 113, 297, 160, 301, 160, -4, 0, 3.141592653589793, 4.0
166, 118, 117, 329, 119, 332, -2, -3, -2.158798930342464, 3.605551275463989
166, 121, 171, 365, 175, 366, -4, -1, -2.896613990462929, 4.123105625617661
167, 0, 373, 140, 375, 140, -2, 0, 3.141592653589793, 2.0
167, 23, 382, 131, 384, 132, -2, -1, -2.677945044588987, 2.23606797749979
167, 30, 224, 119, 226, 119, -2, 0, 3.141592653589793, 2.0
167, 39, 171, 157, 172, 156, -1, 1, 2.356194490192345, 1.4142135623730951
167, 48, 213, 164, 217, 166, -4, -2, -2.677945044588987, 4.47213595499958
167, 49, 212, 363, 218, 364, -6, -1, -2.976443976175166, 6.082762530298219
167, 50, 285, 364, 287, 365, -2, -1, -2.677945044588987, 2.23606797749979
167, 51, 373, 369, 376, 369, -3, 0, 3.141592653589793, 3.0
167, 53, 159, 146, 161, 145, -2, 1, 2.677945044588987, 2.23606797749979
167, 54, 215, 185, 220, 187, -5, -2, -2.761086276477428, 5.385164807134504
167, 62, 275, 364, 278, 365, -3, -1, -2.819842099193151, 3.1622776601683795
167, 66, 577, 181, 578, 183, -1, -2, -2.0344439357957027, 2.23606797749979
167, 79, 106, 272, 111, 273, -5, -1, -2.9441970937399127, 5.0990195135927845
167, 80, 240, 142, 242, 143, -2, -1, -2.677945044588987, 2.23606797749979
167, 83, 231, 364, 237, 364, -6, 0, 3.141592653589793, 6.0
167, 84, 146, 173, 150, 175, -4, -2, -2.677945044588987, 4.47213595499958
167, 86, 165, 223, 168, 223, -3, 0, 3.141592653589793, 3.0
167, 87, 387, 137, 389, 138, -2, -1, -2.677945044588987, 2.23606797749979
167, 89, 226, 163, 229, 165, -3, -2, -2.5535900500422257, 3.605551275463989
167, 94, 294, 160, 297, 160, -3, 0, 3.141592653589793, 3.0
167, 99, 115, 327, 117, 329, -2, -2, -2.356194490192345, 2.8284271247461903
167, 102, 168, 364, 171, 365, -3, -1, -2.819842099193151, 3.1622776601683795
168, 0, 371, 140, 373, 140, -2, 0, 3.141592653589793, 2.0
168, 5, 196, 113, 194, 114, 2, -1, -0.4636476090008061, 2.23606797749979
168, 20, 380, 130, 382, 131, -2, -1, -2.677945044588987, 2.23606797749979
168, 21, 587, 341, 586, 343, 1, -2, -1.1071487177940904, 2.23606797749979
168, 26, 598, 280, 597, 281, 1, -1, -0.7853981633974483, 1.4142135623730951
168, 34, 168, 157, 171, 157, -3, 0, 3.141592653589793, 3.0
168, 42, 207, 361, 212, 363, -5, -2, -2.761086276477428, 5.385164807134504
168, 43, 283, 363, 285, 364, -2, -1, -2.677945044588987, 2.23606797749979
168, 44, 369, 368, 373, 369, -4, -1, -2.896613990462929, 4.123105625617661
168, 46, 157, 146, 159, 146, -2, 0, 3.141592653589793, 2.0
168, 47, 212, 184, 215, 185, -3, -1, -2.819842099193151, 3.1622776601683795
168, 55, 272, 364, 275, 364, -3, 0, 3.141592653589793, 3.0
168, 67, 103, 271, 106, 272, -3, -1, -2.819842099193151, 3.1622776601683795
168, 70, 227, 363, 231, 364, -4, -1, -2.896613990462929, 4.123105625617661
168, 71, 143, 174, 146, 173, -3, 1, 2.819842099193151, 3.1622776601683795
168, 73, 161, 222, 165, 223, -4, -1, -2.896613990462929, 4.123105625617661
168, 75, 224, 162, 226, 163, -2, -1, -2.677945044588987, 2.23606797749979
168, 80, 292, 159, 294, 160, -2, -1, -2.677945044588987, 2.23606797749979
168, 84, 112, 325, 115, 327, -3, -2, -2.5535900500422257, 3.605551275463989
168, 86, 166, 364, 168, 364, -2, 0, 3.141592653589793, 2.0
169, 0, 369, 140, 371, 140, -2, 0, 3.141592653589793, 2.0
169, 7, 256, 141, 258, 142, -2, -1, -2.677945044588987, 2.23606797749979
169, 16, 599, 279, 598, 280, 1, -1, -0.7853981633974483, 1.4142135623730951
169, 22, 166, 157, 168, 157, -2, 0, 3.141592653589793, 2.0
169, 29, 202, 360, 207, 361, -5, -1, -2.9441970937399127, 5.0990195135927845
169, 30, 280, 362, 283, 363, -3, -1, -2.819842099193151, 3.1622776601683795
169, 31, 365, 367, 369, 368, -4, -1, -2.896613990462929, 4.123105625617661
169, 32, 209, 182, 212, 184, -3, -2, -2.5535900500422257, 3.605551275463989
169, 36, 270, 364, 272, 364, -2, 0, 3.141592653589793, 2.0
169, 44, 100, 270, 103, 271, -3, -1, -2.819842099193151, 3.1622776601683795
169, 46, 222, 361, 227, 363, -5, -2, -2.761086276477428, 5.385164807134504
169, 47, 140, 173, 143, 174, -3, -1, -2.819842099193151, 3.1622776601683795
169, 49, 156, 220, 161, 222, -5, -2, -2.761086276477428, 5.385164807134504
169, 51, 222, 160, 224, 162, -2, -2, -2.356194490192345, 2.8284271247461903
169, 55, 289, 158, 292, 159, -3, -1, -2.819842099193151, 3.1622776601683795
169, 59, 110, 323, 112, 325, -2, -2, -2.356194490192345, 2.8284271247461903
170, 15, 382, 131, 384, 132, -2, -1, -2.677945044588987, 2.23606797749979
170, 18, 258, 140, 260, 141, -2, -1, -2.677945044588987, 2.23606797749979
170, 30, 594, 294, 595, 296, -1, -2, -2.0344439357957027, 2.23606797749979
170, 47, 208, 367, 214, 368, -6, -1, -2.976443976175166, 6.082762530298219
170, 48, 207, 161, 213, 164, -6, -3, -2.677945044588987, 6.708203932499369
170, 55, 99, 273, 106, 275, -7, -2, -2.8632929945846817, 7.280109889280518
170, 57, 142, 170, 148, 172, -6, -2, -2.819842099193151, 6.324555320336759
170, 59, 368, 368, 371, 368, -3, 0, 3.141592653589793, 3.0
170, 70, 591, 303, 593, 304, -2, -1, -2.677945044588987, 2.23606797749979
170, 75, 259, 153, 261, 153, -2, 0, 3.141592653589793, 2.0
170, 76, 95, 290, 98, 291, -3, -1, -2.819842099193151, 3.1622776601683795
170, 78, 285, 365, 287, 365, -2, 0, 3.141592653589793, 2.0
170, 85, 169, 366, 172, 367, -3, -1, -2.819842099193151, 3.1622776601683795
170, 87, 159, 218, 163, 219, -4, -1, -2.896613990462929, 4.123105625617661
170, 92, 208, 184, 215, 187, -7, -3, -2.7367008673047097, 7.615773105863909
170, 95, 242, 127, 244, 128, -2, -1, -2.677945044588987, 2.23606797749979
170, 99, 275, 366, 278, 366, -3, 0, 3.141592653589793, 3.0
170, 107, 229, 366, 234, 366, -5, 0, 3.141592653589793, 5.0
170, 113, 592, 207, 593, 209, -1, -2, -2.0344439357957027, 2.23606797749979
170, 125, 226, 164, 229, 165, -3, -1, -2.819842099193151, 3.1622776601683795
170, 130, 108, 268, 115, 271, -7, -3, -2.7367008673047097, 7.615773105863909
170, 131, 203, 132, 205, 133, -2, -1, -2.677945044588987, 2.23606797749979
170, 133, 171, 160, 173, 160, -2, 0, 3.141592653589793, 2.0
170, 135, 235, 135, 237, 136, -2, -1, -2.677945044588987, 2.23606797749979
171, 16, 255, 139, 258, 140, -3, -1, -2.819842099193151, 3.1622776601683795
171, 40, 203, 367, 208, 367, -5, 0, 3.141592653589793, 5.0
171, 41, 203, 159, 207, 161, -4, -2, -2.677945044588987, 4.47213595499958
171, 43, 304, 117, 307, 118, -3, -1, -2.819842099193151, 3.1622776601683795
171, 46, 95, 272, 99, 273, -4, -1, -2.896613990462929, 4.123105625617661
171, 47, 137, 169, 142, 170, -5, -1, -2.9441970937399127, 5.0990195135927845
171, 49, 362, 368, 368, 368, -6, 0, 3.141592653589793, 6.0
171, 59, 256, 153, 259, 153, -3, 0, 3.141592653589793, 3.0
171, 60, 93, 289, 95, 290, -2, -1, -2.677945044588987, 2.23606797749979
171, 61, 283, 364, 285, 365, -2, -1, -2.677945044588987, 2.23606797749979
171, 65, 601, 246, 602, 248, -1, -2, -2.0344439357957027, 2.23606797749979
171, 67, 166, 365, 169, 366, -3, -1, -2.819842099193151, 3.1622776601683795
171, 69, 154, 217, 159, 218, -5, -1, -2.9441970937399127, 5.0990195135927845
171, 74, 203, 181, 208, 184, -5, -3, -2.601173153319209, 5.830951894845301
171, 77, 240, 126, 242, 127, -2, -1, -2.677945044588987, 2.23606797749979
171, 80, 272, 366, 275, 366, -3, 0, 3.141592653589793, 3.0
171, 86, 225, 366, 229, 366, -4, 0, 3.141592653589793, 4.0
171, 92, 591, 205, 592, 207, -1, -2, -2.0344439357957027, 2.23606797749979
171, 101, 222, 163, 226, 164, -4, -1, -2.896613990462929, 4.123105625617661
171, 104, 103, 266, 108, 268, -5, -2, -2.761086276477428, 5.385164807134504
171, 106, 169, 161, 171, 160, -2, 1, 2.677945044588987, 2.23606797749979
171, 108, 231, 134, 235, 135, -4, -1, -2.896613990462929, 4.123105625617661
172, 15, 253, 138, 255, 139, -2, -1, -2.677945044588987, 2.23606797749979
172, 30, 200, 367, 203, 367, -3, 0, 3.141592653589793, 3.0
172, 31, 199, 158, 203, 159, -4, -1, -2.896613990462929, 4.123105625617661
172, 36, 93, 271, 95, 272, -2, -1, -2.677945044588987, 2.23606797749979
172, 37, 135, 169, 137, 169, -2, 0, 3.141592653589793, 2.0
172, 38, 357, 368, 362, 368, -5, 0, 3.141592653589793, 5.0
172, 45, 254, 153, 256, 153, -2, 0, 3.141592653589793, 2.0
172, 47, 281, 363, 283, 364, -2, -1, -2.677945044588987, 2.23606797749979
172, 52, 149, 215, 154, 217, -5, -2, -2.761086276477428, 5.385164807134504
172, 55, 198, 177, 203, 181, -5, -4, -2.4668517113662407, 6.4031242374328485
172, 58, 238, 126, 240, 126, -2, 0, 3.141592653589793, 2.0
172, 61, 269, 366, 272, 366, -3, 0, 3.141592653589793, 3.0
172, 65, 221, 366, 225, 366, -4, 0, 3.141592653589793, 4.0
172, 71, 591, 202, 591, 205, 0, -3, -1.5707963267948966, 3.0
172, 79, 218, 162, 222, 163, -4, -1, -2.896613990462929, 4.123105625617661
172, 81, 98, 264, 103, 266, -5, -2, -2.761086276477428, 5.385164807134504
172, 82, 167, 161, 169, 161, -2, 0, 3.141592653589793, 2.0
172, 84, 229, 133, 231, 134, -2, -1, -2.677945044588987, 2.23606797749979
173, 13, 251, 138, 253, 138, -2, 0, 3.141592653589793, 2.0
173, 23, 197, 367, 200, 367, -3, 0, 3.141592653589793, 3.0
173, 24, 195, 156, 199, 158, -4, -2, -2.677945044588987, 4.47213595499958
173, 29, 352, 368, 357, 368, -5, 0, 3.141592653589793, 5.0
173, 34, 252, 153, 254, 153, -2, 0, 3.141592653589793, 2.0
173, 35, 278, 362, 281, 363, -3, -1, -2.819842099193151, 3.1622776601683795
173, 39, 144, 213, 149, 215, -5, -2, -2.761086276477428, 5.385164807134504
173, 41, 197, 175, 198, 177, -1, -2, -2.0344439357957027, 2.23606797749979
173, 43, 236, 125, 238, 126, -2, -1, -2.677945044588987, 2.23606797749979
173, 46, 266, 366, 269, 366, -3, 0, 3.141592653589793, 3.0
173, 50, 216, 366, 221, 366, -5, 0, 3.141592653589793, 5.0
173, 58, 594, 326, 594, 328, 0, -2, -1.5707963267948966, 2.0
173, 62, 216, 161, 218, 162, -2, -1, -2.677945044588987, 2.23606797749979
173, 64, 97, 262, 98, 264, -1, -2, -2.0344439357957027, 2.23606797749979
173, 65, 165, 161, 167, 161, -2, 0, 3.141592653589793, 2.0
173, 67, 227, 132, 229, 133, -2, -1, -2.677945044588987, 2.23606797749979
174, 9, 249, 137, 251, 138, -2, -1, -2.677945044588987, 2.23606797749979
174, 19, 195, 366, 197, 367, -2, -1, -2.677945044588987, 2.23606797749979
174, 20, 193, 155, 195, 156, -2, -1, -2.677945044588987, 2.23606797749979
174, 25, 348, 367, 352, 368, -4, -1, -2.896613990462929, 4.123105625617661
174, 29, 324, 125, 326, 125, -2, 0, 3.141592653589793, 2.0
174, 30, 250, 153, 252, 153, -2, 0, 3.141592653589793, 2.0
174, 31, 275, 361, 278, 362, -3, -1, -2.819842099193151, 3.1622776601683795
174, 33, 141, 211, 144, 213, -3, -2, -2.5535900500422257, 3.605551275463989
174, 35, 192, 171, 197, 175, -5, -4, -2.4668517113662407, 6.4031242374328485
174, 37, 234, 125, 236, 125, -2, 0, 3.141592653589793, 2.0
174, 40, 262, 364, 266, 366, -4, -2, -2.677945044588987, 4.47213595499958
174, 43, 212, 365, 216, 366, -4, -1, -2.896613990462929, 4.123105625617661
174, 54, 212, 160, 216, 161, -4, -1, -2.896613990462929, 4.123105625617661
175, 9, 252, 140, 255, 141, -3, -1, -2.819842099193151, 3.1622776601683795
175, 10, 295, 114, 297, 116, -2, -2, -2.356194490192345, 2.8284271247461903
175, 23, 138, 171, 140, 171, -2, 0, 3.141592653589793, 2.0
175, 29, 143, 146, 145, 147, -2, -1, -2.677945044588987, 2.23606797749979
175, 34, 203, 364, 206, 364, -3, 0, 3.141592653589793, 3.0
175, 38, 352, 367, 357, 367, -5, 0, 3.141592653589793, 5.0
175, 39, 280, 365, 283, 365, -3, 0, 3.141592653589793, 3.0
175, 53, 593, 293, 594, 295, -1, -2, -2.0344439357957027, 2.23606797749979
175, 56, 275, 108, 278, 109, -3, -1, -2.819842099193151, 3.1622776601683795
175, 62, 89, 293, 91, 293, -2, 0, 3.141592653589793, 2.0
175, 63, 343, 137, 345, 139, -2, -2, -2.356194490192345, 2.8284271247461903
175, 66, 95, 266, 97, 267, -2, -1, -2.677945044588987, 2.23606797749979
175, 75, 590, 255, 591, 257, -1, -2, -2.0344439357957027, 2.23606797749979
175, 90, 325, 126, 328, 127, -3, -1, -2.819842099193151, 3.1622776601683795
175, 92, 267, 365, 270, 366, -3, -1, -2.819842099193151, 3.1622776601683795
175, 93, 226, 151, 230, 152, -4, -1, -2.896613990462929, 4.123105625617661
175, 96, 112, 179, 114, 179, -2, 0, 3.141592653589793, 2.0
175, 101, 116, 145, 118, 147, -2, -2, -2.356194490192345, 2.8284271247461903
175, 103, 197, 153, 201, 154, -4, -1, -2.896613990462929, 4.123105625617661
175, 107, 412, 130, 414, 132, -2, -2, -2.356194490192345, 2.8284271247461903
175, 108, 449, 131, 451, 133, -2, -2, -2.356194490192345, 2.8284271247461903
175, 109, 142, 211, 147, 214, -5, -3, -2.601173153319209, 5.830951894845301
175, 118, 168, 161, 170, 161, -2, 0, 3.141592653589793, 2.0
175, 119, 192, 174, 199, 177, -7, -3, -2.7367008673047097, 7.615773105863909
175, 120, 197, 159, 201, 161, -4, -2, -2.677945044588987, 4.47213595499958
175, 123, 105, 321, 108, 324, -3, -3, -2.356194490192345, 4.242640687119285
175, 125, 237, 127, 240, 128, -3, -1, -2.819842099193151, 3.1622776601683795
175, 127, 335, 126, 338, 127, -3, -1, -2.819842099193151, 3.1622776601683795
175, 129, 217, 163, 221, 164, -4, -1, -2.896613990462929, 4.123105625617661
175, 135, 230, 134, 232, 135, -2, -1, -2.677945044588987, 2.23606797749979
175, 138, 601, 314, 600, 315, 1, -1, -0.7853981633974483, 1.4142135623730951
175, 143, 128, 226, 130, 228, -2, -2, -2.356194490192345, 2.8284271247461903
175, 144, 258, 146, 260, 147, -2, -1, -2.677945044588987, 2.23606797749979
175, 145, 303, 148, 305, 149, -2, -1, -2.677945044588987, 2.23606797749979
175, 146, 214, 366, 219, 366, -5, 0, 3.141592653589793, 5.0
175, 153, 605, 226, 604, 229, 1, -3, -1.2490457723982544, 3.1622776601683795
175, 156, 606, 304, 605, 306, 1, -2, -1.1071487177940904, 2.23606797749979
175, 157, 237, 143, 239, 144, -2, -1, -2.677945044588987, 2.23606797749979
176, 6, 250, 139, 252, 140, -2, -1, -2.677945044588987, 2.23606797749979
176, 19, 366, 142, 368, 142, -2, 0, 3.141592653589793, 2.0
176, 24, 200, 363, 203, 364, -3, -1, -2.819842099193151, 3.1622776601683795
176, 28, 347, 367, 352, 367, -5, 0, 3.141592653589793, 5.0
176, 29, 277, 364, 280, 365, -3, -1, -2.819842099193151, 3.1622776601683795
176, 47, 94, 264, 95, 266, -1, -2, -2.0344439357957027, 2.23606797749979
176, 51, 589, 217, 589, 219, 0, -2, -1.5707963267948966, 2.0
176, 54, 589, 253, 590, 255, -1, -2, -2.0344439357957027, 2.23606797749979
176, 66, 263, 365, 267, 365, -4, 0, 3.141592653589793, 4.0
176, 67, 224, 150, 226, 151, -2, -1, -2.677945044588987, 2.23606797749979
176, 75, 193, 152, 197, 153, -4, -1, -2.896613990462929, 4.123105625617661
176, 79, 138, 211, 142, 211, -4, 0, 3.141592653589793, 4.0
176, 81, 64, 344, 66, 344, -2, 0, 3.141592653589793, 2.0
176, 87, 185, 171, 192, 174, -7, -3, -2.7367008673047097, 7.615773105863909
176, 88, 193, 157, 197, 159, -4, -2, -2.677945044588987, 4.47213595499958
176, 90, 102, 317, 105, 321, -3, -4, -2.214297435588181, 5.0
176, 91, 235, 127, 237, 127, -2, 0, 3.141592653589793, 2.0
176, 94, 212, 162, 217, 163, -5, -1, -2.9441970937399127, 5.0990195135927845
176, 106, 126, 224, 128, 226, -2, -2, -2.356194490192345, 2.8284271247461903
176, 107, 255, 145, 258, 146, -3, -1, -2.819842099193151, 3.1622776601683795
176, 108, 301, 147, 303, 148, -2, -1, -2.677945044588987, 2.23606797749979
176, 109, 211, 366, 214, 366, -3, 0, 3.141592653589793, 3.0
176, 115, 521, 367, 520, 368, 1, -1, -0.7853981633974483, 1.4142135623730951
177, 5, 248, 139, 250, 139, -2, 0, 3.141592653589793, 2.0
177, 15, 363, 141, 366, 142, -3, -1, -2.819842099193151, 3.1622776601683795
177, 20, 198, 362, 200, 363, -2, -1, -2.677945044588987, 2.23606797749979
177, 24, 343, 365, 347, 367, -4, -2, -2.677945044588987, 4.47213595499958
177, 25, 275, 364, 277, 364, -2, 0, 3.141592653589793, 2.0
177, 28, 79, 327, 81, 327, -2, 0, 3.141592653589793, 2.0
177, 54, 258, 364, 263, 365, -5, -1, -2.9441970937399127, 5.0990195135927845
177, 55, 222, 148, 224, 150, -2, -2, -2.356194490192345, 2.8284271247461903
177, 62, 189, 151, 193, 152, -4, -1, -2.896613990462929, 4.123105625617661
177, 64, 133, 210, 138, 211, -5, -1, -2.9441970937399127, 5.0990195135927845
177, 70, 165, 162, 167, 161, -2, 1, 2.677945044588987, 2.23606797749979
177, 71, 184, 169, 185, 171, -1, -2, -2.0344439357957027, 2.23606797749979
177, 72, 190, 156, 193, 157, -3, -1, -2.819842099193151, 3.1622776601683795
177, 74, 100, 315, 102, 317, -2, -2, -2.356194490192345, 2.8284271247461903
177, 78, 208, 161, 212, 162, -4, -1, -2.896613990462929, 4.123105625617661
177, 81, 83, 365, 85, 366, -2, -1, -2.677945044588987, 2.23606797749979
177, 88, 123, 221, 126, 224, -3, -3, -2.356194490192345, 4.242640687119285
177, 89, 252, 144, 255, 145, -3, -1, -2.819842099193151, 3.1622776601683795
177, 91, 208, 366, 211, 366, -3, 0, 3.141592653589793, 3.0
177, 97, 522, 366, 521, 367, 1, -1, -0.7853981633974483, 1.4142135623730951
178, 4, 246, 138, 248, 139, -2, -1, -2.677945044588987, 2.23606797749979
178, 13, 360, 141, 363, 141, -3, 0, 3.141592653589793, 3.0
178, 14, 93, 305, 95, 307, -2, -2, -2.356194490192345, 2.8284271247461903
178, 18, 196, 362, 198, 362, -2, 0, 3.141592653589793, 2.0
178, 22, 339, 364, 343, 365, -4, -1, -2.896613990462929, 4.123105625617661
178, 23, 272, 364, 275, 364, -3, 0, 3.141592653589793, 3.0
178, 39, 588, 249, 589, 252, -1, -3, -1.892546881191539, 3.1622776601683795
178, 48, 256, 363, 258, 364, -2, -1, -2.677945044588987, 2.23606797749979
178, 49, 219, 147, 222, 148, -3, -1, -2.819842099193151, 3.1622776601683795
178, 56, 129, 209, 133, 210, -4, -1, -2.896613990462929, 4.123105625617661
178, 60, 180, 166, 184, 169, -4, -3, -2.498091544796509, 5.0
178, 61, 187, 155, 190, 156, -3, -1, -2.819842099193151, 3.1622776601683795
178, 62, 97, 313, 100, 315, -3, -2, -2.5535900500422257, 3.605551275463989
178, 72, 118, 218, 123, 221, -5, -3, -2.601173153319209, 5.830951894845301
178, 73, 250, 143, 252, 144, -2, -1, -2.677945044588987, 2.23606797749979
178, 74, 298, 147, 300, 147, -2, 0, 3.141592653589793, 2.0
178, 75, 205, 366, 208, 366, -3, 0, 3.141592653589793, 3.0
178, 77, 159, 366, 161, 366, -2, 0, 3.141592653589793, 2.0
179, 12, 358, 140, 360, 141, -2, -1, -2.677945044588987, 2.23606797749979
179, 15, 194, 362, 196, 362, -2, 0, 3.141592653589793, 2.0
179, 19, 335, 363, 339, 364, -4, -1, -2.896613990462929, 4.123105625617661
179, 20, 269, 363, 272, 364, -3, -1, -2.819842099193151, 3.1622776601683795
179, 34, 588, 247, 588, 249, 0, -2, -1.5707963267948966, 2.0
179, 42, 254, 363, 256, 363, -2, 0, 3.141592653589793, 2.0
179, 43, 215, 146, 219, 147, -4, -1, -2.896613990462929, 4.123105625617661
179, 49, 126, 208, 129, 209, -3, -1, -2.819842099193151, 3.1622776601683795
179, 52, 162, 163, 164, 162, -2, 1, 2.677945044588987, 2.23606797749979
179, 53, 174, 165, 180, 166, -6, -1, -2.976443976175166, 6.082762530298219
179, 55, 95, 311, 97, 313, -2, -2, -2.356194490192345, 2.8284271247461903
179, 58, 205, 161, 207, 161, -2, 0, 3.141592653589793, 2.0
179, 64, 116, 216, 118, 218, -2, -2, -2.356194490192345, 2.8284271247461903
179, 65, 247, 142, 250, 143, -3, -1, -2.819842099193151, 3.1622776601683795
179, 66, 296, 147, 298, 147, -2, 0, 3.141592653589793, 2.0
179, 67, 202, 365, 205, 366, -3, -1, -2.819842099193151, 3.1622776601683795
179, 69, 157, 366, 159, 366, -2, 0, 3.141592653589793, 2.0
180, 24, 247, 139, 250, 140, -3, -1, -2.819842099193151, 3.1622776601683795
180, 30, 340, 367, 343, 367, -3, 0, 3.141592653589793, 3.0
180, 34, 221, 122, 223, 123, -2, -1, -2.677945044588987, 2.23606797749979
180, 38, 362, 143, 364, 144, -2, -1, -2.677945044588987, 2.23606797749979
180, 43, 340, 138, 342, 138, -2, 0, 3.141592653589793, 2.0
180, 44, 191, 153, 193, 154, -2, -1, -2.677945044588987, 2.23606797749979
180, 51, 200, 362, 202, 363, -2, -1, -2.677945044588987, 2.23606797749979
180, 58, 99, 315, 101, 318, -2, -3, -2.158798930342464, 3.605551275463989
180, 62, 580, 158, 581, 160, -1, -2, -2.0344439357957027, 2.23606797749979
180, 68, 589, 289, 590, 291, -1, -2, -2.0344439357957027, 2.23606797749979
180, 79, 586, 175, 586, 177, 0, -2, -1.5707963267948966, 2.0
180, 83, 177, 167, 183, 170, -6, -3, -2.677945044588987, 6.708203932499369
180, 88, 223, 149, 225, 151, -2, -2, -2.356194490192345, 2.8284271247461903
180, 90, 86, 244, 84, 245, 2, -1, -0.4636476090008061, 2.23606797749979
180, 97, 208, 365, 210, 365, -2, 0, 3.141592653589793, 2.0
180, 105, 165, 165, 167, 165, -2, 0, 3.141592653589793, 2.0
180, 107, 256, 366, 261, 367, -5, -1, -2.9441970937399127, 5.0990195135927845
180, 111, 208, 164, 212, 164, -4, 0, 3.141592653589793, 4.0
180, 113, 227, 135, 229, 135, -2, 0, 3.141592653589793, 2.0
180, 118, 588, 250, 589, 252, -1, -2, -2.0344439357957027, 2.23606797749979
180, 120, 249, 152, 251, 152, -2, 0, 3.141592653589793, 2.0
180, 122, 272, 365, 276, 365, -4, 0, 3.141592653589793, 4.0
180, 126, 161, 368, 163, 368, -2, 0, 3.141592653589793, 2.0
180, 138, 278, 163, 282, 163, -4, 0, 3.141592653589793, 4.0
180, 139, 299, 150, 301, 150, -2, 0, 3.141592653589793, 2.0
180, 143, 581, 286, 582, 289, -1, -3, -1.892546881191539, 3.1622776601683795
180, 144, 235, 143, 237, 144, -2, -1, -2.677945044588987, 2.23606797749979
181, 13, 244, 137, 247, 139, -3, -2, -2.5535900500422257, 3.605551275463989
181, 16, 156, 149, 158, 149, -2, 0, 3.141592653589793, 2.0
181, 19, 339, 368, 340, 367, -1, 1, 2.356194490192345, 1.4142135623730951
181, 26, 359, 142, 362, 143, -3, -1, -2.819842099193151, 3.1622776601683795
181, 31, 189, 153, 191, 153, -2, 0, 3.141592653589793, 2.0
181, 38, 197, 361, 200, 362, -3, -1, -2.819842099193151, 3.1622776601683795
181, 43, 96, 312, 99, 315, -3, -3, -2.356194490192345, 4.242640687119285
181, 51, 588, 287, 589, 289, -1, -2, -2.0344439357957027, 2.23606797749979
181, 60, 171, 164, 177, 167, -6, -3, -2.677945044588987, 6.708203932499369
181, 71, 206, 365, 208, 365, -2, 0, 3.141592653589793, 2.0
181, 77, 163, 166, 165, 165, -2, 1, 2.677945044588987, 2.23606797749979
181, 79, 251, 366, 256, 366, -5, 0, 3.141592653589793, 5.0
181, 82, 204, 163, 208, 164, -4, -1, -2.896613990462929, 4.123105625617661
181, 84, 225, 134, 227, 135, -2, -1, -2.677945044588987, 2.23606797749979
181, 89, 587, 248, 588, 250, -1, -2, -2.0344439357957027, 2.23606797749979
181, 91, 247, 151, 249, 152, -2, -1, -2.677945044588987, 2.23606797749979
181, 93, 268, 365, 272, 365, -4, 0, 3.141592653589793, 4.0
181, 95, 159, 368, 161, 368, -2, 0, 3.141592653589793, 2.0
181, 104, 274, 163, 278, 163, -4, 0, 3.141592653589793, 4.0
181, 105, 297, 150, 299, 150, -2, 0, 3.141592653589793, 2.0
181, 108, 581, 284, 581, 286, 0, -2, -1.5707963267948966, 2.0
182, 6, 242, 136, 244, 137, -2, -1, -2.677945044588987, 2.23606797749979
182, 11, 334, 368, 339, 368, -5, 0, 3.141592653589793, 5.0
182, 15, 218, 121, 220, 122, -2, -1, -2.677945044588987, 2.23606797749979
182, 16, 128, 170, 130, 170, -2, 0, 3.141592653589793, 2.0
182, 18, 357, 141, 359, 142, -2, -1, -2.677945044588987, 2.23606797749979
182, 21, 337, 138, 339, 138, -2, 0, 3.141592653589793, 2.0
182, 28, 194, 360, 197, 361, -3, -1, -2.819842099193151, 3.1622776601683795
182, 39, 588, 285, 588, 287, 0, -2, -1.5707963267948966, 2.0
182, 47, 169, 165, 171, 164, -2, 1, 2.677945044588987, 2.23606797749979
182, 55, 203, 365, 206, 365, -3, 0, 3.141592653589793, 3.0
182, 59, 229, 126, 231, 126, -2, 0, 3.141592653589793, 2.0
182, 62, 100, 264, 101, 266, -1, -2, -2.0344439357957027, 2.23606797749979
182, 63, 246, 365, 251, 366, -5, -1, -2.9441970937399127, 5.0990195135927845
182, 66, 202, 162, 204, 163, -2, -1, -2.677945044588987, 2.23606797749979
182, 71, 586, 246, 587, 248, -1, -2, -2.0344439357957027, 2.23606797749979
182, 73, 245, 151, 247, 151, -2, 0, 3.141592653589793, 2.0
182, 75, 264, 364, 268, 365, -4, -1, -2.896613990462929, 4.123105625617661
182, 77, 157, 368, 159, 368, -2, 0, 3.141592653589793, 2.0
182, 84, 270, 161, 274, 163, -4, -2, -2.677945044588987, 4.47213595499958
182, 85, 295, 150, 297, 150, -2, 0, 3.141592653589793, 2.0
182, 88, 581, 282, 581, 284, 0, -2, -1.5707963267948966, 2.0
183, 9, 329, 367, 334, 368, -5, -1, -2.9441970937399127, 5.0990195135927845
183, 10, 320, 127, 322, 128, -2, -1, -2.677945044588987, 2.23606797749979
183, 24, 191, 359, 194, 360, -3, -1, -2.819842099193151, 3.1622776601683795
183, 43, 83, 242, 85, 244, -2, -2, -2.356194490192345, 2.8284271247461903
183, 48, 200, 364, 203, 365, -3, -1, -2.819842099193151, 3.1622776601683795
183, 53, 160, 166, 162, 166, -2, 0, 3.141592653589793, 2.0
183, 54, 242, 365, 246, 365, -4, 0, 3.141592653589793, 4.0
183, 57, 200, 161, 202, 162, -2, -1, -2.677945044588987, 2.23606797749979
183, 62, 585, 244, 586, 246, -1, -2, -2.0344439357957027, 2.23606797749979
183, 63, 243, 150, 245, 151, -2, -1, -2.677945044588987, 2.23606797749979
183, 65, 261, 364, 264, 364, -3, 0, 3.141592653589793, 3.0
183, 67, 155, 368, 157, 368, -2, 0, 3.141592653589793, 2.0
183, 74, 265, 160, 270, 161, -5, -1, -2.9441970937399127, 5.0990195135927845
183, 75, 293, 150, 295, 150, -2, 0, 3.141592653589793, 2.0
183, 79, 596, 223, 595, 224, 1, -1, -0.7853981633974483, 1.4142135623730951
184, 9, 326, 367, 329, 367, -3, 0, 3.141592653589793, 3.0
184, 23, 187, 359, 191, 359, -4, 0, 3.141592653589793, 4.0
184, 25, 155, 139, 154, 140, 1, -1, -0.7853981633974483, 1.4142135623730951
184, 42, 197, 363, 200, 364, -3, -1, -2.819842099193151, 3.1622776601683795
184, 46, 238, 365, 242, 365, -4, 0, 3.141592653589793, 4.0
184, 53, 585, 242, 585, 244, 0, -2, -1.5707963267948966, 2.0
184, 54, 241, 149, 243, 150, -2, -1, -2.677945044588987, 2.23606797749979
184, 56, 258, 363, 261, 364, -3, -1, -2.819842099193151, 3.1622776601683795
184, 57, 152, 368, 155, 368, -3, 0, 3.141592653589793, 3.0
184, 64, 262, 160, 265, 160, -3, 0, 3.141592653589793, 3.0
184, 65, 291, 150, 293, 150, -2, 0, 3.141592653589793, 2.0
185, 4, 243, 137, 245, 138, -2, -1, -2.677945044588987, 2.23606797749979
185, 21, 327, 368, 331, 368, -4, 0, 3.141592653589793, 4.0
185, 32, 590, 284, 590, 286, 0, -2, -1.5707963267948966, 2.0
185, 34, 171, 166, 173, 166, -2, 0, 3.141592653589793, 2.0
185, 35, 358, 140, 360, 141, -2, -1, -2.677945044588987, 2.23606797749979
185, 52, 249, 116, 251, 117, -2, -1, -2.677945044588987, 2.23606797749979
185, 63, 192, 366, 195, 367, -3, -1, -2.819842099193151, 3.1622776601683795
185, 71, 96, 302, 97, 304, -1, -2, -2.0344439357957027, 2.23606797749979
185, 84, 200, 143, 202, 143, -2, 0, 3.141592653589793, 2.0
185, 91, 587, 245, 588, 247, -1, -2, -2.0344439357957027, 2.23606797749979
185, 99, 127, 171, 129, 171, -2, 0, 3.141592653589793, 2.0
185, 110, 202, 366, 205, 366, -3, 0, 3.141592653589793, 3.0
185, 111, 591, 214, 591, 216, 0, -2, -1.5707963267948966, 2.0
185, 120, 218, 148, 220, 149, -2, -1, -2.677945044588987, 2.23606797749979
185, 127, 243, 153, 245, 154, -2, -1, -2.677945044588987, 2.23606797749979
185, 128, 201, 163, 204, 163, -3, 0, 3.141592653589793, 3.0
186, 4, 241, 136, 243, 137, -2, -1, -2.677945044588987, 2.23606797749979
186, 18, 325, 368, 327, 368, -2, 0, 3.141592653589793, 2.0
186, 27, 590, 282, 590, 284, 0, -2, -1.5707963267948966, 2.0
186, 29, 169, 166, 171, 166, -2, 0, 3.141592653589793, 2.0
186, 30, 356, 139, 358, 140, -2, -1, -2.677945044588987, 2.23606797749979
186, 32, 333, 140, 335, 140, -2, 0, 3.141592653589793, 2.0
186, 46, 154, 151, 156, 151, -2, 0, 3.141592653589793, 2.0
186, 51, 189, 365, 192, 366, -3, -1, -2.819842099193151, 3.1622776601683795
186, 58, 96, 300, 96, 302, 0, -2, -1.5707963267948966, 2.0
186, 71, 198, 143, 200, 143, -2, 0, 3.141592653589793, 2.0
186, 76, 586, 243, 587, 245, -1, -2, -2.0344439357957027, 2.23606797749979
186, 92, 199, 366, 202, 366, -3, 0, 3.141592653589793, 3.0
186, 93, 591, 212, 591, 214, 0, -2, -1.5707963267948966, 2.0
186, 101, 215, 147, 218, 148, -3, -1, -2.819842099193151, 3.1622776601683795
186, 104, 224, 133, 226, 134, -2, -1, -2.677945044588987, 2.23606797749979
186, 107, 241, 153, 243, 153, -2, 0, 3.141592653589793, 2.0
186, 108, 198, 162, 201, 163, -3, -1, -2.819842099193151, 3.1622776601683795
187, 4, 239, 135, 241, 136, -2, -1, -2.677945044588987, 2.23606797749979
187, 16, 323, 367, 325, 368, -2, -1, -2.677945044588987, 2.23606797749979
187, 18, 75, 333, 76, 335, -1, -2, -2.0344439357957027, 2.23606797749979
187, 20, 81, 291, 80, 292, 1, -1, -0.7853981633974483, 1.4142135623730951
187, 25, 590, 280, 590, 282, 0, -2, -1.5707963267948966, 2.0
187, 28, 355, 140, 356, 139, -1, 1, 2.356194490192345, 1.4142135623730951
187, 48, 186, 364, 189, 365, -3, -1, -2.819842099193151, 3.1622776601683795
187, 53, 95, 298, 96, 300, -1, -2, -2.0344439357957027, 2.23606797749979
187, 63, 196, 142, 198, 143, -2, -1, -2.677945044588987, 2.23606797749979
187, 68, 585, 241, 586, 243, -1, -2, -2.0344439357957027, 2.23606797749979
187, 78, 195, 366, 199, 366, -4, 0, 3.141592653589793, 4.0
187, 79, 591, 210, 591, 212, 0, -2, -1.5707963267948966, 2.0
187, 85, 212, 147, 215, 147, -3, 0, 3.141592653589793, 3.0
187, 87, 222, 133, 224, 133, -2, 0, 3.141592653589793, 2.0
187, 89, 238, 152, 241, 153, -3, -1, -2.819842099193151, 3.1622776601683795
187, 90, 196, 161, 198, 162, -2, -1, -2.677945044588987, 2.23606797749979
188, 12, 321, 367, 323, 367, -2, 0, 3.141592653589793, 2.0
188, 19, 590, 278, 590, 280, 0, -2, -1.5707963267948966, 2.0
188, 21, 166, 166, 168, 166, -2, 0, 3.141592653589793, 2.0
188, 22, 353, 139, 355, 140, -2, -1, -2.677945044588987, 2.23606797749979
188, 24, 330, 140, 332, 140, -2, 0, 3.141592653589793, 2.0
188, 39, 183, 363, 186, 364, -3, -1, -2.819842099193151, 3.1622776601683795
188, 50, 194, 142, 196, 142, -2, 0, 3.141592653589793, 2.0
188, 54, 584, 239, 585, 241, -1, -2, -2.0344439357957027, 2.23606797749979
188, 63, 192, 365, 195, 366, -3, -1, -2.819842099193151, 3.1622776601683795
188, 64, 591, 208, 591, 210, 0, -2, -1.5707963267948966, 2.0
188, 70, 208, 146, 212, 147, -4, -1, -2.896613990462929, 4.123105625617661
188, 71, 220, 133, 222, 133, -2, 0, 3.141592653589793, 2.0
188, 73, 236, 151, 238, 152, -2, -1, -2.677945044588987, 2.23606797749979
189, 10, 218, 121, 220, 122, -2, -1, -2.677945044588987, 2.23606797749979
189, 12, 319, 366, 321, 367, -2, -1, -2.677945044588987, 2.23606797749979
189, 18, 590, 276, 590, 278, 0, -2, -1.5707963267948966, 2.0
189, 20, 164, 166, 166, 166, -2, 0, 3.141592653589793, 2.0
189, 21, 351, 139, 353, 139, -2, 0, 3.141592653589793, 2.0
189, 23, 328, 140, 330, 140, -2, 0, 3.141592653589793, 2.0
189, 34, 150, 151, 152, 151, -2, 0, 3.141592653589793, 2.0
189, 36, 181, 362, 183, 363, -2, -1, -2.677945044588987, 2.23606797749979
189, 45, 191, 142, 194, 142, -3, 0, 3.141592653589793, 3.0
189, 49, 583, 237, 584, 239, -1, -2, -2.0344439357957027, 2.23606797749979
189, 57, 189, 365, 192, 365, -3, 0, 3.141592653589793, 3.0
189, 58, 591, 206, 591, 208, 0, -2, -1.5707963267948966, 2.0
189, 63, 206, 145, 208, 146, -2, -1, -2.677945044588987, 2.23606797749979
189, 65, 234, 151, 236, 151, -2, 0, 3.141592653589793, 2.0
190, 8, 239, 136, 241, 137, -2, -1, -2.677945044588987, 2.23606797749979
190, 20, 355, 142, 357, 142, -2, 0, 3.141592653589793, 2.0
190, 27, 167, 167, 169, 167, -2, 0, 3.141592653589793, 2.0
190, 34, 187, 159, 189, 159, -2, 0, 3.141592653589793, 2.0
190, 40, 578, 156, 580, 159, -2, -3, -2.158798930342464, 3.605551275463989
190, 53, 593, 280, 594, 282, -1, -2, -2.0344439357957027, 2.23606797749979
190, 54, 325, 367, 327, 368, -2, -1, -2.677945044588987, 2.23606797749979
190, 55, 185, 366, 189, 366, -4, 0, 3.141592653589793, 4.0
190, 60, 124, 172, 126, 172, -2, 0, 3.141592653589793, 2.0
190, 86, 212, 148, 215, 148, -3, 0, 3.141592653589793, 3.0
190, 92, 230, 127, 232, 128, -2, -1, -2.677945044588987, 2.23606797749979
190, 107, 152, 152, 154, 152, -2, 0, 3.141592653589793, 2.0
190, 111, 194, 366, 197, 366, -3, 0, 3.141592653589793, 3.0
190, 112, 588, 241, 589, 243, -1, -2, -2.0344439357957027, 2.23606797749979
190, 114, 96, 298, 97, 300, -1, -2, -2.0344439357957027, 2.23606797749979
190, 127, 193, 143, 195, 143, -2, 0, 3.141592653589793, 2.0
190, 130, 228, 146, 230, 146, -2, 0, 3.141592653589793, 2.0
190, 133, 223, 135, 225, 135, -2, 0, 3.141592653589793, 2.0
190, 142, 591, 209, 591, 211, 0, -2, -1.5707963267948966, 2.0
191, 7, 237, 136, 239, 136, -2, 0, 3.141592653589793, 2.0
191, 23, 165, 167, 167, 167, -2, 0, 3.141592653589793, 2.0
191, 25, 135, 172, 136, 171, -1, 1, 2.356194490192345, 1.4142135623730951
191, 26, 219, 122, 221, 122, -2, 0, 3.141592653589793, 2.0
191, 30, 185, 159, 187, 159, -2, 0, 3.141592653589793, 2.0
191, 44, 592, 278, 593, 280, -1, -2, -2.0344439357957027, 2.23606797749979
191, 46, 182, 367, 185, 366, -3, 1, 2.819842099193151, 3.1622776601683795
191, 67, 209, 148, 212, 148, -3, 0, 3.141592653589793, 3.0
191, 86, 150, 152, 152, 152, -2, 0, 3.141592653589793, 2.0
191, 90, 191, 366, 194, 366, -3, 0, 3.141592653589793, 3.0
191, 91, 587, 239, 588, 241, -1, -2, -2.0344439357957027, 2.23606797749979
191, 105, 195, 164, 197, 164, -2, 0, 3.141592653589793, 2.0
191, 109, 221, 135, 223, 135, -2, 0, 3.141592653589793, 2.0
191, 117, 591, 207, 591, 209, 0, -2, -1.5707963267948966, 2.0
192, 5, 235, 136, 237, 136, -2, 0, 3.141592653589793, 2.0
192, 19, 163, 167, 165, 167, -2, 0, 3.141592653589793, 2.0
192, 26, 183, 158, 185, 159, -2, -1, -2.677945044588987, 2.23606797749979
192, 38, 322, 367, 324, 367, -2, 0, 3.141592653589793, 2.0
192, 39, 179, 366, 182, 367, -3, -1, -2.819842099193151, 3.1622776601683795
192, 58, 207, 147, 209, 148, -2, -1, -2.677945044588987, 2.23606797749979
192, 63, 227, 127, 229, 127, -2, 0, 3.141592653589793, 2.0
192, 79, 188, 365, 191, 366, -3, -1, -2.819842099193151, 3.1622776601683795
192, 80, 587, 237, 587, 239, 0, -2, -1.5707963267948966, 2.0
192, 88, 334, 144, 336, 144, -2, 0, 3.141592653589793, 2.0
192, 91, 190, 142, 192, 143, -2, -1, -2.677945044588987, 2.23606797749979
192, 93, 225, 146, 227, 146, -2, 0, 3.141592653589793, 2.0
192, 96, 219, 134, 221, 135, -2, -1, -2.677945044588987, 2.23606797749979
192, 101, 591, 205, 591, 207, 0, -2, -1.5707963267948966, 2.0
193, 10, 351, 142, 353, 142, -2, 0, 3.141592653589793, 2.0
193, 21, 181, 159, 183, 158, -2, 1, 2.677945044588987, 2.23606797749979
193, 30, 591, 275, 592, 277, -1, -2, -2.0344439357957027, 2.23606797749979
193, 31, 320, 367, 322, 367, -2, 0, 3.141592653589793, 2.0
193, 32, 176, 366, 179, 366, -3, 0, 3.141592653589793, 3.0
193, 44, 205, 147, 207, 147, -2, 0, 3.141592653589793, 2.0
193, 59, 185, 365, 188, 365, -3, 0, 3.141592653589793, 3.0
193, 60, 586, 234, 587, 237, -1, -3, -1.892546881191539, 3.1622776601683795
193, 68, 192, 165, 194, 164, -2, 1, 2.677945044588987, 2.23606797749979
193, 69, 223, 146, 225, 146, -2, 0, 3.141592653589793, 2.0
194, 11, 160, 167, 162, 167, -2, 0, 3.141592653589793, 2.0
194, 14, 215, 121, 217, 122, -2, -1, -2.677945044588987, 2.23606797749979
194, 17, 179, 159, 181, 159, -2, 0, 3.141592653589793, 2.0
194, 24, 591, 273, 591, 275, 0, -2, -1.5707963267948966, 2.0
194, 25, 318, 367, 320, 367, -2, 0, 3.141592653589793, 2.0
194, 26, 173, 365, 176, 366, -3, -1, -2.819842099193151, 3.1622776601683795
194, 38, 152, 137, 154, 137, -2, 0, 3.141592653589793, 2.0
194, 47, 182, 365, 185, 365, -3, 0, 3.141592653589793, 3.0
194, 48, 586, 232, 586, 234, 0, -2, -1.5707963267948966, 2.0
194, 57, 221, 146, 223, 146, -2, 0, 3.141592653589793, 2.0
195, 0, 236, 136, 238, 137, -2, -1, -2.677945044588987, 2.23606797749979
195, 23, 179, 361, 182, 362, -3, -1, -2.819842099193151, 3.1622776601683795
195, 26, 165, 168, 167, 168, -2, 0, 3.141592653589793, 2.0
195, 34, 216, 364, 220, 365, -4, -1, -2.896613990462929, 4.123105625617661
195, 35, 593, 277, 593, 279, 0, -2, -1.5707963267948966, 2.0
195, 43, 321, 367, 323, 367, -2, 0, 3.141592653589793, 2.0
195, 45, 582, 200, 584, 201, -2, -1, -2.677945044588987, 2.23606797749979
195, 46, 351, 144, 353, 144, -2, 0, 3.141592653589793, 2.0
195, 57, 237, 363, 242, 364, -5, -1, -2.9441970937399127, 5.0990195135927845
195, 62, 207, 148, 210, 148, -3, 0, 3.141592653589793, 3.0
195, 67, 191, 366, 194, 366, -3, 0, 3.141592653589793, 3.0
195, 70, 94, 143, 96, 144, -2, -1, -2.677945044588987, 2.23606797749979
195, 84, 314, 117, 316, 118, -2, -1, -2.677945044588987, 2.23606797749979
195, 93, 587, 235, 588, 238, -1, -3, -1.892546881191539, 3.1622776601683795
195, 103, 46, 117, 49, 117, -3, 0, 3.141592653589793, 3.0
195, 104, 191, 164, 193, 163, -2, 1, 2.677945044588987, 2.23606797749979
195, 106, 148, 364, 147, 365, 1, -1, -0.7853981633974483, 1.4142135623730951
195, 127, 286, 154, 288, 154, -2, 0, 3.141592653589793, 2.0
195, 144, 156, 177, 157, 176, -1, 1, 2.356194490192345, 1.4142135623730951
195, 146, 254, 161, 257, 162, -3, -1, -2.819842099193151, 3.1622776601683795
195, 148, 332, 139, 334, 139, -2, 0, 3.141592653589793, 2.0
196, 0, 234, 135, 236, 136, -2, -1, -2.677945044588987, 2.23606797749979
196, 18, 176, 360, 179, 361, -3, -1, -2.819842099193151, 3.1622776601683795
196, 20, 163, 168, 165, 168, -2, 0, 3.141592653589793, 2.0
196, 26, 214, 363, 216, 364, -2, -1, -2.677945044588987, 2.23606797749979
196, 27, 593, 273, 593, 277, 0, -4, -1.5707963267948966, 4.0
196, 34, 319, 366, 321, 367, -2, -1, -2.677945044588987, 2.23606797749979
196, 36, 349, 144, 351, 144, -2, 0, 3.141592653589793, 2.0
196, 45, 232, 362, 237, 363, -5, -1, -2.9441970937399127, 5.0990195135927845
196, 50, 205, 148, 207, 148, -2, 0, 3.141592653589793, 2.0
196, 52, 592, 202, 593, 204, -1, -2, -2.0344439357957027, 2.23606797749979
196, 54, 188, 366, 191, 366, -3, 0, 3.141592653589793, 3.0
196, 74, 586, 231, 587, 235, -1, -4, -1.8157749899217608, 4.123105625617661
196, 81, 189, 165, 191, 164, -2, 1, 2.677945044588987, 2.23606797749979
196, 97, 283, 153, 286, 154, -3, -1, -2.819842099193151, 3.1622776601683795
196, 112, 155, 179, 156, 177, -1, 2, 2.0344439357957027, 2.23606797749979
196, 114, 250, 161, 254, 161, -4, 0, 3.141592653589793, 4.0
196, 115, 224, 148, 226, 148, -2, 0, 3.141592653589793, 2.0
196, 116, 330, 139, 332, 139, -2, 0, 3.141592653589793, 2.0
197, 0, 232, 134, 234, 135, -2, -1, -2.677945044588987, 2.23606797749979
197, 17, 174, 359, 176, 360, -2, -1, -2.677945044588987, 2.23606797749979
197, 19, 161, 167, 163, 168, -2, -1, -2.677945044588987, 2.23606797749979
197, 25, 211, 363, 214, 363, -3, 0, 3.141592653589793, 3.0
197, 26, 592, 270, 593, 273, -1, -3, -1.892546881191539, 3.1622776601683795
197, 31, 317, 365, 319, 366, -2, -1, -2.677945044588987, 2.23606797749979
197, 33, 347, 143, 349, 144, -2, -1, -2.677945044588987, 2.23606797749979
197, 41, 227, 362, 232, 362, -5, 0, 3.141592653589793, 5.0
197, 43, 597, 166, 595, 167, 2, -1, -0.4636476090008061, 2.23606797749979
197, 46, 203, 148, 205, 148, -2, 0, 3.141592653589793, 2.0
197, 49, 185, 366, 188, 366, -3, 0, 3.141592653589793, 3.0
197, 65, 585, 229, 586, 231, -1, -2, -2.0344439357957027, 2.23606797749979
197, 87, 280, 153, 283, 153, -3, 0, 3.141592653589793, 3.0
197, 100, 154, 180, 155, 179, -1, 1, 2.356194490192345, 1.4142135623730951
197, 102, 245, 161, 250, 161, -5, 0, 3.141592653589793, 5.0
197, 103, 222, 149, 224, 148, -2, 1, 2.677945044588987, 2.23606797749979
198, 0, 230, 133, 232, 134, -2, -1, -2.677945044588987, 2.23606797749979
198, 14, 180, 163, 181, 162, -1, 1, 2.356194490192345, 1.4142135623730951
198, 15, 173, 360, 174, 359, -1, 1, 2.356194490192345, 1.4142135623730951
198, 17, 159, 167, 161, 167, -2, 0, 3.141592653589793, 2.0
198, 21, 209, 363, 211, 363, -2, 0, 3.141592653589793, 2.0
198, 22, 591, 268, 592, 270, -1, -2, -2.0344439357957027, 2.23606797749979
198, 25, 315, 364, 317, 365, -2, -1, -2.677945044588987, 2.23606797749979
198, 27, 345, 143, 347, 143, -2, 0, 3.141592653589793, 2.0
198, 34, 224, 362, 227, 362, -3, 0, 3.141592653589793, 3.0
198, 38, 201, 148, 203, 148, -2, 0, 3.141592653589793, 2.0
198, 41, 182, 366, 185, 366, -3, 0, 3.141592653589793, 3.0
198, 55, 585, 226, 585, 229, 0, -3, -1.5707963267948966, 3.0
198, 87, 152, 181, 154, 180, -2, 1, 2.677945044588987, 2.23606797749979
198, 89, 242, 159, 245, 161, -3, -2, -2.5535900500422257, 3.605551275463989
198, 90, 220, 149, 222, 149, -2, 0, 3.141592653589793, 2.0
199, 0, 228, 132, 230, 133, -2, -1, -2.677945044588987, 2.23606797749979
199, 14, 179, 164, 180, 163, -1, 1, 2.356194490192345, 1.4142135623730951
199, 15, 171, 360, 173, 360, -2, 0, 3.141592653589793, 2.0
199, 21, 207, 363, 209, 363, -2, 0, 3.141592653589793, 2.0
199, 22, 591, 266, 591, 268, 0, -2, -1.5707963267948966, 2.0
199, 26, 342, 143, 345, 143, -3, 0, 3.141592653589793, 3.0
199, 39, 180, 366, 182, 366, -2, 0, 3.141592653589793, 2.0
199, 50, 586, 224, 585, 226, 1, -2, -1.1071487177940904, 2.23606797749979
199, 67, 277, 152, 279, 153, -2, -1, -2.677945044588987, 2.23606797749979
199, 74, 150, 182, 152, 181, -2, 1, 2.677945044588987, 2.23606797749979
199, 76, 239, 159, 242, 159, -3, 0, 3.141592653589793, 3.0
199, 77, 218, 149, 220, 149, -2, 0, 3.141592653589793, 2.0
199, 78, 326, 139, 328, 139, -2, 0, 3.141592653589793, 2.0
200, 2, 348, 145, 350, 145, -2, 0, 3.141592653589793, 2.0
200, 7, 232, 136, 234, 137, -2, -1, -2.677945044588987, 2.23606797749979
200, 28, 175, 363, 177, 363, -2, 0, 3.141592653589793, 2.0
200, 37, 182, 364, 184, 364, -2, 0, 3.141592653589793, 2.0
200, 40, 581, 197, 583, 199, -2, -2, -2.356194490192345, 2.8284271247461903
200, 45, 316, 366, 319, 367, -3, -1, -2.819842099193151, 3.1622776601683795
200, 48, 590, 268, 591, 271, -1, -3, -1.892546881191539, 3.1622776601683795
200, 49, 222, 365, 228, 366, -6, -1, -2.976443976175166, 6.082762530298219
200, 53, 162, 168, 164, 168, -2, 0, 3.141592653589793, 2.0
200, 55, 184, 159, 185, 158, -1, 1, 2.356194490192345, 1.4142135623730951
200, 66, 204, 149, 206, 149, -2, 0, 3.141592653589793, 2.0
200, 79, 586, 229, 587, 232, -1, -3, -1.892546881191539, 3.1622776601683795
200, 91, 190, 163, 191, 162, -1, 1, 2.356194490192345, 1.4142135623730951
200, 94, 130, 124, 132, 124, -2, 0, 3.141592653589793, 2.0
200, 95, 304, 118, 306, 119, -2, -1, -2.677945044588987, 2.23606797749979
200, 111, 192, 170, 194, 169, -2, 1, 2.677945044588987, 2.23606797749979
200, 123, 247, 161, 250, 162, -3, -1, -2.819842099193151, 3.1622776601683795
200, 124, 160, 176, 162, 176, -2, 0, 3.141592653589793, 2.0
200, 126, 213, 366, 215, 366, -2, 0, 3.141592653589793, 2.0
200, 130, 221, 148, 222, 147, -1, 1, 2.356194490192345, 1.4142135623730951
200, 137, 231, 154, 233, 154, -2, 0, 3.141592653589793, 2.0
200, 138, 282, 154, 284, 155, -2, -1, -2.677945044588987, 2.23606797749979
200, 142, 290, 132, 292, 133, -2, -1, -2.677945044588987, 2.23606797749979
200, 148, 582, 269, 583, 272, -1, -3, -1.892546881191539, 3.1622776601683795
201, 2, 346, 146, 348, 145, -2, 1, 2.677945044588987, 2.23606797749979
201, 21, 173, 362, 175, 363, -2, -1, -2.677945044588987, 2.23606797749979
201, 31, 580, 195, 581, 197, -1, -2, -2.0344439357957027, 2.23606797749979
201, 36, 314, 365, 316, 366, -2, -1, -2.677945044588987, 2.23606797749979
201, 39, 590, 266, 590, 268, 0, -2, -1.5707963267948966, 2.0
201, 40, 218, 364, 222, 365, -4, -1, -2.896613990462929, 4.123105625617661
201, 44, 160, 168, 162, 168, -2, 0, 3.141592653589793, 2.0
201, 45, 183, 160, 184, 159, -1, 1, 2.356194490192345, 1.4142135623730951
201, 53, 202, 149, 204, 149, -2, 0, 3.141592653589793, 2.0
201, 55, 596, 169, 597, 168, -1, 1, 2.356194490192345, 1.4142135623730951
201, 64, 586, 227, 586, 229, 0, -2, -1.5707963267948966, 2.0
201, 71, 189, 164, 190, 163, -1, 1, 2.356194490192345, 1.4142135623730951
201, 87, 190, 171, 192, 170, -2, 1, 2.677945044588987, 2.23606797749979
201, 99, 243, 161, 247, 161, -4, 0, 3.141592653589793, 4.0
201, 102, 211, 366, 213, 366, -2, 0, 3.141592653589793, 2.0
201, 106, 219, 148, 221, 148, -2, 0, 3.141592653589793, 2.0
201, 111, 228, 154, 231, 154, -3, 0, 3.141592653589793, 3.0
201, 112, 280, 153, 282, 154, -2, -1, -2.677945044588987, 2.23606797749979
201, 116, 288, 132, 290, 132, -2, 0, 3.141592653589793, 2.0
201, 122, 581, 266, 582, 269, -1, -3, -1.892546881191539, 3.1622776601683795
202, 2, 343, 146, 346, 146, -3, 0, 3.141592653589793, 3.0
202, 5, 229, 136, 231, 136, -2, 0, 3.141592653589793, 2.0
202, 18, 171, 361, 173, 362, -2, -1, -2.677945044588987, 2.23606797749979
202, 23, 179, 364, 181, 364, -2, 0, 3.141592653589793, 2.0
202, 25, 218, 128, 220, 128, -2, 0, 3.141592653589793, 2.0
202, 26, 578, 193, 580, 195, -2, -2, -2.356194490192345, 2.8284271247461903
202, 31, 312, 365, 314, 365, -2, 0, 3.141592653589793, 2.0
202, 33, 590, 263, 590, 266, 0, -3, -1.5707963267948966, 3.0
202, 34, 216, 363, 218, 364, -2, -1, -2.677945044588987, 2.23606797749979
202, 38, 158, 168, 160, 168, -2, 0, 3.141592653589793, 2.0
202, 39, 182, 161, 183, 160, -1, 1, 2.356194490192345, 1.4142135623730951
202, 55, 586, 225, 586, 227, 0, -2, -1.5707963267948966, 2.0
202, 60, 188, 165, 189, 164, -1, 1, 2.356194490192345, 1.4142135623730951
202, 73, 189, 172, 190, 171, -1, 1, 2.356194490192345, 1.4142135623730951
202, 81, 240, 160, 243, 161, -3, -1, -2.819842099193151, 3.1622776601683795
202, 84, 209, 366, 211, 366, -2, 0, 3.141592653589793, 2.0
202, 87, 217, 148, 219, 148, -2, 0, 3.141592653589793, 2.0
202, 90, 226, 155, 228, 154, -2, 1, 2.677945044588987, 2.23606797749979
202, 91, 278, 152, 280, 153, -2, -1, -2.677945044588987, 2.23606797749979
202, 99, 580, 263, 581, 266, -1, -3, -1.892546881191539, 3.1622776601683795
203, 1, 340, 146, 343, 146, -3, 0, 3.141592653589793, 3.0
203, 17, 169, 360, 171, 361, -2, -1, -2.677945044588987, 2.23606797749979
203, 21, 177, 364, 179, 364, -2, 0, 3.141592653589793, 2.0
203, 23, 577, 191, 578, 193, -1, -2, -2.0344439357957027, 2.23606797749979
203, 28, 310, 365, 312, 365, -2, 0, 3.141592653589793, 2.0
203, 29, 590, 261, 590, 263, 0, -2, -1.5707963267948966, 2.0
203, 30, 214, 362, 216, 363, -2, -1, -2.677945044588987, 2.23606797749979
203, 34, 156, 168, 158, 168, -2, 0, 3.141592653589793, 2.0
203, 47, 585, 223, 586, 225, -1, -2, -2.0344439357957027, 2.23606797749979
203, 52, 187, 166, 188, 165, -1, 1, 2.356194490192345, 1.4142135623730951
203, 63, 187, 173, 189, 172, -2, 1, 2.677945044588987, 2.23606797749979
203, 73, 207, 365, 209, 366, -2, -1, -2.677945044588987, 2.23606797749979
203, 79, 224, 155, 226, 155, -2, 0, 3.141592653589793, 2.0
203, 80, 276, 152, 278, 152, -2, 0, 3.141592653589793, 2.0
203, 86, 579, 261, 580, 263, -1, -2, -2.0344439357957027, 2.23606797749979
204, 1, 336, 145, 340, 146, -4, -1, -2.896613990462929, 4.123105625617661
204, 16, 197, 131, 199, 131, -2, 0, 3.141592653589793, 2.0
204, 19, 576, 189, 577, 191, -1, -2, -2.0344439357957027, 2.23606797749979
204, 21, 95, 304, 95, 306, 0, -2, -1.5707963267948966, 2.0
204, 24, 308, 365, 310, 365, -2, 0, 3.141592653589793, 2.0
204, 25, 211, 362, 214, 362, -3, 0, 3.141592653589793, 3.0
204, 29, 154, 167, 156, 168, -2, -1, -2.677945044588987, 2.23606797749979
204, 36, 240, 117, 242, 118, -2, -1, -2.677945044588987, 2.23606797749979
204, 41, 585, 221, 585, 223, 0, -2, -1.5707963267948966, 2.0
204, 53, 184, 174, 187, 173, -3, 1, 2.819842099193151, 3.1622776601683795
204, 63, 205, 365, 207, 365, -2, 0, 3.141592653589793, 2.0
204, 65, 214, 147, 216, 148, -2, -1, -2.677945044588987, 2.23606797749979
204, 75, 579, 259, 579, 261, 0, -2, -1.5707963267948966, 2.0
205, 4, 343, 147, 345, 148, -2, -1, -2.677945044588987, 2.23606797749979
205, 14, 202, 149, 204, 149, -2, 0, 3.141592653589793, 2.0
205, 17, 312, 367, 314, 367, -2, 0, 3.141592653589793, 2.0
205, 24, 187, 167, 189, 166, -2, 1, 2.677945044588987, 2.23606797749979
205, 27, 157, 168, 159, 169, -2, -1, -2.677945044588987, 2.23606797749979
205, 41, 181, 162, 182, 161, -1, 1, 2.356194490192345, 1.4142135623730951
205, 53, 215, 364, 217, 365, -2, -1, -2.677945044588987, 2.23606797749979
205, 61, 208, 365, 210, 366, -2, -1, -2.677945044588987, 2.23606797749979
205, 67, 591, 263, 591, 266, 0, -3, -1.5707963267948966, 3.0
205, 68, 587, 225, 588, 227, -1, -2, -2.0344439357957027, 2.23606797749979
205, 75, 576, 193, 577, 195, -1, -2, -2.0344439357957027, 2.23606797749979
205, 83, 239, 162, 241, 162, -2, 0, 3.141592653589793, 2.0
205, 88, 182, 367, 184, 367, -2, 0, 3.141592653589793, 2.0
205, 97, 153, 176, 155, 176, -2, 0, 3.141592653589793, 2.0
205, 110, 223, 158, 225, 158, -2, 0, 3.141592653589793, 2.0
205, 115, 146, 188, 148, 187, -2, 1, 2.677945044588987, 2.23606797749979
205, 119, 217, 151, 219, 150, -2, 1, 2.677945044588987, 2.23606797749979
205, 132, 579, 224, 580, 227, -1, -3, -1.892546881191539, 3.1622776601683795
205, 138, 335, 143, 335, 145, 0, -2, -1.5707963267948966, 2.0
206, 4, 340, 148, 343, 147, -3, 1, 2.819842099193151, 3.1622776601683795
206, 12, 201, 150, 202, 149, -1, 1, 2.356194490192345, 1.4142135623730951
206, 14, 309, 366, 312, 367, -3, -1, -2.819842099193151, 3.1622776601683795
206, 16, 94, 308, 95, 310, -1, -2, -2.0344439357957027, 2.23606797749979
206, 17, 216, 127, 218, 128, -2, -1, -2.677945044588987, 2.23606797749979
206, 19, 185, 167, 187, 167, -2, 0, 3.141592653589793, 2.0
206, 42, 213, 363, 215, 364, -2, -1, -2.677945044588987, 2.23606797749979
206, 49, 206, 364, 208, 365, -2, -1, -2.677945044588987, 2.23606797749979
206, 52, 590, 261, 591, 263, -1, -2, -2.0344439357957027, 2.23606797749979
206, 53, 586, 223, 587, 225, -1, -2, -2.0344439357957027, 2.23606797749979
206, 59, 575, 191, 576, 193, -1, -2, -2.0344439357957027, 2.23606797749979
206, 65, 236, 162, 239, 162, -3, 0, 3.141592653589793, 3.0
206, 76, 151, 176, 153, 176, -2, 0, 3.141592653589793, 2.0
206, 84, 221, 158, 223, 158, -2, 0, 3.141592653589793, 2.0
206, 88, 144, 188, 146, 188, -2, 0, 3.141592653589793, 2.0
206, 90, 215, 151, 217, 151, -2, 0, 3.141592653589793, 2.0
206, 96, 325, 143, 327, 143, -2, 0, 3.141592653589793, 2.0
206, 100, 578, 222, 579, 224, -1, -2, -2.0344439357957027, 2.23606797749979
206, 106, 333, 143, 335, 143, -2, 0, 3.141592653589793, 2.0
207, 3, 338, 148, 340, 148, -2, 0, 3.141592653589793, 2.0
207, 13, 307, 366, 309, 366, -2, 0, 3.141592653589793, 2.0
207, 17, 184, 168, 185, 167, -1, 1, 2.356194490192345, 1.4142135623730951
207, 30, 178, 163, 180, 162, -2, 1, 2.677945044588987, 2.23606797749979
207, 38, 210, 362, 213, 363, -3, -1, -2.819842099193151, 3.1622776601683795
207, 43, 204, 363, 206, 364, -2, -1, -2.677945044588987, 2.23606797749979
207, 44, 142, 159, 143, 158, -1, 1, 2.356194490192345, 1.4142135623730951
207, 45, 589, 259, 590, 261, -1, -2, -2.0344439357957027, 2.23606797749979
207, 46, 585, 221, 586, 223, -1, -2, -2.0344439357957027, 2.23606797749979
207, 52, 574, 189, 575, 191, -1, -2, -2.0344439357957027, 2.23606797749979
207, 55, 233, 162, 236, 162, -3, 0, 3.141592653589793, 3.0
207, 58, 179, 367, 181, 367, -2, 0, 3.141592653589793, 2.0
207, 72, 219, 158, 221, 158, -2, 0, 3.141592653589793, 2.0
207, 75, 142, 188, 144, 188, -2, 0, 3.141592653589793, 2.0
207, 77, 213, 152, 215, 151, -2, 1, 2.677945044588987, 2.23606797749979
207, 82, 322, 143, 325, 143, -3, 0, 3.141592653589793, 3.0
207, 86, 577, 220, 578, 222, -1, -2, -2.0344439357957027, 2.23606797749979
207, 91, 330, 142, 333, 143, -3, -1, -2.819842099193151, 3.1622776601683795
208, 3, 336, 148, 338, 148, -2, 0, 3.141592653589793, 2.0
208, 13, 304, 366, 307, 366, -3, 0, 3.141592653589793, 3.0
208, 16, 182, 168, 184, 168, -2, 0, 3.141592653589793, 2.0
208, 31, 226, 137, 228, 137, -2, 0, 3.141592653589793, 2.0
208, 34, 207, 361, 210, 362, -3, -1, -2.819842099193151, 3.1622776601683795
208, 39, 202, 362, 204, 363, -2, -1, -2.677945044588987, 2.23606797749979
208, 41, 588, 257, 589, 259, -1, -2, -2.0344439357957027, 2.23606797749979
208, 42, 584, 219, 585, 221, -1, -2, -2.0344439357957027, 2.23606797749979
208, 48, 573, 187, 574, 189, -1, -2, -2.0344439357957027, 2.23606797749979
208, 51, 230, 162, 233, 162, -3, 0, 3.141592653589793, 3.0
208, 59, 148, 175, 150, 176, -2, -1, -2.677945044588987, 2.23606797749979
208, 67, 217, 158, 219, 158, -2, 0, 3.141592653589793, 2.0
208, 70, 140, 188, 142, 188, -2, 0, 3.141592653589793, 2.0
208, 76, 320, 142, 322, 143, -2, -1, -2.677945044588987, 2.23606797749979
208, 80, 577, 218, 577, 220, 0, -2, -1.5707963267948966, 2.0
208, 83, 328, 141, 330, 142, -2, -1, -2.677945044588987, 2.23606797749979
209, 3, 334, 148, 336, 148, -2, 0, 3.141592653589793, 2.0
209, 6, 372, 133, 374, 133, -2, 0, 3.141592653589793, 2.0
209, 13, 301, 366, 304, 366, -3, 0, 3.141592653589793, 3.0
209, 16, 180, 168, 182, 168, -2, 0, 3.141592653589793, 2.0
209, 26, 175, 163, 177, 163, -2, 0, 3.141592653589793, 2.0
209, 32, 204, 360, 207, 361, -3, -1, -2.819842099193151, 3.1622776601683795
209, 34, 199, 362, 202, 362, -3, 0, 3.141592653589793, 3.0
209, 36, 587, 254, 588, 257, -1, -3, -1.892546881191539, 3.1622776601683795
209, 37, 583, 217, 584, 219, -1, -2, -2.0344439357957027, 2.23606797749979
209, 43, 571, 186, 573, 187, -2, -1, -2.677945044588987, 2.23606797749979
209, 46, 227, 163, 230, 162, -3, 1, 2.819842099193151, 3.1622776601683795
209, 54, 146, 175, 148, 175, -2, 0, 3.141592653589793, 2.0
209, 61, 215, 158, 217, 158, -2, 0, 3.141592653589793, 2.0
209, 64, 138, 188, 140, 188, -2, 0, 3.141592653589793, 2.0
209, 69, 318, 141, 320, 142, -2, -1, -2.677945044588987, 2.23606797749979
209, 72, 577, 216, 577, 218, 0, -2, -1.5707963267948966, 2.0
209, 75, 325, 140, 328, 141, -3, -1, -2.819842099193151, 3.1622776601683795
210, 4, 227, 137, 229, 138, -2, -1, -2.677945044588987, 2.23606797749979
210, 12, 170, 362, 172, 363, -2, -1, -2.677945044588987, 2.23606797749979
210, 24, 99, 260, 100, 262, -1, -2, -2.0344439357957027, 2.23606797749979
210, 31, 337, 149, 340, 149, -3, 0, 3.141592653589793, 3.0
210, 33, 305, 367, 308, 368, -3, -1, -2.819842099193151, 3.1622776601683795
210, 57, 585, 220, 586, 222, -1, -2, -2.0344439357957027, 2.23606797749979
210, 82, 213, 363, 215, 364, -2, -1, -2.677945044588987, 2.23606797749979
210, 85, 176, 367, 178, 368, -2, -1, -2.677945044588987, 2.23606797749979
210, 88, 233, 162, 236, 162, -3, 0, 3.141592653589793, 3.0
210, 102, 578, 189, 579, 191, -1, -2, -2.0344439357957027, 2.23606797749979
210, 121, 204, 366, 206, 366, -2, 0, 3.141592653589793, 2.0
210, 133, 273, 154, 275, 154, -2, 0, 3.141592653589793, 2.0
210, 138, 590, 257, 590, 260, 0, -3, -1.5707963267948966, 3.0
210, 139, 322, 142, 324, 143, -2, -1, -2.677945044588987, 2.23606797749979
210, 142, 583, 257, 583, 259, 0, -2, -1.5707963267948966, 2.0
211, 24, 334, 149, 337, 149, -3, 0, 3.141592653589793, 3.0
211, 26, 302, 366, 305, 367, -3, -1, -2.819842099193151, 3.1622776601683795
211, 32, 179, 171, 181, 169, -2, 2, 2.356194490192345, 2.8284271247461903
211, 40, 176, 164, 177, 163, -1, 1, 2.356194490192345, 1.4142135623730951
211, 45, 135, 117, 137, 117, -2, 0, 3.141592653589793, 2.0
211, 48, 585, 218, 585, 220, 0, -2, -1.5707963267948966, 2.0
211, 67, 211, 363, 213, 363, -2, 0, 3.141592653589793, 2.0
211, 73, 231, 162, 233, 162, -2, 0, 3.141592653589793, 2.0
211, 81, 251, 123, 253, 124, -2, -1, -2.677945044588987, 2.23606797749979
211, 87, 577, 187, 578, 189, -1, -2, -2.0344439357957027, 2.23606797749979
211, 97, 202, 365, 204, 366, -2, -1, -2.677945044588987, 2.23606797749979
211, 105, 67, 339, 69, 340, -2, -1, -2.677945044588987, 2.23606797749979
211, 107, 271, 154, 273, 154, -2, 0, 3.141592653589793, 2.0
211, 111, 590, 255, 590, 257, 0, -2, -1.5707963267948966, 2.0
211, 112, 320, 141, 322, 142, -2, -1, -2.677945044588987, 2.23606797749979
211, 115, 582, 255, 583, 257, -1, -2, -2.0344439357957027, 2.23606797749979
212, 19, 331, 148, 334, 149, -3, -1, -2.819842099193151, 3.1622776601683795
212, 21, 299, 365, 302, 366, -3, -1, -2.819842099193151, 3.1622776601683795
212, 24, 177, 171, 179, 171, -2, 0, 3.141592653589793, 2.0
212, 32, 174, 164, 176, 164, -2, 0, 3.141592653589793, 2.0
212, 51, 209, 363, 211, 363, -2, 0, 3.141592653589793, 2.0
212, 56, 228, 162, 231, 162, -3, 0, 3.141592653589793, 3.0
212, 67, 576, 185, 577, 187, -1, -2, -2.0344439357957027, 2.23606797749979
212, 76, 200, 364, 202, 365, -2, -1, -2.677945044588987, 2.23606797749979
212, 85, 269, 154, 271, 154, -2, 0, 3.141592653589793, 2.0
212, 88, 590, 253, 590, 255, 0, -2, -1.5707963267948966, 2.0
212, 89, 317, 140, 320, 141, -3, -1, -2.819842099193151, 3.1622776601683795
212, 92, 581, 251, 582, 255, -1, -4, -1.8157749899217608, 4.123105625617661
213, 17, 294, 364, 299, 365, -5, -1, -2.9441970937399127, 5.0990195135927845
213, 20, 174, 171, 177, 171, -3, 0, 3.141592653589793, 3.0
213, 28, 172, 164, 174, 164, -2, 0, 3.141592653589793, 2.0
213, 42, 207, 362, 209, 363, -2, -1, -2.677945044588987, 2.23606797749979
213, 47, 225, 161, 228, 162, -3, -1, -2.819842099193151, 3.1622776601683795
213, 50, 199, 153, 200, 152, -1, 1, 2.356194490192345, 1.4142135623730951
213, 55, 575, 183, 576, 185, -1, -2, -2.0344439357957027, 2.23606797749979
213, 61, 198, 364, 200, 364, -2, 0, 3.141592653589793, 2.0
213, 67, 267, 154, 269, 154, -2, 0, 3.141592653589793, 2.0
213, 70, 590, 251, 590, 253, 0, -2, -1.5707963267948966, 2.0
213, 71, 315, 140, 317, 140, -2, 0, 3.141592653589793, 2.0
213, 74, 582, 246, 581, 251, 1, -5, -1.373400766945016, 5.0990195135927845
214, 15, 290, 363, 294, 364, -4, -1, -2.896613990462929, 4.123105625617661
214, 36, 205, 361, 207, 362, -2, -1, -2.677945044588987, 2.23606797749979
214, 41, 222, 161, 225, 161, -3, 0, 3.141592653589793, 3.0
214, 55, 265, 154, 267, 154, -2, 0, 3.141592653589793, 2.0
214, 57, 590, 249, 590, 251, 0, -2, -1.5707963267948966, 2.0
214, 59, 581, 242, 582, 246, -1, -4, -1.8157749899217608, 4.123105625617661
215, 20, 331, 147, 334, 148, -3, -1, -2.819842099193151, 3.1622776601683795
215, 30, 173, 165, 175, 165, -2, 0, 3.141592653589793, 2.0
215, 33, 165, 362, 167, 363, -2, -1, -2.677945044588987, 2.23606797749979
215, 45, 299, 368, 302, 369, -3, -1, -2.819842099193151, 3.1622776601683795
215, 49, 208, 363, 210, 364, -2, -1, -2.677945044588987, 2.23606797749979
215, 60, 589, 251, 590, 254, -1, -3, -1.892546881191539, 3.1622776601683795
215, 71, 200, 364, 202, 365, -2, -1, -2.677945044588987, 2.23606797749979
215, 85, 175, 179, 179, 179, -4, 0, 3.141592653589793, 4.0
215, 99, 228, 160, 230, 161, -2, -1, -2.677945044588987, 2.23606797749979
215, 108, 317, 141, 319, 141, -2, 0, 3.141592653589793, 2.0
215, 114, 573, 184, 574, 187, -1, -3, -1.892546881191539, 3.1622776601683795
215, 122, 320, 127, 322, 128, -2, -1, -2.677945044588987, 2.23606797749979
215, 143, 208, 154, 210, 154, -2, 0, 3.141592653589793, 2.0
215, 151, 267, 155, 269, 155, -2, 0, 3.141592653589793, 2.0
215, 154, 582, 253, 583, 256, -1, -3, -1.892546881191539, 3.1622776601683795
216, 18, 328, 146, 331, 147, -3, -1, -2.819842099193151, 3.1622776601683795
216, 26, 171, 165, 173, 165, -2, 0, 3.141592653589793, 2.0
216, 38, 295, 368, 299, 368, -4, 0, 3.141592653589793, 4.0
216, 42, 206, 362, 208, 363, -2, -1, -2.677945044588987, 2.23606797749979
216, 51, 588, 249, 589, 251, -1, -2, -2.0344439357957027, 2.23606797749979
216, 58, 198, 365, 200, 364, -2, 1, 2.677945044588987, 2.23606797749979
216, 70, 172, 180, 175, 179, -3, 1, 2.819842099193151, 3.1622776601683795
216, 82, 226, 160, 228, 160, -2, 0, 3.141592653589793, 2.0
216, 91, 314, 141, 317, 141, -3, 0, 3.141592653589793, 3.0
216, 96, 572, 182, 573, 184, -1, -2, -2.0344439357957027, 2.23606797749979
216, 120, 207, 155, 208, 154, -1, 1, 2.356194490192345, 1.4142135623730951
216, 121, 113, 353, 112, 355, 1, -2, -1.1071487177940904, 2.23606797749979
216, 126, 264, 155, 267, 155, -3, 0, 3.141592653589793, 3.0
216, 129, 581, 251, 582, 253, -1, -2, -2.0344439357957027, 2.23606797749979
217, 13, 371, 132, 373, 132, -2, 0, 3.141592653589793, 2.0
217, 15, 325, 145, 328, 146, -3, -1, -2.819842099193151, 3.1622776601683795
217, 25, 153, 176, 154, 175, -1, 1, 2.356194490192345, 1.4142135623730951
217, 29, 291, 367, 295, 368, -4, -1, -2.896613990462929, 4.123105625617661
217, 32, 204, 362, 206, 362, -2, 0, 3.141592653589793, 2.0
217, 39, 588, 247, 588, 249, 0, -2, -1.5707963267948966, 2.0
217, 45, 196, 364, 198, 365, -2, -1, -2.677945044588987, 2.23606797749979
217, 52, 168, 181, 172, 180, -4, 1, 2.896613990462929, 4.123105625617661
217, 60, 224, 160, 226, 160, -2, 0, 3.141592653589793, 2.0
217, 67, 311, 141, 314, 141, -3, 0, 3.141592653589793, 3.0
217, 71, 571, 180, 572, 182, -1, -2, -2.0344439357957027, 2.23606797749979
217, 74, 317, 126, 319, 127, -2, -1, -2.677945044588987, 2.23606797749979
217, 89, 575, 335, 575, 337, 0, -2, -1.5707963267948966, 2.0
217, 90, 205, 155, 207, 155, -2, 0, 3.141592653589793, 2.0
217, 94, 262, 155, 264, 155, -2, 0, 3.141592653589793, 2.0
217, 96, 580, 248, 581, 251, -1, -3, -1.892546881191539, 3.1622776601683795
217, 97, 198, 155, 199, 154, -1, 1, 2.356194490192345, 1.4142135623730951
218, 12, 322, 144, 325, 145, -3, -1, -2.819842099193151, 3.1622776601683795
218, 17, 168, 165, 170, 165, -2, 0, 3.141592653589793, 2.0
218, 24, 287, 366, 291, 367, -4, -1, -2.896613990462929, 4.123105625617661
218, 28, 96, 294, 94, 294, 2, 0, 0.0, 2.0
218, 29, 587, 245, 588, 247, -1, -2, -2.0344439357957027, 2.23606797749979
218, 34, 194, 363, 196, 364, -2, -1, -2.677945044588987, 2.23606797749979
218, 35, 536, 127, 537, 129, -1, -2, -2.0344439357957027, 2.23606797749979
218, 41, 165, 181, 168, 181, -3, 0, 3.141592653589793, 3.0
218, 48, 222, 160, 224, 160, -2, 0, 3.141592653589793, 2.0
218, 54, 532, 133, 532, 135, 0, -2, -1.5707963267948966, 2.0
218, 55, 309, 140, 311, 141, -2, -1, -2.677945044588987, 2.23606797749979
218, 59, 570, 178, 571, 180, -1, -2, -2.0344439357957027, 2.23606797749979
218, 61, 315, 126, 317, 126, -2, 0, 3.141592653589793, 2.0
218, 74, 575, 333, 575, 335, 0, -2, -1.5707963267948966, 2.0
218, 75, 204, 156, 205, 155, -1, 1, 2.356194490192345, 1.4142135623730951
218, 81, 578, 246, 580, 248, -2, -2, -2.356194490192345, 2.8284271247461903
218, 82, 196, 155, 198, 155, -2, 0, 3.141592653589793, 2.0
219, 10, 369, 132, 371, 132, -2, 0, 3.141592653589793, 2.0
219, 12, 319, 144, 322, 144, -3, 0, 3.141592653589793, 3.0
219, 17, 165, 165, 168, 165, -3, 0, 3.141592653589793, 3.0
219, 21, 150, 176, 152, 176, -2, 0, 3.141592653589793, 2.0
219, 24, 285, 365, 287, 366, -2, -1, -2.677945044588987, 2.23606797749979
219, 29, 586, 243, 587, 245, -1, -2, -2.0344439357957027, 2.23606797749979
219, 33, 192, 363, 194, 363, -2, 0, 3.141592653589793, 2.0
219, 39, 162, 181, 165, 181, -3, 0, 3.141592653589793, 3.0
219, 43, 300, 118, 302, 118, -2, 0, 3.141592653589793, 2.0
219, 49, 307, 139, 309, 140, -2, -1, -2.677945044588987, 2.23606797749979
219, 51, 570, 176, 570, 178, 0, -2, -1.5707963267948966, 2.0
219, 63, 203, 157, 204, 156, -1, 1, 2.356194490192345, 1.4142135623730951
219, 67, 577, 244, 578, 246, -1, -2, -2.0344439357957027, 2.23606797749979
219, 68, 195, 156, 196, 155, -1, 1, 2.356194490192345, 1.4142135623730951
220, 3, 325, 148, 328, 149, -3, -1, -2.819842099193151, 3.1622776601683795
220, 27, 170, 167, 172, 167, -2, 0, 3.141592653589793, 2.0
220, 33, 143, 150, 145, 151, -2, -1, -2.677945044588987, 2.23606797749979
220, 55, 288, 368, 293, 368, -5, 0, 3.141592653589793, 5.0
220, 56, 318, 127, 320, 128, -2, -1, -2.677945044588987, 2.23606797749979
220, 80, 164, 363, 166, 363, -2, 0, 3.141592653589793, 2.0
220, 95, 590, 245, 590, 248, 0, -3, -1.5707963267948966, 3.0
220, 109, 567, 165, 567, 167, 0, -2, -1.5707963267948966, 2.0
220, 114, 202, 363, 204, 364, -2, -1, -2.677945044588987, 2.23606797749979
220, 117, 114, 145, 116, 145, -2, 0, 3.141592653589793, 2.0
220, 130, 225, 159, 227, 159, -2, 0, 3.141592653589793, 2.0
220, 135, 167, 183, 171, 182, -4, 1, 2.896613990462929, 4.123105625617661
221, 3, 322, 147, 325, 148, -3, -1, -2.819842099193151, 3.1622776601683795
221, 23, 168, 167, 170, 167, -2, 0, 3.141592653589793, 2.0
221, 41, 398, 130, 400, 130, -2, 0, 3.141592653589793, 2.0
221, 43, 283, 368, 288, 368, -5, 0, 3.141592653589793, 5.0
221, 44, 316, 126, 318, 127, -2, -1, -2.677945044588987, 2.23606797749979
221, 58, 458, 126, 460, 127, -2, -1, -2.677945044588987, 2.23606797749979
221, 75, 590, 243, 590, 245, 0, -2, -1.5707963267948966, 2.0
221, 86, 565, 164, 567, 165, -2, -1, -2.677945044588987, 2.23606797749979
221, 89, 200, 362, 202, 363, -2, -1, -2.677945044588987, 2.23606797749979
221, 99, 195, 156, 197, 156, -2, 0, 3.141592653589793, 2.0
221, 104, 223, 159, 225, 159, -2, 0, 3.141592653589793, 2.0
221, 107, 163, 183, 167, 183, -4, 0, 3.141592653589793, 4.0
221, 111, 311, 143, 313, 143, -2, 0, 3.141592653589793, 2.0
221, 116, 36, 318, 38, 318, -2, 0, 3.141592653589793, 2.0
222, 3, 320, 146, 322, 147, -2, -1, -2.677945044588987, 2.23606797749979
222, 10, 369, 133, 371, 133, -2, 0, 3.141592653589793, 2.0
222, 22, 166, 167, 168, 167, -2, 0, 3.141592653589793, 2.0
222, 38, 279, 367, 283, 368, -4, -1, -2.896613990462929, 4.123105625617661
222, 57, 304, 127, 306, 127, -2, 0, 3.141592653589793, 2.0
222, 64, 589, 241, 590, 243, -1, -2, -2.0344439357957027, 2.23606797749979
222, 87, 221, 159, 223, 159, -2, 0, 3.141592653589793, 2.0
222, 90, 160, 184, 163, 183, -3, 1, 2.819842099193151, 3.1622776601683795
222, 92, 309, 143, 311, 143, -2, 0, 3.141592653589793, 2.0
223, 3, 317, 145, 320, 146, -3, -1, -2.819842099193151, 3.1622776601683795
223, 7, 222, 138, 224, 138, -2, 0, 3.141592653589793, 2.0
223, 15, 389, 122, 391, 122, -2, 0, 3.141592653589793, 2.0
223, 16, 198, 138, 199, 137, -1, 1, 2.356194490192345, 1.4142135623730951
223, 20, 164, 169, 166, 167, -2, 2, 2.356194490192345, 2.8284271247461903
223, 54, 588, 239, 589, 241, -1, -2, -2.0344439357957027, 2.23606797749979
223, 58, 190, 146, 191, 145, -1, 1, 2.356194490192345, 1.4142135623730951
223, 73, 219, 159, 221, 159, -2, 0, 3.141592653589793, 2.0
223, 76, 158, 185, 160, 184, -2, 1, 2.677945044588987, 2.23606797749979
223, 78, 307, 143, 309, 143, -2, 0, 3.141592653589793, 2.0
223, 80, 130, 346, 133, 345, -3, 1, 2.819842099193151, 3.1622776601683795
224, 3, 314, 145, 317, 145, -3, 0, 3.141592653589793, 3.0
224, 9, 366, 133, 368, 133, -2, 0, 3.141592653589793, 2.0
224, 27, 274, 366, 278, 367, -4, -1, -2.896613990462929, 4.123105625617661
224, 43, 588, 237, 588, 239, 0, -2, -1.5707963267948966, 2.0
224, 59, 217, 159, 219, 159, -2, 0, 3.141592653589793, 2.0
224, 62, 304, 142, 307, 143, -3, -1, -2.819842099193151, 3.1622776601683795
224, 65, 144, 361, 143, 362, 1, -1, -0.7853981633974483, 1.4142135623730951
225, 13, 276, 368, 282, 368, -6, 0, 3.141592653589793, 6.0
225, 15, 591, 337, 590, 338, 1, -1, -0.7853981633974483, 1.4142135623730951
225, 18, 290, 117, 292, 117, -2, 0, 3.141592653589793, 2.0
225, 28, 369, 134, 371, 134, -2, 0, 3.141592653589793, 2.0
225, 40, 320, 148, 323, 149, -3, -1, -2.819842099193151, 3.1622776601683795
225, 42, 167, 170, 169, 169, -2, 1, 2.677945044588987, 2.23606797749979
225, 43, 168, 364, 170, 364, -2, 0, 3.141592653589793, 2.0
225, 51, 160, 364, 162, 364, -2, 0, 3.141592653589793, 2.0
225, 94, 158, 182, 160, 181, -2, 1, 2.677945044588987, 2.23606797749979
225, 98, 199, 363, 201, 365, -2, -2, -2.356194490192345, 2.8284271247461903
225, 118, 588, 241, 589, 243, -1, -2, -2.0344439357957027, 2.23606797749979
225, 134, 193, 159, 195, 159, -2, 0, 3.141592653589793, 2.0
225, 149, 306, 143, 308, 143, -2, 0, 3.141592653589793, 2.0
225, 154, 190, 365, 192, 367, -2, -2, -2.356194490192345, 2.8284271247461903
225, 157, 258, 159, 261, 159, -3, 0, 3.141592653589793, 3.0
225, 160, 561, 166, 563, 167, -2, -1, -2.677945044588987, 2.23606797749979
226, 12, 271, 368, 276, 368, -5, 0, 3.141592653589793, 5.0
226, 35, 318, 147, 320, 148, -2, -1, -2.677945044588987, 2.23606797749979
226, 37, 165, 170, 167, 170, -2, 0, 3.141592653589793, 2.0
226, 51, 190, 148, 191, 147, -1, 1, 2.356194490192345, 1.4142135623730951
226, 74, 156, 183, 158, 182, -2, 1, 2.677945044588987, 2.23606797749979
226, 77, 197, 362, 199, 363, -2, -1, -2.677945044588987, 2.23606797749979
226, 81, 314, 127, 316, 128, -2, -1, -2.677945044588987, 2.23606797749979
226, 88, 219, 162, 221, 162, -2, 0, 3.141592653589793, 2.0
226, 92, 587, 239, 588, 241, -1, -2, -2.0344439357957027, 2.23606797749979
226, 118, 188, 364, 190, 365, -2, -1, -2.677945044588987, 2.23606797749979
226, 120, 255, 159, 258, 159, -3, 0, 3.141592653589793, 3.0
227, 9, 267, 368, 271, 368, -4, 0, 3.141592653589793, 4.0
227, 27, 315, 146, 318, 147, -3, -1, -2.819842099193151, 3.1622776601683795
227, 28, 163, 170, 165, 170, -2, 0, 3.141592653589793, 2.0
227, 37, 221, 139, 223, 139, -2, 0, 3.141592653589793, 2.0
227, 40, 188, 148, 190, 148, -2, 0, 3.141592653589793, 2.0
227, 56, 394, 130, 396, 130, -2, 0, 3.141592653589793, 2.0
227, 59, 154, 184, 156, 183, -2, 1, 2.677945044588987, 2.23606797749979
227, 61, 195, 361, 197, 362, -2, -1, -2.677945044588987, 2.23606797749979
227, 68, 217, 162, 219, 162, -2, 0, 3.141592653589793, 2.0
227, 72, 586, 237, 587, 239, -1, -2, -2.0344439357957027, 2.23606797749979
227, 90, 303, 143, 305, 143, -2, 0, 3.141592653589793, 2.0
227, 92, 186, 363, 188, 364, -2, -1, -2.677945044588987, 2.23606797749979
227, 93, 252, 159, 255, 159, -3, 0, 3.141592653589793, 3.0
228, 8, 265, 368, 267, 368, -2, 0, 3.141592653589793, 2.0
228, 15, 91, 225, 91, 227, 0, -2, -1.5707963267948966, 2.0
228, 26, 313, 145, 315, 146, -2, -1, -2.677945044588987, 2.23606797749979
228, 27, 160, 170, 163, 170, -3, 0, 3.141592653589793, 3.0
228, 34, 67, 337, 68, 336, -1, 1, 2.356194490192345, 1.4142135623730951
228, 55, 190, 360, 195, 361, -5, -1, -2.9441970937399127, 5.0990195135927845
228, 59, 216, 163, 217, 162, -1, 1, 2.356194490192345, 1.4142135623730951
228, 61, 203, 159, 205, 159, -2, 0, 3.141592653589793, 2.0
228, 62, 585, 234, 586, 237, -1, -3, -1.892546881191539, 3.1622776601683795
228, 66, 583, 329, 582, 331, 1, -2, -1.1071487177940904, 2.23606797749979
228, 69, 189, 159, 191, 159, -2, 0, 3.141592653589793, 2.0
228, 75, 301, 143, 303, 143, -2, 0, 3.141592653589793, 2.0
228, 77, 183, 362, 186, 363, -3, -1, -2.819842099193151, 3.1622776601683795
228, 78, 248, 159, 252, 159, -4, 0, 3.141592653589793, 4.0
229, 7, 261, 367, 265, 368, -4, -1, -2.896613990462929, 4.123105625617661
229, 10, 146, 179, 148, 180, -2, -1, -2.677945044588987, 2.23606797749979
229, 32, 185, 148, 187, 148, -2, 0, 3.141592653589793, 2.0
229, 42, 391, 130, 393, 130, -2, 0, 3.141592653589793, 2.0
229, 44, 151, 183, 153, 184, -2, -1, -2.677945044588987, 2.23606797749979
229, 45, 188, 359, 190, 360, -2, -1, -2.677945044588987, 2.23606797749979
229, 49, 214, 162, 216, 163, -2, -1, -2.677945044588987, 2.23606797749979
229, 52, 584, 231, 585, 234, -1, -3, -1.892546881191539, 3.1622776601683795
229, 59, 187, 159, 189, 159, -2, 0, 3.141592653589793, 2.0
229, 65, 181, 361, 183, 362, -2, -1, -2.677945044588987, 2.23606797749979
229, 66, 246, 157, 248, 159, -2, -2, -2.356194490192345, 2.8284271247461903
230, 11, 199, 138, 200, 137, -1, 1, 2.356194490192345, 1.4142135623730951
230, 18, 163, 172, 165, 172, -2, 0, 3.141592653589793, 2.0
230, 21, 158, 363, 160, 364, -2, -1, -2.677945044588987, 2.23606797749979
230, 26, 601, 281, 600, 282, 1, -1, -0.7853981633974483, 1.4142135623730951
230, 33, 265, 369, 270, 369, -5, 0, 3.141592653589793, 5.0
230, 39, 366, 133, 368, 134, -2, -1, -2.677945044588987, 2.23606797749979
230, 45, 316, 145, 318, 145, -2, 0, 3.141592653589793, 2.0
230, 58, 157, 182, 159, 181, -2, 1, 2.677945044588987, 2.23606797749979
230, 68, 168, 366, 170, 367, -2, -1, -2.677945044588987, 2.23606797749979
230, 90, 587, 233, 588, 236, -1, -3, -1.892546881191539, 3.1622776601683795
230, 100, 189, 161, 191, 161, -2, 0, 3.141592653589793, 2.0
230, 101, 157, 190, 159, 189, -2, 1, 2.677945044588987, 2.23606797749979
230, 127, 187, 364, 189, 365, -2, -1, -2.677945044588987, 2.23606797749979
230, 135, 204, 158, 206, 158, -2, 0, 3.141592653589793, 2.0
230, 139, 188, 151, 190, 151, -2, 0, 3.141592653589793, 2.0
230, 146, 208, 173, 210, 173, -2, 0, 3.141592653589793, 2.0
231, 9, 197, 138, 199, 138, -2, 0, 3.141592653589793, 2.0
231, 14, 161, 172, 163, 172, -2, 0, 3.141592653589793, 2.0
231, 16, 156, 362, 158, 363, -2, -1, -2.677945044588987, 2.23606797749979
231, 23, 261, 369, 265, 369, -4, 0, 3.141592653589793, 4.0
231, 27, 364, 133, 366, 133, -2, 0, 3.141592653589793, 2.0
231, 30, 314, 144, 316, 145, -2, -1, -2.677945044588987, 2.23606797749979
231, 42, 155, 182, 157, 182, -2, 0, 3.141592653589793, 2.0
231, 50, 166, 366, 168, 366, -2, 0, 3.141592653589793, 2.0
231, 70, 586, 230, 587, 233, -1, -3, -1.892546881191539, 3.1622776601683795
231, 78, 155, 191, 157, 190, -2, 1, 2.677945044588987, 2.23606797749979
231, 98, 185, 363, 187, 364, -2, -1, -2.677945044588987, 2.23606797749979
231, 110, 205, 174, 208, 173, -3, 1, 2.819842099193151, 3.1622776601683795
232, 13, 154, 362, 156, 362, -2, 0, 3.141592653589793, 2.0
232, 19, 256, 369, 261, 369, -5, 0, 3.141592653589793, 5.0
232, 23, 362, 133, 364, 133, -2, 0, 3.141592653589793, 2.0
232, 26, 312, 143, 314, 144, -2, -1, -2.677945044588987, 2.23606797749979
232, 58, 586, 227, 586, 230, 0, -3, -1.5707963267948966, 3.0
232, 59, 216, 164, 218, 164, -2, 0, 3.141592653589793, 2.0
232, 64, 186, 161, 188, 161, -2, 0, 3.141592653589793, 2.0
232, 65, 152, 192, 155, 191, -3, 1, 2.819842099193151, 3.1622776601683795
232, 83, 183, 362, 185, 363, -2, -1, -2.677945044588987, 2.23606797749979
232, 88, 200, 159, 203, 158, -3, 1, 2.819842099193151, 3.1622776601683795
232, 90, 183, 151, 187, 151, -4, 0, 3.141592653589793, 4.0
232, 93, 202, 174, 205, 174, -3, 0, 3.141592653589793, 3.0
232, 94, 261, 128, 263, 128, -2, 0, 3.141592653589793, 2.0
232, 96, 206, 141, 207, 140, -1, 1, 2.356194490192345, 1.4142135623730951
233, 6, 194, 138, 196, 138, -2, 0, 3.141592653589793, 2.0
233, 10, 158, 172, 160, 172, -2, 0, 3.141592653589793, 2.0
233, 14, 252, 369, 256, 369, -4, 0, 3.141592653589793, 4.0
233, 16, 360, 132, 362, 133, -2, -1, -2.677945044588987, 2.23606797749979
233, 19, 310, 142, 312, 143, -2, -1, -2.677945044588987, 2.23606797749979
233, 44, 586, 225, 586, 227, 0, -2, -1.5707963267948966, 2.0
233, 66, 180, 362, 183, 362, -3, 0, 3.141592653589793, 3.0
233, 70, 198, 159, 200, 159, -2, 0, 3.141592653589793, 2.0
233, 72, 181, 151, 183, 151, -2, 0, 3.141592653589793, 2.0
233, 75, 198, 175, 202, 174, -4, 1, 2.896613990462929, 4.123105625617661
234, 12, 248, 370, 252, 369, -4, 1, 2.896613990462929, 4.123105625617661
234, 17, 308, 142, 310, 142, -2, 0, 3.141592653589793, 2.0
234, 38, 213, 164, 215, 164, -2, 0, 3.141592653589793, 2.0
234, 42, 149, 192, 151, 192, -2, 0, 3.141592653589793, 2.0
234, 57, 178, 361, 180, 362, -2, -1, -2.677945044588987, 2.23606797749979
234, 59, 196, 159, 198, 159, -2, 0, 3.141592653589793, 2.0
234, 63, 195, 175, 198, 175, -3, 0, 3.141592653589793, 3.0
235, 35, 363, 134, 365, 134, -2, 0, 3.141592653589793, 2.0
235, 40, 328, 116, 329, 118, -1, -2, -2.0344439357957027, 2.23606797749979
235, 42, 160, 174, 162, 174, -2, 0, 3.141592653589793, 2.0
235, 49, 250, 367, 256, 367, -6, 0, 3.141592653589793, 6.0
235, 77, 301, 132, 303, 133, -2, -1, -2.677945044588987, 2.23606797749979
235, 78, 181, 365, 184, 365, -3, 0, 3.141592653589793, 3.0
235, 81, 164, 365, 167, 366, -3, -1, -2.819842099193151, 3.1622776601683795
235, 88, 191, 357, 194, 358, -3, -1, -2.819842099193151, 3.1622776601683795
235, 93, 390, 132, 392, 132, -2, 0, 3.141592653589793, 2.0
235, 99, 153, 191, 155, 190, -2, 1, 2.677945044588987, 2.23606797749979
235, 111, 115, 147, 117, 148, -2, -1, -2.677945044588987, 2.23606797749979
235, 115, 586, 229, 587, 231, -1, -2, -2.0344439357957027, 2.23606797749979
235, 133, 36, 316, 38, 316, -2, 0, 3.141592653589793, 2.0
235, 142, 600, 306, 599, 307, 1, -1, -0.7853981633974483, 1.4142135623730951
235, 149, 45, 319, 47, 319, -2, 0, 3.141592653589793, 2.0
235, 150, 242, 158, 246, 159, -4, -1, -2.896613990462929, 4.123105625617661
236, 22, 195, 138, 197, 138, -2, 0, 3.141592653589793, 2.0
236, 38, 244, 367, 250, 367, -6, 0, 3.141592653589793, 6.0
236, 63, 179, 365, 181, 365, -2, 0, 3.141592653589793, 2.0
236, 66, 593, 324, 594, 326, -1, -2, -2.0344439357957027, 2.23606797749979
236, 70, 188, 356, 191, 357, -3, -1, -2.819842099193151, 3.1622776601683795
236, 75, 388, 131, 390, 132, -2, -1, -2.677945044588987, 2.23606797749979
236, 78, 213, 164, 215, 164, -2, 0, 3.141592653589793, 2.0
236, 90, 586, 227, 586, 229, 0, -2, -1.5707963267948966, 2.0
236, 97, 593, 279, 593, 281, 0, -2, -1.5707963267948966, 2.0
236, 109, 211, 128, 213, 129, -2, -1, -2.677945044588987, 2.23606797749979
236, 115, 239, 157, 242, 158, -3, -1, -2.819842099193151, 3.1622776601683795
236, 117, 297, 146, 299, 146, -2, 0, 3.141592653589793, 2.0
237, 24, 157, 174, 159, 174, -2, 0, 3.141592653589793, 2.0
237, 31, 241, 367, 244, 367, -3, 0, 3.141592653589793, 3.0
237, 55, 176, 365, 179, 365, -3, 0, 3.141592653589793, 3.0
237, 57, 184, 355, 188, 356, -4, -1, -2.896613990462929, 4.123105625617661
237, 76, 585, 225, 586, 227, -1, -2, -2.0344439357957027, 2.23606797749979
237, 78, 78, 232, 80, 232, -2, 0, 3.141592653589793, 2.0
237, 81, 592, 277, 593, 279, -1, -2, -2.0344439357957027, 2.23606797749979
237, 97, 235, 156, 239, 157, -4, -1, -2.896613990462929, 4.123105625617661
238, 5, 284, 117, 287, 118, -3, -1, -2.819842099193151, 3.1622776601683795
238, 20, 76, 325, 78, 325, -2, 0, 3.141592653589793, 2.0
238, 38, 183, 163, 186, 163, -3, 0, 3.141592653589793, 3.0
238, 41, 297, 131, 299, 132, -2, -1, -2.677945044588987, 2.23606797749979
238, 43, 181, 354, 184, 355, -3, -1, -2.819842099193151, 3.1622776601683795
238, 47, 384, 130, 387, 131, -3, -1, -2.819842099193151, 3.1622776601683795
238, 60, 585, 223, 585, 225, 0, -2, -1.5707963267948966, 2.0
238, 65, 592, 275, 592, 277, 0, -2, -1.5707963267948966, 2.0
238, 72, 208, 127, 210, 128, -2, -1, -2.677945044588987, 2.23606797749979
238, 73, 558, 176, 559, 175, -1, 1, 2.356194490192345, 1.4142135623730951
238, 75, 232, 156, 235, 156, -3, 0, 3.141592653589793, 3.0
239, 17, 154, 174, 156, 174, -2, 0, 3.141592653589793, 2.0
239, 22, 238, 366, 240, 367, -2, -1, -2.677945044588987, 2.23606797749979
239, 31, 139, 161, 141, 162, -2, -1, -2.677945044588987, 2.23606797749979
239, 36, 295, 131, 297, 131, -2, 0, 3.141592653589793, 2.0
239, 37, 179, 353, 181, 354, -2, -1, -2.677945044588987, 2.23606797749979
239, 49, 585, 221, 585, 223, 0, -2, -1.5707963267948966, 2.0
239, 62, 230, 155, 232, 156, -2, -1, -2.677945044588987, 2.23606797749979
240, 8, 136, 137, 138, 138, -2, -1, -2.677945044588987, 2.23606797749979
240, 31, 193, 139, 195, 139, -2, 0, 3.141592653589793, 2.0
240, 44, 244, 365, 246, 366, -2, -1, -2.677945044588987, 2.23606797749979
240, 46, 120, 177, 122, 178, -2, -1, -2.677945044588987, 2.23606797749979
240, 53, 588, 225, 588, 227, 0, -2, -1.5707963267948966, 2.0
240, 55, 293, 147, 295, 147, -2, 0, 3.141592653589793, 2.0
240, 60, 310, 144, 312, 145, -2, -1, -2.677945044588987, 2.23606797749979
240, 71, 584, 214, 585, 216, -1, -2, -2.0344439357957027, 2.23606797749979
240, 87, 182, 152, 184, 152, -2, 0, 3.141592653589793, 2.0
240, 108, 213, 167, 215, 167, -2, 0, 3.141592653589793, 2.0
240, 111, 151, 196, 153, 196, -2, 0, 3.141592653589793, 2.0
240, 114, 106, 292, 106, 294, 0, -2, -1.5707963267948966, 2.0
240, 119, 296, 130, 298, 130, -2, 0, 3.141592653589793, 2.0
240, 133, 199, 164, 201, 163, -2, 1, 2.677945044588987, 2.23606797749979
240, 135, 577, 215, 578, 217, -1, -2, -2.0344439357957027, 2.23606797749979
241, 4, 63, 339, 65, 339, -2, 0, 3.141592653589793, 2.0
241, 31, 242, 364, 244, 365, -2, -1, -2.677945044588987, 2.23606797749979
241, 36, 588, 223, 588, 225, 0, -2, -1.5707963267948966, 2.0
241, 38, 291, 147, 293, 147, -2, 0, 3.141592653589793, 2.0
241, 43, 308, 143, 310, 144, -2, -1, -2.677945044588987, 2.23606797749979
241, 81, 149, 196, 151, 196, -2, 0, 3.141592653589793, 2.0
241, 97, 33, 343, 34, 342, -1, 1, 2.356194490192345, 1.4142135623730951
241, 100, 577, 213, 577, 215, 0, -2, -1.5707963267948966, 2.0
242, 27, 239, 364, 242, 364, -3, 0, 3.141592653589793, 3.0
242, 34, 358, 136, 360, 137, -2, -1, -2.677945044588987, 2.23606797749979
242, 36, 306, 142, 308, 143, -2, -1, -2.677945044588987, 2.23606797749979
242, 43, 583, 211, 584, 213, -1, -2, -2.0344439357957027, 2.23606797749979
242, 62, 210, 167, 212, 167, -2, 0, 3.141592653589793, 2.0
242, 64, 147, 196, 149, 196, -2, 0, 3.141592653589793, 2.0
242, 76, 196, 165, 198, 164, -2, 1, 2.677945044588987, 2.23606797749979
242, 77, 576, 211, 577, 213, -1, -2, -2.0344439357957027, 2.23606797749979
243, 23, 237, 363, 239, 364, -2, -1, -2.677945044588987, 2.23606797749979
243, 27, 588, 220, 588, 222, 0, -2, -1.5707963267948966, 2.0
243, 28, 288, 147, 291, 147, -3, 0, 3.141592653589793, 3.0
243, 30, 304, 141, 306, 142, -2, -1, -2.677945044588987, 2.23606797749979
243, 50, 208, 167, 210, 167, -2, 0, 3.141592653589793, 2.0
243, 52, 145, 196, 147, 196, -2, 0, 3.141592653589793, 2.0
244, 24, 286, 146, 288, 147, -2, -1, -2.677945044588987, 2.23606797749979
244, 26, 302, 141, 304, 141, -2, 0, 3.141592653589793, 2.0
244, 32, 582, 208, 583, 210, -1, -2, -2.0344439357957027, 2.23606797749979
244, 41, 206, 167, 208, 167, -2, 0, 3.141592653589793, 2.0
244, 49, 193, 166, 195, 165, -2, 1, 2.677945044588987, 2.23606797749979
245, 5, 218, 140, 220, 140, -2, 0, 3.141592653589793, 2.0
245, 14, 356, 132, 358, 133, -2, -1, -2.677945044588987, 2.23606797749979
245, 20, 307, 140, 309, 141, -2, -1, -2.677945044588987, 2.23606797749979
245, 28, 242, 367, 244, 367, -2, 0, 3.141592653589793, 2.0
245, 31, 150, 363, 152, 364, -2, -1, -2.677945044588987, 2.23606797749979
245, 43, 193, 145, 195, 145, -2, 0, 3.141592653589793, 2.0
245, 53, 583, 211, 584, 213, -1, -2, -2.0344439357957027, 2.23606797749979
245, 55, 291, 134, 293, 134, -2, 0, 3.141592653589793, 2.0
245, 73, 383, 129, 385, 130, -2, -1, -2.677945044588987, 2.23606797749979
245, 77, 182, 161, 184, 162, -2, -1, -2.677945044588987, 2.23606797749979
245, 103, 173, 367, 175, 367, -2, 0, 3.141592653589793, 2.0
245, 122, 129, 348, 131, 349, -2, -1, -2.677945044588987, 2.23606797749979
245, 129, 176, 180, 178, 180, -2, 0, 3.141592653589793, 2.0
245, 140, 109, 258, 110, 260, -1, -2, -2.0344439357957027, 2.23606797749979
245, 144, 210, 168, 212, 168, -2, 0, 3.141592653589793, 2.0
245, 148, 576, 216, 577, 218, -1, -2, -2.0344439357957027, 2.23606797749979
245, 152, 186, 183, 189, 183, -3, 0, 3.141592653589793, 3.0
245, 153, 291, 149, 294, 149, -3, 0, 3.141592653589793, 3.0
245, 157, 227, 160, 230, 161, -3, -1, -2.819842099193151, 3.1622776601683795
246, 15, 305, 139, 307, 140, -2, -1, -2.677945044588987, 2.23606797749979
246, 21, 239, 367, 242, 367, -3, 0, 3.141592653589793, 3.0
246, 24, 148, 362, 150, 363, -2, -1, -2.677945044588987, 2.23606797749979
246, 28, 90, 227, 92, 228, -2, -1, -2.677945044588987, 2.23606797749979
246, 35, 191, 145, 193, 145, -2, 0, 3.141592653589793, 2.0
246, 44, 582, 209, 583, 211, -1, -2, -2.0344439357957027, 2.23606797749979
246, 60, 381, 128, 383, 129, -2, -1, -2.677945044588987, 2.23606797749979
246, 81, 171, 366, 173, 367, -2, -1, -2.677945044588987, 2.23606797749979
246, 97, 173, 181, 176, 180, -3, 1, 2.819842099193151, 3.1622776601683795
246, 99, 147, 197, 149, 197, -2, 0, 3.141592653589793, 2.0
246, 112, 575, 214, 576, 216, -1, -2, -2.0344439357957027, 2.23606797749979
246, 115, 184, 182, 186, 183, -2, -1, -2.677945044588987, 2.23606797749979
246, 116, 287, 149, 291, 149, -4, 0, 3.141592653589793, 4.0
246, 120, 224, 160, 227, 160, -3, 0, 3.141592653589793, 3.0
247, 14, 303, 138, 305, 139, -2, -1, -2.677945044588987, 2.23606797749979
247, 20, 236, 366, 239, 367, -3, -1, -2.819842099193151, 3.1622776601683795
247, 23, 146, 361, 148, 362, -2, -1, -2.677945044588987, 2.23606797749979
247, 32, 189, 145, 191, 145, -2, 0, 3.141592653589793, 2.0
247, 55, 179, 161, 181, 161, -2, 0, 3.141592653589793, 2.0
247, 68, 169, 366, 171, 366, -2, 0, 3.141592653589793, 2.0
247, 69, 392, 109, 395, 110, -3, -1, -2.819842099193151, 3.1622776601683795
247, 75, 581, 223, 581, 225, 0, -2, -1.5707963267948966, 2.0
247, 82, 170, 182, 173, 181, -3, 1, 2.819842099193151, 3.1622776601683795
247, 84, 145, 197, 147, 197, -2, 0, 3.141592653589793, 2.0
247, 91, 207, 168, 209, 168, -2, 0, 3.141592653589793, 2.0
247, 94, 182, 183, 184, 182, -2, 1, 2.677945044588987, 2.23606797749979
247, 95, 284, 149, 287, 149, -3, 0, 3.141592653589793, 3.0
247, 99, 221, 160, 224, 160, -3, 0, 3.141592653589793, 3.0
248, 4, 215, 140, 217, 140, -2, 0, 3.141592653589793, 2.0
248, 12, 301, 137, 303, 138, -2, -1, -2.677945044588987, 2.23606797749979
248, 18, 145, 359, 146, 361, -1, -2, -2.0344439357957027, 2.23606797749979
248, 26, 187, 145, 189, 145, -2, 0, 3.141592653589793, 2.0
248, 36, 570, 169, 571, 172, -1, -3, -1.892546881191539, 3.1622776601683795
248, 56, 167, 366, 169, 366, -2, 0, 3.141592653589793, 2.0
248, 62, 581, 221, 581, 223, 0, -2, -1.5707963267948966, 2.0
248, 66, 169, 183, 170, 182, -1, 1, 2.356194490192345, 1.4142135623730951
248, 74, 205, 168, 207, 168, -2, 0, 3.141592653589793, 2.0
248, 76, 180, 183, 182, 183, -2, 0, 3.141592653589793, 2.0
248, 77, 280, 149, 284, 149, -4, 0, 3.141592653589793, 4.0
248, 79, 219, 159, 221, 160, -2, -1, -2.677945044588987, 2.23606797749979
249, 8, 351, 132, 353, 132, -2, 0, 3.141592653589793, 2.0
249, 11, 299, 136, 301, 137, -2, -1, -2.677945044588987, 2.23606797749979
249, 17, 128, 172, 130, 173, -2, -1, -2.677945044588987, 2.23606797749979
249, 43, 178, 149, 177, 151, 1, -2, -1.1071487177940904, 2.23606797749979
249, 48, 165, 365, 167, 366, -2, -1, -2.677945044588987, 2.23606797749979
249, 53, 581, 219, 581, 221, 0, -2, -1.5707963267948966, 2.0
249, 57, 167, 184, 169, 183, -2, 1, 2.677945044588987, 2.23606797749979
249, 67, 178, 184, 180, 183, -2, 1, 2.677945044588987, 2.23606797749979
249, 68, 276, 149, 280, 149, -4, 0, 3.141592653589793, 4.0
249, 70, 217, 159, 219, 159, -2, 0, 3.141592653589793, 2.0
250, 10, 303, 139, 305, 140, -2, -1, -2.677945044588987, 2.23606797749979
250, 25, 147, 360, 148, 362, -1, -2, -2.0344439357957027, 2.23606797749979
250, 36, 237, 369, 239, 369, -2, 0, 3.141592653589793, 2.0
250, 51, 583, 193, 584, 195, -1, -2, -2.0344439357957027, 2.23606797749979
250, 62, 146, 176, 147, 175, -1, 1, 2.356194490192345, 1.4142135623730951
250, 75, 187, 149, 189, 149, -2, 0, 3.141592653589793, 2.0
250, 96, 380, 130, 382, 130, -2, 0, 3.141592653589793, 2.0
250, 105, 169, 368, 171, 368, -2, 0, 3.141592653589793, 2.0
250, 110, 582, 209, 583, 211, -1, -2, -2.0344439357957027, 2.23606797749979
250, 111, 156, 366, 158, 367, -2, -1, -2.677945044588987, 2.23606797749979
250, 120, 178, 164, 180, 164, -2, 0, 3.141592653589793, 2.0
250, 121, 222, 158, 224, 159, -2, -1, -2.677945044588987, 2.23606797749979
250, 122, 145, 198, 147, 198, -2, 0, 3.141592653589793, 2.0
250, 143, 292, 153, 295, 154, -3, -1, -2.819842099193151, 3.1622776601683795
250, 146, 205, 168, 207, 168, -2, 0, 3.141592653589793, 2.0
251, 7, 299, 138, 303, 139, -4, -1, -2.896613990462929, 4.123105625617661
251, 11, 353, 134, 355, 134, -2, 0, 3.141592653589793, 2.0
251, 18, 145, 358, 147, 360, -2, -2, -2.356194490192345, 2.8284271247461903
251, 28, 235, 369, 237, 369, -2, 0, 3.141592653589793, 2.0
251, 40, 187, 141, 189, 141, -2, 0, 3.141592653589793, 2.0
251, 75, 378, 129, 380, 130, -2, -1, -2.677945044588987, 2.23606797749979
251, 82, 167, 368, 169, 368, -2, 0, 3.141592653589793, 2.0
251, 85, 581, 207, 582, 209, -1, -2, -2.0344439357957027, 2.23606797749979
251, 86, 154, 366, 156, 366, -2, 0, 3.141592653589793, 2.0
251, 92, 220, 158, 222, 158, -2, 0, 3.141592653589793, 2.0
251, 94, 170, 186, 173, 186, -3, 0, 3.141592653589793, 3.0
251, 108, 289, 152, 292, 153, -3, -1, -2.819842099193151, 3.1622776601683795
251, 111, 203, 168, 205, 168, -2, 0, 3.141592653589793, 2.0
252, 6, 297, 137, 299, 138, -2, -1, -2.677945044588987, 2.23606797749979
252, 13, 142, 356, 145, 358, -3, -2, -2.5535900500422257, 3.605551275463989
252, 22, 233, 369, 235, 369, -2, 0, 3.141592653589793, 2.0
252, 54, 589, 218, 589, 220, 0, -2, -1.5707963267948966, 2.0
252, 62, 140, 142, 139, 144, 1, -2, -1.1071487177940904, 2.23606797749979
252, 64, 376, 129, 378, 129, -2, 0, 3.141592653589793, 2.0
252, 68, 165, 368, 167, 368, -2, 0, 3.141592653589793, 2.0
252, 71, 581, 205, 581, 207, 0, -2, -1.5707963267948966, 2.0
252, 72, 152, 365, 154, 366, -2, -1, -2.677945044588987, 2.23606797749979
252, 77, 218, 158, 220, 158, -2, 0, 3.141592653589793, 2.0
252, 79, 169, 187, 170, 186, -1, 1, 2.356194490192345, 1.4142135623730951
252, 92, 287, 153, 289, 152, -2, 1, 2.677945044588987, 2.23606797749979
252, 93, 201, 168, 203, 168, -2, 0, 3.141592653589793, 2.0
253, 4, 296, 138, 297, 137, -1, 1, 2.356194490192345, 1.4142135623730951
253, 7, 350, 134, 352, 134, -2, 0, 3.141592653589793, 2.0
253, 10, 139, 354, 142, 356, -3, -2, -2.5535900500422257, 3.605551275463989
253, 17, 231, 369, 233, 369, -2, 0, 3.141592653589793, 2.0
253, 48, 163, 367, 165, 368, -2, -1, -2.677945044588987, 2.23606797749979
253, 50, 580, 203, 581, 205, -1, -2, -2.0344439357957027, 2.23606797749979
253, 51, 149, 364, 152, 365, -3, -1, -2.819842099193151, 3.1622776601683795
253, 54, 174, 164, 176, 164, -2, 0, 3.141592653589793, 2.0
253, 55, 216, 158, 218, 158, -2, 0, 3.141592653589793, 2.0
253, 66, 285, 153, 287, 153, -2, 0, 3.141592653589793, 2.0
254, 2, 192, 126, 193, 125, -1, 1, 2.356194490192345, 1.4142135623730951
254, 4, 294, 138, 296, 138, -2, 0, 3.141592653589793, 2.0
254, 15, 228, 369, 231, 369, -3, 0, 3.141592653589793, 3.0
254, 37, 161, 366, 163, 367, -2, -1, -2.677945044588987, 2.23606797749979
254, 38, 580, 201, 580, 203, 0, -2, -1.5707963267948966, 2.0
254, 39, 147, 362, 149, 364, -2, -2, -2.356194490192345, 2.8284271247461903
254, 42, 172, 164, 174, 164, -2, 0, 3.141592653589793, 2.0
254, 43, 166, 187, 168, 187, -2, 0, 3.141592653589793, 2.0
254, 49, 282, 152, 285, 153, -3, -1, -2.819842099193151, 3.1622776601683795
255, 28, 232, 367, 234, 367, -2, 0, 3.141592653589793, 2.0
255, 33, 298, 142, 300, 142, -2, 0, 3.141592653589793, 2.0
255, 66, 148, 363, 150, 364, -2, -1, -2.677945044588987, 2.23606797749979
255, 71, 176, 166, 178, 166, -2, 0, 3.141592653589793, 2.0
255, 79, 216, 161, 218, 161, -2, 0, 3.141592653589793, 2.0
255, 94, 124, 348, 126, 348, -2, 0, 3.141592653589793, 2.0
255, 97, 161, 366, 165, 367, -4, -1, -2.896613990462929, 4.123105625617661
255, 100, 376, 132, 378, 132, -2, 0, 3.141592653589793, 2.0
255, 108, 203, 171, 205, 171, -2, 0, 3.141592653589793, 2.0
255, 114, 591, 218, 591, 220, 0, -2, -1.5707963267948966, 2.0
255, 115, 142, 357, 145, 358, -3, -1, -2.819842099193151, 3.1622776601683795
255, 117, 153, 343, 158, 345, -5, -2, -2.761086276477428, 5.385164807134504
255, 120, 107, 251, 108, 253, -1, -2, -2.0344439357957027, 2.23606797749979
255, 129, 143, 351, 146, 351, -3, 0, 3.141592653589793, 3.0
255, 131, 581, 205, 582, 207, -1, -2, -2.0344439357957027, 2.23606797749979
255, 137, 156, 359, 158, 360, -2, -1, -2.677945044588987, 2.23606797749979
255, 146, 174, 187, 176, 186, -2, 1, 2.677945044588987, 2.23606797749979
255, 154, 286, 131, 288, 132, -2, -1, -2.677945044588987, 2.23606797749979
255, 157, 359, 126, 361, 126, -2, 0, 3.141592653589793, 2.0
255, 158, 189, 168, 191, 168, -2, 0, 3.141592653589793, 2.0
255, 160, 583, 217, 583, 219, 0, -2, -1.5707963267948966, 2.0
255, 162, 242, 137, 244, 138, -2, -1, -2.677945044588987, 2.23606797749979
256, 11, 213, 144, 215, 145, -2, -1, -2.677945044588987, 2.23606797749979
256, 22, 230, 367, 232, 367, -2, 0, 3.141592653589793, 2.0
256, 26, 296, 142, 298, 142, -2, 0, 3.141592653589793, 2.0
256, 40, 300, 129, 302, 129, -2, 0, 3.141592653589793, 2.0
256, 55, 146, 362, 148, 363, -2, -1, -2.677945044588987, 2.23606797749979
256, 59, 174, 166, 176, 166, -2, 0, 3.141592653589793, 2.0
256, 65, 214, 161, 216, 161, -2, 0, 3.141592653589793, 2.0
256, 66, 157, 143, 159, 142, -2, 1, 2.677945044588987, 2.23606797749979
256, 74, 159, 365, 161, 366, -2, -1, -2.677945044588987, 2.23606797749979
256, 77, 374, 132, 376, 132, -2, 0, 3.141592653589793, 2.0
256, 80, 201, 171, 203, 171, -2, 0, 3.141592653589793, 2.0
256, 85, 591, 216, 591, 218, 0, -2, -1.5707963267948966, 2.0
256, 86, 140, 354, 142, 357, -2, -3, -2.158798930342464, 3.605551275463989
256, 88, 147, 341, 153, 343, -6, -2, -2.819842099193151, 6.324555320336759
256, 98, 141, 349, 143, 351, -2, -2, -2.356194490192345, 2.8284271247461903
256, 100, 580, 203, 581, 205, -1, -2, -2.0344439357957027, 2.23606797749979
256, 103, 154, 358, 156, 359, -2, -1, -2.677945044588987, 2.23606797749979
256, 109, 172, 187, 174, 187, -2, 0, 3.141592653589793, 2.0
256, 115, 284, 130, 286, 131, -2, -1, -2.677945044588987, 2.23606797749979
256, 119, 187, 168, 189, 168, -2, 0, 3.141592653589793, 2.0
256, 123, 240, 137, 242, 137, -2, 0, 3.141592653589793, 2.0
257, 21, 228, 366, 230, 367, -2, -1, -2.677945044588987, 2.23606797749979
257, 24, 294, 142, 296, 142, -2, 0, 3.141592653589793, 2.0
257, 36, 298, 129, 300, 129, -2, 0, 3.141592653589793, 2.0
257, 50, 146, 360, 146, 362, 0, -2, -1.5707963267948966, 2.0
257, 54, 172, 166, 174, 166, -2, 0, 3.141592653589793, 2.0
257, 59, 212, 162, 214, 161, -2, 1, 2.677945044588987, 2.23606797749979
257, 66, 157, 364, 159, 365, -2, -1, -2.677945044588987, 2.23606797749979
257, 69, 372, 131, 374, 132, -2, -1, -2.677945044588987, 2.23606797749979
257, 75, 590, 214, 591, 216, -1, -2, -2.0344439357957027, 2.23606797749979
257, 76, 138, 353, 140, 354, -2, -1, -2.677945044588987, 2.23606797749979
257, 78, 144, 337, 147, 341, -3, -4, -2.214297435588181, 5.0
257, 85, 139, 348, 141, 349, -2, -1, -2.677945044588987, 2.23606797749979
257, 87, 579, 201, 580, 203, -1, -2, -2.0344439357957027, 2.23606797749979
257, 89, 151, 357, 154, 358, -3, -1, -2.819842099193151, 3.1622776601683795
257, 101, 184, 168, 187, 168, -3, 0, 3.141592653589793, 3.0
257, 102, 582, 214, 583, 216, -1, -2, -2.0344439357957027, 2.23606797749979
257, 103, 166, 181, 168, 182, -2, -1, -2.677945044588987, 2.23606797749979
258, 18, 226, 365, 228, 366, -2, -1, -2.677945044588987, 2.23606797749979
258, 21, 292, 142, 294, 142, -2, 0, 3.141592653589793, 2.0
258, 31, 296, 129, 298, 129, -2, 0, 3.141592653589793, 2.0
258, 44, 144, 358, 146, 360, -2, -2, -2.356194490192345, 2.8284271247461903
258, 47, 170, 166, 172, 166, -2, 0, 3.141592653589793, 2.0
258, 50, 210, 162, 212, 162, -2, 0, 3.141592653589793, 2.0
258, 56, 155, 363, 157, 364, -2, -1, -2.677945044588987, 2.23606797749979
258, 58, 370, 130, 372, 131, -2, -1, -2.677945044588987, 2.23606797749979
258, 61, 198, 171, 200, 171, -2, 0, 3.141592653589793, 2.0
258, 64, 136, 351, 138, 353, -2, -2, -2.356194490192345, 2.8284271247461903
258, 72, 137, 347, 139, 348, -2, -1, -2.677945044588987, 2.23606797749979
258, 73, 578, 199, 579, 201, -1, -2, -2.0344439357957027, 2.23606797749979
258, 75, 148, 355, 151, 357, -3, -2, -2.5535900500422257, 3.605551275463989
258, 84, 182, 169, 184, 168, -2, 1, 2.677945044588987, 2.23606797749979
258, 85, 581, 212, 582, 214, -1, -2, -2.0344439357957027, 2.23606797749979
258, 86, 164, 181, 166, 181, -2, 0, 3.141592653589793, 2.0
259, 17, 223, 365, 226, 365, -3, 0, 3.141592653589793, 3.0
259, 20, 290, 141, 292, 142, -2, -1, -2.677945044588987, 2.23606797749979
259, 38, 141, 357, 144, 358, -3, -1, -2.819842099193151, 3.1622776601683795
259, 41, 168, 166, 170, 166, -2, 0, 3.141592653589793, 2.0
259, 44, 208, 162, 210, 162, -2, 0, 3.141592653589793, 2.0
259, 50, 153, 361, 155, 363, -2, -2, -2.356194490192345, 2.8284271247461903
259, 52, 368, 129, 370, 130, -2, -1, -2.677945044588987, 2.23606797749979
259, 55, 196, 171, 198, 171, -2, 0, 3.141592653589793, 2.0
259, 58, 134, 350, 136, 351, -2, -1, -2.677945044588987, 2.23606797749979
259, 64, 577, 197, 578, 199, -1, -2, -2.0344439357957027, 2.23606797749979
259, 66, 145, 354, 148, 355, -3, -1, -2.819842099193151, 3.1622776601683795
259, 71, 180, 169, 182, 169, -2, 0, 3.141592653589793, 2.0
259, 72, 581, 210, 581, 212, 0, -2, -1.5707963267948966, 2.0
259, 73, 162, 180, 164, 181, -2, -1, -2.677945044588987, 2.23606797749979
259, 74, 236, 136, 238, 137, -2, -1, -2.677945044588987, 2.23606797749979
260, 10, 57, 353, 57, 355, 0, -2, -1.5707963267948966, 2.0
260, 19, 152, 174, 154, 175, -2, -1, -2.677945044588987, 2.23606797749979
260, 32, 144, 180, 146, 180, -2, 0, 3.141592653589793, 2.0
260, 44, 292, 143, 295, 143, -3, 0, 3.141592653589793, 3.0
260, 46, 227, 365, 230, 366, -3, -1, -2.819842099193151, 3.1622776601683795
260, 50, 298, 130, 300, 130, -2, 0, 3.141592653589793, 2.0
260, 64, 123, 344, 125, 345, -2, -1, -2.677945044588987, 2.23606797749979
260, 75, 84, 329, 85, 331, -1, -2, -2.0344439357957027, 2.23606797749979
260, 81, 426, 128, 428, 129, -2, -1, -2.677945044588987, 2.23606797749979
260, 88, 88, 340, 90, 341, -2, -1, -2.677945044588987, 2.23606797749979
260, 89, 139, 347, 142, 350, -3, -3, -2.356194490192345, 4.242640687119285
260, 94, 372, 132, 374, 132, -2, 0, 3.141592653589793, 2.0
260, 108, 590, 214, 590, 216, 0, -2, -1.5707963267948966, 2.0
260, 110, 116, 213, 118, 213, -2, 0, 3.141592653589793, 2.0
260, 112, 171, 167, 173, 167, -2, 0, 3.141592653589793, 2.0
260, 129, 216, 162, 218, 162, -2, 0, 3.141592653589793, 2.0
260, 130, 155, 369, 157, 369, -2, 0, 3.141592653589793, 2.0
260, 141, 199, 173, 201, 173, -2, 0, 3.141592653589793, 2.0
260, 146, 166, 183, 168, 183, -2, 0, 3.141592653589793, 2.0
260, 147, 580, 202, 581, 204, -1, -2, -2.0344439357957027, 2.23606797749979
260, 149, 55, 317, 54, 315, 1, 2, 1.1071487177940904, 2.23606797749979
260, 156, 271, 154, 274, 154, -3, 0, 3.141592653589793, 3.0
260, 160, 150, 336, 153, 337, -3, -1, -2.819842099193151, 3.1622776601683795
260, 161, 131, 344, 133, 345, -2, -1, -2.677945044588987, 2.23606797749979
261, 25, 210, 142, 212, 142, -2, 0, 3.141592653589793, 2.0
261, 33, 289, 142, 292, 143, -3, -1, -2.819842099193151, 3.1622776601683795
261, 35, 223, 365, 227, 365, -4, 0, 3.141592653589793, 4.0
261, 38, 296, 130, 298, 130, -2, 0, 3.141592653589793, 2.0
261, 62, 424, 127, 426, 128, -2, -1, -2.677945044588987, 2.23606797749979
261, 67, 136, 345, 139, 347, -3, -2, -2.5535900500422257, 3.605551275463989
261, 68, 195, 143, 197, 143, -2, 0, 3.141592653589793, 2.0
261, 71, 370, 131, 372, 132, -2, -1, -2.677945044588987, 2.23606797749979
261, 83, 590, 212, 590, 214, 0, -2, -1.5707963267948966, 2.0
261, 100, 153, 368, 155, 369, -2, -1, -2.677945044588987, 2.23606797749979
261, 108, 197, 173, 199, 173, -2, 0, 3.141592653589793, 2.0
261, 112, 164, 183, 166, 183, -2, 0, 3.141592653589793, 2.0
261, 117, 268, 154, 271, 154, -3, 0, 3.141592653589793, 3.0
261, 120, 146, 334, 150, 336, -4, -2, -2.677945044588987, 4.47213595499958
262, 27, 287, 143, 289, 142, -2, 1, 2.677945044588987, 2.23606797749979
262, 29, 220, 364, 223, 365, -3, -1, -2.819842099193151, 3.1622776601683795
262, 32, 294, 130, 296, 130, -2, 0, 3.141592653589793, 2.0
262, 43, 120, 343, 122, 344, -2, -1, -2.677945044588987, 2.23606797749979
262, 52, 422, 126, 424, 127, -2, -1, -2.677945044588987, 2.23606797749979
262, 55, 133, 343, 136, 345, -3, -2, -2.5535900500422257, 3.605551275463989
262, 65, 390, 109, 392, 110, -2, -1, -2.677945044588987, 2.23606797749979
262, 89, 195, 172, 197, 173, -2, -1, -2.677945044588987, 2.23606797749979
262, 97, 265, 154, 268, 154, -3, 0, 3.141592653589793, 3.0
262, 100, 142, 332, 146, 334, -4, -2, -2.677945044588987, 4.47213595499958
263, 18, 285, 143, 287, 143, -2, 0, 3.141592653589793, 2.0
263, 20, 216, 363, 220, 364, -4, -1, -2.896613990462929, 4.123105625617661
263, 23, 292, 130, 294, 130, -2, 0, 3.141592653589793, 2.0
263, 39, 420, 125, 422, 126, -2, -1, -2.677945044588987, 2.23606797749979
263, 42, 130, 343, 133, 343, -3, 0, 3.141592653589793, 3.0
263, 45, 367, 131, 369, 131, -2, 0, 3.141592653589793, 2.0
263, 63, 213, 163, 214, 162, -1, 1, 2.356194490192345, 1.4142135623730951
263, 70, 193, 172, 195, 172, -2, 0, 3.141592653589793, 2.0
263, 71, 126, 206, 124, 207, 2, -1, -0.4636476090008061, 2.23606797749979
263, 74, 160, 183, 163, 183, -3, 0, 3.141592653589793, 3.0
263, 77, 262, 154, 265, 154, -3, 0, 3.141592653589793, 3.0
263, 80, 139, 330, 142, 332, -3, -2, -2.5535900500422257, 3.605551275463989
264, 2, 123, 177, 125, 177, -2, 0, 3.141592653589793, 2.0
264, 18, 284, 144, 285, 143, -1, 1, 2.356194490192345, 1.4142135623730951
264, 20, 212, 363, 216, 363, -4, 0, 3.141592653589793, 4.0
264, 23, 290, 130, 292, 130, -2, 0, 3.141592653589793, 2.0
264, 38, 418, 124, 420, 125, -2, -1, -2.677945044588987, 2.23606797749979
264, 40, 128, 343, 130, 343, -2, 0, 3.141592653589793, 2.0
264, 43, 365, 130, 367, 131, -2, -1, -2.677945044588987, 2.23606797749979
264, 61, 149, 368, 151, 368, -2, 0, 3.141592653589793, 2.0
264, 68, 125, 204, 126, 206, -1, -2, -2.0344439357957027, 2.23606797749979
264, 71, 158, 183, 160, 183, -2, 0, 3.141592653589793, 2.0
264, 74, 259, 155, 262, 154, -3, 1, 2.819842099193151, 3.1622776601683795
264, 76, 137, 329, 139, 330, -2, -1, -2.677945044588987, 2.23606797749979
264, 77, 543, 365, 542, 366, 1, -1, -0.7853981633974483, 1.4142135623730951
265, 4, 289, 143, 291, 143, -2, 0, 3.141592653589793, 2.0
265, 13, 149, 173, 151, 174, -2, -1, -2.677945044588987, 2.23606797749979
265, 40, 295, 130, 297, 131, -2, -1, -2.677945044588987, 2.23606797749979
265, 59, 368, 131, 370, 132, -2, -1, -2.677945044588987, 2.23606797749979
265, 61, 197, 173, 199, 173, -2, 0, 3.141592653589793, 2.0
265, 77, 221, 366, 224, 367, -3, -1, -2.819842099193151, 3.1622776601683795
265, 86, 420, 127, 423, 128, -3, -1, -2.819842099193151, 3.1622776601683795
265, 87, 132, 350, 134, 352, -2, -2, -2.356194490192345, 2.8284271247461903
265, 89, 588, 210, 589, 212, -1, -2, -2.0344439357957027, 2.23606797749979
265, 109, 120, 347, 122, 347, -2, 0, 3.141592653589793, 2.0
265, 111, 131, 334, 135, 337, -4, -3, -2.498091544796509, 5.0
265, 142, 266, 152, 269, 153, -3, -1, -2.819842099193151, 3.1622776601683795
266, 2, 555, 365, 554, 366, 1, -1, -0.7853981633974483, 1.4142135623730951
266, 3, 288, 144, 289, 143, -1, 1, 2.356194490192345, 1.4142135623730951
266, 18, 87, 339, 86, 341, 1, -2, -1.1071487177940904, 2.23606797749979
266, 45, 381, 122, 383, 123, -2, -1, -2.677945044588987, 2.23606797749979
266, 47, 366, 130, 368, 131, -2, -1, -2.677945044588987, 2.23606797749979
266, 49, 195, 173, 197, 173, -2, 0, 3.141592653589793, 2.0
266, 62, 218, 365, 221, 366, -3, -1, -2.819842099193151, 3.1622776601683795
266, 69, 418, 126, 420, 127, -2, -1, -2.677945044588987, 2.23606797749979
266, 70, 130, 349, 132, 350, -2, -1, -2.677945044588987, 2.23606797749979
266, 72, 587, 208, 588, 210, -1, -2, -2.0344439357957027, 2.23606797749979
266, 85, 118, 347, 120, 347, -2, 0, 3.141592653589793, 2.0
266, 87, 128, 332, 131, 334, -3, -2, -2.5535900500422257, 3.605551275463989
266, 108, 225, 158, 227, 157, -2, 1, 2.677945044588987, 2.23606797749979
266, 109, 264, 152, 266, 152, -2, 0, 3.141592653589793, 2.0
266, 114, 584, 309, 583, 310, 1, -1, -0.7853981633974483, 1.4142135623730951
267, 14, 584, 364, 583, 365, 1, -1, -0.7853981633974483, 1.4142135623730951
267, 28, 167, 168, 169, 168, -2, 0, 3.141592653589793, 2.0
267, 37, 193, 173, 195, 173, -2, 0, 3.141592653589793, 2.0
267, 49, 215, 365, 218, 365, -3, 0, 3.141592653589793, 3.0
267, 55, 416, 126, 418, 126, -2, 0, 3.141592653589793, 2.0
267, 56, 128, 347, 130, 349, -2, -2, -2.356194490192345, 2.8284271247461903
267, 67, 116, 347, 118, 347, -2, 0, 3.141592653589793, 2.0
267, 68, 125, 331, 128, 332, -3, -1, -2.819842099193151, 3.1622776601683795
267, 77, 440, 130, 442, 131, -2, -1, -2.677945044588987, 2.23606797749979
267, 84, 223, 158, 225, 158, -2, 0, 3.141592653589793, 2.0
267, 85, 262, 151, 264, 152, -2, -1, -2.677945044588987, 2.23606797749979
268, 2, 286, 145, 288, 144, -2, 1, 2.677945044588987, 2.23606797749979
268, 19, 291, 129, 293, 130, -2, -1, -2.677945044588987, 2.23606797749979
268, 26, 378, 121, 380, 122, -2, -1, -2.677945044588987, 2.23606797749979
268, 28, 191, 172, 193, 173, -2, -1, -2.677945044588987, 2.23606797749979
268, 40, 212, 365, 215, 365, -3, 0, 3.141592653589793, 3.0
268, 45, 126, 347, 128, 347, -2, 0, 3.141592653589793, 2.0
268, 46, 152, 365, 154, 365, -2, 0, 3.141592653589793, 2.0
268, 55, 114, 347, 116, 347, -2, 0, 3.141592653589793, 2.0
268, 56, 123, 329, 125, 331, -2, -2, -2.356194490192345, 2.8284271247461903
268, 66, 123, 212, 124, 211, -1, 1, 2.356194490192345, 1.4142135623730951
269, 2, 283, 146, 286, 145, -3, 1, 2.819842099193151, 3.1622776601683795
269, 17, 288, 128, 291, 129, -3, -1, -2.819842099193151, 3.1622776601683795
269, 32, 208, 162, 210, 162, -2, 0, 3.141592653589793, 2.0
269, 36, 209, 365, 212, 365, -3, 0, 3.141592653589793, 3.0
269, 41, 124, 346, 126, 347, -2, -1, -2.677945044588987, 2.23606797749979
269, 49, 122, 327, 123, 329, -1, -2, -2.0344439357957027, 2.23606797749979
269, 56, 438, 129, 440, 130, -2, -1, -2.677945044588987, 2.23606797749979
270, 7, 285, 144, 287, 144, -2, 0, 3.141592653589793, 2.0
270, 14, 378, 122, 380, 123, -2, -1, -2.677945044588987, 2.23606797749979
270, 28, 53, 185, 55, 186, -2, -1, -2.677945044588987, 2.23606797749979
270, 40, 212, 368, 216, 368, -4, 0, 3.141592653589793, 4.0
270, 43, 146, 171, 148, 172, -2, -1, -2.677945044588987, 2.23606797749979
270, 62, 589, 207, 589, 209, 0, -2, -1.5707963267948966, 2.0
270, 70, 291, 130, 293, 131, -2, -1, -2.677945044588987, 2.23606797749979
270, 83, 124, 330, 126, 332, -2, -2, -2.356194490192345, 2.8284271247461903
270, 84, 140, 201, 142, 201, -2, 0, 3.141592653589793, 2.0
270, 96, 193, 173, 195, 173, -2, 0, 3.141592653589793, 2.0
270, 112, 133, 344, 135, 345, -2, -1, -2.677945044588987, 2.23606797749979
270, 126, 260, 153, 263, 153, -3, 0, 3.141592653589793, 3.0
270, 133, 570, 195, 570, 197, 0, -2, -1.5707963267948966, 2.0
270, 139, 116, 348, 118, 348, -2, 0, 3.141592653589793, 2.0
271, 6, 283, 145, 285, 144, -2, 1, 2.677945044588987, 2.23606797749979
271, 29, 208, 368, 212, 368, -4, 0, 3.141592653589793, 4.0
271, 51, 289, 129, 291, 130, -2, -1, -2.677945044588987, 2.23606797749979
271, 69, 191, 173, 193, 173, -2, 0, 3.141592653589793, 2.0
271, 81, 131, 343, 133, 344, -2, -1, -2.677945044588987, 2.23606797749979
271, 85, 110, 352, 112, 353, -2, -1, -2.677945044588987, 2.23606797749979
271, 90, 258, 153, 260, 153, -2, 0, 3.141592653589793, 2.0
271, 91, 553, 361, 552, 362, 1, -1, -0.7853981633974483, 1.4142135623730951
271, 93, 278, 134, 280, 134, -2, 0, 3.141592653589793, 2.0
271, 94, 570, 193, 570, 195, 0, -2, -1.5707963267948966, 2.0
272, 6, 281, 146, 283, 145, -2, 1, 2.677945044588987, 2.23606797749979
272, 11, 375, 121, 377, 122, -2, -1, -2.677945044588987, 2.23606797749979
272, 29, 205, 367, 208, 368, -3, -1, -2.819842099193151, 3.1622776601683795
272, 51, 287, 129, 289, 129, -2, 0, 3.141592653589793, 2.0
272, 59, 121, 329, 123, 330, -2, -1, -2.677945044588987, 2.23606797749979
272, 60, 137, 202, 139, 201, -2, 1, 2.677945044588987, 2.23606797749979
272, 65, 189, 173, 191, 173, -2, 0, 3.141592653589793, 2.0
272, 74, 129, 341, 131, 343, -2, -2, -2.356194490192345, 2.8284271247461903
272, 80, 254, 152, 258, 153, -4, -1, -2.896613990462929, 4.123105625617661
272, 81, 554, 360, 553, 361, 1, -1, -0.7853981633974483, 1.4142135623730951
272, 83, 570, 191, 570, 193, 0, -2, -1.5707963267948966, 2.0
273, 6, 279, 146, 281, 146, -2, 0, 3.141592653589793, 2.0
273, 7, 139, 179, 141, 179, -2, 0, 3.141592653589793, 2.0
273, 27, 202, 366, 205, 367, -3, -1, -2.819842099193151, 3.1622776601683795
273, 34, 166, 167, 167, 166, -1, 1, 2.356194490192345, 1.4142135623730951
273, 50, 414, 127, 416, 127, -2, 0, 3.141592653589793, 2.0
273, 60, 187, 172, 189, 173, -2, -1, -2.677945044588987, 2.23606797749979
273, 67, 127, 339, 129, 341, -2, -2, -2.356194490192345, 2.8284271247461903
273, 72, 252, 151, 254, 152, -2, -1, -2.677945044588987, 2.23606797749979
274, 5, 276, 147, 279, 146, -3, 1, 2.819842099193151, 3.1622776601683795
274, 15, 582, 180, 582, 182, 0, -2, -1.5707963267948966, 2.0
274, 23, 200, 366, 202, 366, -2, 0, 3.141592653589793, 2.0
274, 41, 412, 126, 414, 127, -2, -1, -2.677945044588987, 2.23606797749979
274, 49, 185, 172, 187, 172, -2, 0, 3.141592653589793, 2.0
274, 53, 125, 338, 127, 339, -2, -1, -2.677945044588987, 2.23606797749979
274, 57, 250, 151, 252, 151, -2, 0, 3.141592653589793, 2.0
274, 58, 555, 358, 554, 359, 1, -1, -0.7853981633974483, 1.4142135623730951
275, 2, 283, 147, 285, 147, -2, 0, 3.141592653589793, 2.0
275, 19, 205, 366, 208, 366, -3, 0, 3.141592653589793, 3.0
275, 54, 376, 121, 378, 122, -2, -1, -2.677945044588987, 2.23606797749979
275, 65, 362, 129, 364, 130, -2, -1, -2.677945044588987, 2.23606797749979
275, 70, 132, 339, 134, 341, -2, -2, -2.356194490192345, 2.8284271247461903
275, 78, 188, 175, 190, 175, -2, 0, 3.141592653589793, 2.0
275, 82, 132, 349, 134, 350, -2, -1, -2.677945044588987, 2.23606797749979
275, 111, 143, 171, 145, 172, -2, -1, -2.677945044588987, 2.23606797749979
275, 115, 414, 127, 416, 127, -2, 0, 3.141592653589793, 2.0
275, 133, 125, 343, 127, 345, -2, -2, -2.356194490192345, 2.8284271247461903
275, 136, 288, 129, 290, 130, -2, -1, -2.677945044588987, 2.23606797749979
275, 150, 210, 168, 212, 168, -2, 0, 3.141592653589793, 2.0
276, 2, 279, 147, 283, 147, -4, 0, 3.141592653589793, 4.0
276, 10, 340, 137, 342, 137, -2, 0, 3.141592653589793, 2.0
276, 16, 201, 365, 205, 366, -4, -1, -2.896613990462929, 4.123105625617661
276, 39, 581, 181, 582, 183, -1, -2, -2.0344439357957027, 2.23606797749979
276, 52, 360, 128, 362, 129, -2, -1, -2.677945044588987, 2.23606797749979
276, 55, 130, 337, 132, 339, -2, -2, -2.356194490192345, 2.8284271247461903
276, 62, 186, 175, 188, 175, -2, 0, 3.141592653589793, 2.0
276, 66, 131, 347, 132, 349, -1, -2, -2.0344439357957027, 2.23606797749979
276, 89, 412, 127, 414, 127, -2, 0, 3.141592653589793, 2.0
276, 102, 123, 341, 125, 343, -2, -2, -2.356194490192345, 2.8284271247461903
276, 105, 286, 128, 288, 129, -2, -1, -2.677945044588987, 2.23606797749979
276, 118, 120, 216, 121, 215, -1, 1, 2.356194490192345, 1.4142135623730951
277, 2, 276, 147, 279, 147, -3, 0, 3.141592653589793, 3.0
277, 9, 338, 136, 340, 137, -2, -1, -2.677945044588987, 2.23606797749979
277, 13, 198, 364, 201, 365, -3, -1, -2.819842099193151, 3.1622776601683795
277, 32, 373, 120, 375, 121, -2, -1, -2.677945044588987, 2.23606797749979
277, 41, 358, 127, 360, 128, -2, -1, -2.677945044588987, 2.23606797749979
277, 43, 129, 335, 130, 337, -1, -2, -2.0344439357957027, 2.23606797749979
277, 45, 228, 120, 230, 120, -2, 0, 3.141592653589793, 2.0
277, 80, 275, 136, 277, 136, -2, 0, 3.141592653589793, 2.0
277, 85, 207, 168, 209, 168, -2, 0, 3.141592653589793, 2.0
278, 2, 273, 147, 276, 147, -3, 0, 3.141592653589793, 3.0
278, 6, 138, 179, 140, 179, -2, 0, 3.141592653589793, 2.0
278, 9, 335, 135, 338, 136, -3, -1, -2.819842099193151, 3.1622776601683795
278, 11, 196, 363, 198, 364, -2, -1, -2.677945044588987, 2.23606797749979
278, 36, 127, 333, 129, 335, -2, -2, -2.356194490192345, 2.8284271247461903
278, 40, 183, 175, 185, 175, -2, 0, 3.141592653589793, 2.0
278, 57, 409, 126, 411, 127, -2, -1, -2.677945044588987, 2.23606797749979
279, 2, 269, 147, 273, 147, -4, 0, 3.141592653589793, 4.0
279, 5, 137, 180, 138, 179, -1, 1, 2.356194490192345, 1.4142135623730951
279, 6, 195, 125, 196, 124, -1, 1, 2.356194490192345, 1.4142135623730951
279, 8, 333, 135, 335, 135, -2, 0, 3.141592653589793, 2.0
279, 10, 193, 362, 196, 363, -3, -1, -2.819842099193151, 3.1622776601683795
279, 12, 317, 119, 319, 119, -2, 0, 3.141592653589793, 2.0
279, 13, 177, 142, 179, 141, -2, 1, 2.677945044588987, 2.23606797749979
279, 21, 577, 155, 579, 156, -2, -1, -2.677945044588987, 2.23606797749979
279, 26, 370, 120, 372, 120, -2, 0, 3.141592653589793, 2.0
279, 60, 273, 135, 275, 136, -2, -1, -2.677945044588987, 2.23606797749979
280, 10, 337, 136, 340, 137, -3, -1, -2.819842099193151, 3.1622776601683795
280, 12, 272, 149, 276, 148, -4, 1, 2.896613990462929, 4.123105625617661
280, 26, 200, 369, 202, 369, -2, 0, 3.141592653589793, 2.0
280, 35, 581, 177, 582, 179, -1, -2, -2.0344439357957027, 2.23606797749979
280, 66, 129, 337, 130, 339, -1, -2, -2.0344439357957027, 2.23606797749979
280, 78, 288, 118, 290, 119, -2, -1, -2.677945044588987, 2.23606797749979
280, 87, 284, 129, 286, 129, -2, 0, 3.141592653589793, 2.0
280, 92, 358, 127, 360, 128, -2, -1, -2.677945044588987, 2.23606797749979
280, 113, 185, 175, 187, 175, -2, 0, 3.141592653589793, 2.0
280, 128, 436, 131, 438, 131, -2, 0, 3.141592653589793, 2.0
280, 135, 151, 190, 153, 190, -2, 0, 3.141592653589793, 2.0
280, 141, 208, 170, 210, 170, -2, 0, 3.141592653589793, 2.0
280, 150, 342, 143, 346, 143, -4, 0, 3.141592653589793, 4.0
281, 10, 268, 149, 272, 149, -4, 0, 3.141592653589793, 4.0
281, 20, 203, 146, 205, 146, -2, 0, 3.141592653589793, 2.0
281, 66, 282, 128, 284, 129, -2, -1, -2.677945044588987, 2.23606797749979
281, 71, 356, 126, 358, 127, -2, -1, -2.677945044588987, 2.23606797749979
281, 108, 207, 171, 208, 170, -1, 1, 2.356194490192345, 1.4142135623730951
281, 114, 340, 143, 342, 143, -2, 0, 3.141592653589793, 2.0
281, 117, 361, 134, 363, 135, -2, -1, -2.677945044588987, 2.23606797749979
282, 8, 334, 136, 336, 136, -2, 0, 3.141592653589793, 2.0
282, 9, 264, 148, 268, 149, -4, -1, -2.896613990462929, 4.123105625617661
282, 17, 197, 369, 199, 369, -2, 0, 3.141592653589793, 2.0
282, 47, 162, 170, 164, 170, -2, 0, 3.141592653589793, 2.0
282, 55, 280, 128, 282, 128, -2, 0, 3.141592653589793, 2.0
282, 60, 354, 125, 356, 126, -2, -1, -2.677945044588987, 2.23606797749979
282, 73, 183, 176, 184, 175, -1, 1, 2.356194490192345, 1.4142135623730951
282, 79, 108, 357, 109, 356, -1, 1, 2.356194490192345, 1.4142135623730951
282, 89, 205, 171, 207, 171, -2, 0, 3.141592653589793, 2.0
282, 95, 338, 141, 340, 143, -2, -2, -2.356194490192345, 2.8284271247461903
282, 98, 359, 133, 361, 134, -2, -1, -2.677945044588987, 2.23606797749979
283, 6, 332, 136, 334, 136, -2, 0, 3.141592653589793, 2.0
283, 7, 260, 148, 264, 148, -4, 0, 3.141592653589793, 4.0
283, 14, 195, 369, 197, 369, -2, 0, 3.141592653589793, 2.0
283, 49, 352, 124, 354, 125, -2, -1, -2.677945044588987, 2.23606797749979
283, 73, 204, 172, 205, 171, -1, 1, 2.356194490192345, 1.4142135623730951
283, 78, 336, 140, 338, 141, -2, -1, -2.677945044588987, 2.23606797749979
283, 81, 357, 132, 359, 133, -2, -1, -2.677945044588987, 2.23606797749979
284, 5, 330, 136, 332, 136, -2, 0, 3.141592653589793, 2.0
284, 6, 258, 148, 260, 148, -2, 0, 3.141592653589793, 2.0
284, 12, 193, 369, 195, 369, -2, 0, 3.141592653589793, 2.0
284, 28, 271, 138, 273, 138, -2, 0, 3.141592653589793, 2.0
284, 30, 159, 170, 161, 170, -2, 0, 3.141592653589793, 2.0
284, 45, 180, 177, 182, 176, -2, 1, 2.677945044588987, 2.23606797749979
284, 46, 80, 196, 82, 196, -2, 0, 3.141592653589793, 2.0
284, 63, 333, 139, 336, 140, -3, -1, -2.819842099193151, 3.1622776601683795
284, 66, 355, 131, 357, 132, -2, -1, -2.677945044588987, 2.23606797749979
285, 21, 331, 135, 334, 136, -3, -1, -2.819842099193151, 3.1622776601683795
285, 23, 263, 150, 268, 150, -5, 0, 3.141592653589793, 5.0
285, 40, 197, 367, 199, 367, -2, 0, 3.141592653589793, 2.0
285, 44, 122, 327, 122, 329, 0, -2, -1.5707963267948966, 2.0
285, 51, 161, 171, 163, 171, -2, 0, 3.141592653589793, 2.0
285, 54, 354, 128, 356, 129, -2, -1, -2.677945044588987, 2.23606797749979
285, 96, 205, 172, 207, 172, -2, 0, 3.141592653589793, 2.0
285, 105, 574, 189, 575, 191, -1, -2, -2.0344439357957027, 2.23606797749979
285, 108, 272, 139, 274, 138, -2, 1, 2.677945044588987, 2.23606797749979
285, 112, 281, 130, 283, 130, -2, 0, 3.141592653589793, 2.0
285, 115, 179, 175, 181, 175, -2, 0, 3.141592653589793, 2.0
285, 133, 164, 186, 166, 186, -2, 0, 3.141592653589793, 2.0
285, 140, 339, 140, 341, 140, -2, 0, 3.141592653589793, 2.0
285, 142, 219, 166, 221, 166, -2, 0, 3.141592653589793, 2.0
285, 146, 243, 153, 245, 152, -2, 1, 2.677945044588987, 2.23606797749979
285, 154, 319, 138, 321, 139, -2, -1, -2.677945044588987, 2.23606797749979
285, 156, 567, 188, 568, 190, -1, -2, -2.0344439357957027, 2.23606797749979
286, 15, 329, 134, 331, 135, -2, -1, -2.677945044588987, 2.23606797749979
286, 17, 258, 149, 263, 150, -5, -1, -2.9441970937399127, 5.0990195135927845
286, 28, 195, 366, 197, 367, -2, -1, -2.677945044588987, 2.23606797749979
286, 38, 159, 171, 161, 171, -2, 0, 3.141592653589793, 2.0
286, 39, 69, 251, 68, 252, 1, -1, -0.7853981633974483, 1.4142135623730951
286, 72, 202, 172, 205, 172, -3, 0, 3.141592653589793, 3.0
286, 75, 409, 129, 411, 129, -2, 0, 3.141592653589793, 2.0
286, 82, 270, 139, 272, 139, -2, 0, 3.141592653589793, 2.0
286, 87, 177, 175, 179, 175, -2, 0, 3.141592653589793, 2.0
286, 102, 162, 187, 164, 186, -2, 1, 2.677945044588987, 2.23606797749979
286, 106, 137, 209, 138, 208, -1, 1, 2.356194490192345, 1.4142135623730951
286, 108, 337, 140, 339, 140, -2, 0, 3.141592653589793, 2.0
286, 109, 217, 166, 219, 166, -2, 0, 3.141592653589793, 2.0
286, 113, 240, 153, 243, 153, -3, 0, 3.141592653589793, 3.0
286, 118, 316, 137, 319, 138, -3, -1, -2.819842099193151, 3.1622776601683795
287, 15, 327, 134, 329, 134, -2, 0, 3.141592653589793, 2.0
287, 16, 254, 149, 258, 149, -4, 0, 3.141592653589793, 4.0
287, 23, 193, 366, 195, 366, -2, 0, 3.141592653589793, 2.0
287, 26, 122, 324, 122, 326, 0, -2, -1.5707963267948966, 2.0
287, 31, 157, 171, 159, 171, -2, 0, 3.141592653589793, 2.0
287, 57, 200, 172, 202, 172, -2, 0, 3.141592653589793, 2.0
287, 60, 407, 128, 409, 129, -2, -1, -2.677945044588987, 2.23606797749979
287, 66, 278, 130, 280, 130, -2, 0, 3.141592653589793, 2.0
287, 69, 175, 175, 177, 175, -2, 0, 3.141592653589793, 2.0
287, 83, 160, 187, 162, 187, -2, 0, 3.141592653589793, 2.0
287, 87, 136, 210, 137, 209, -1, 1, 2.356194490192345, 1.4142135623730951
287, 89, 334, 139, 337, 140, -3, -1, -2.819842099193151, 3.1622776601683795
287, 90, 215, 166, 217, 166, -2, 0, 3.141592653589793, 2.0
287, 92, 237, 153, 240, 153, -3, 0, 3.141592653589793, 3.0
288, 15, 325, 133, 327, 134, -2, -1, -2.677945044588987, 2.23606797749979
288, 16, 251, 146, 254, 149, -3, -3, -2.356194490192345, 4.242640687119285
288, 24, 121, 322, 122, 324, -1, -2, -2.0344439357957027, 2.23606797749979
288, 29, 155, 170, 157, 171, -2, -1, -2.677945044588987, 2.23606797749979
288, 51, 198, 172, 200, 172, -2, 0, 3.141592653589793, 2.0
288, 61, 173, 175, 175, 175, -2, 0, 3.141592653589793, 2.0
288, 72, 158, 187, 160, 187, -2, 0, 3.141592653589793, 2.0
288, 76, 135, 211, 136, 210, -1, 1, 2.356194490192345, 1.4142135623730951
288, 78, 331, 139, 334, 139, -3, 0, 3.141592653589793, 3.0
288, 81, 234, 152, 237, 153, -3, -1, -2.819842099193151, 3.1622776601683795
289, 12, 323, 133, 325, 133, -2, 0, 3.141592653589793, 2.0
289, 16, 190, 365, 192, 366, -2, -1, -2.677945044588987, 2.23606797749979
289, 20, 110, 345, 110, 347, 0, -2, -1.5707963267948966, 2.0
289, 39, 404, 127, 406, 128, -2, -1, -2.677945044588987, 2.23606797749979
289, 43, 275, 130, 277, 130, -2, 0, 3.141592653589793, 2.0
289, 52, 156, 187, 158, 187, -2, 0, 3.141592653589793, 2.0
289, 54, 134, 212, 135, 211, -1, 1, 2.356194490192345, 1.4142135623730951
289, 56, 328, 138, 331, 139, -3, -1, -2.819842099193151, 3.1622776601683795
289, 57, 211, 166, 214, 166, -3, 0, 3.141592653589793, 3.0
289, 59, 232, 152, 234, 152, -2, 0, 3.141592653589793, 2.0
290, 8, 328, 136, 330, 136, -2, 0, 3.141592653589793, 2.0
290, 23, 255, 151, 259, 152, -4, -1, -2.896613990462929, 4.123105625617661
290, 42, 193, 367, 195, 367, -2, 0, 3.141592653589793, 2.0
290, 79, 139, 213, 140, 212, -1, 1, 2.356194490192345, 1.4142135623730951
290, 107, 198, 171, 200, 171, -2, 0, 3.141592653589793, 2.0
290, 108, 192, 149, 194, 149, -2, 0, 3.141592653589793, 2.0
290, 112, 271, 141, 273, 140, -2, 1, 2.677945044588987, 2.23606797749979
290, 118, 351, 129, 353, 129, -2, 0, 3.141592653589793, 2.0
290, 122, 406, 129, 408, 130, -2, -1, -2.677945044588987, 2.23606797749979
290, 123, 237, 155, 239, 156, -2, -1, -2.677945044588987, 2.23606797749979
291, 3, 326, 135, 328, 136, -2, -1, -2.677945044588987, 2.23606797749979
291, 15, 252, 150, 255, 151, -3, -1, -2.819842099193151, 3.1622776601683795
291, 32, 191, 367, 193, 367, -2, 0, 3.141592653589793, 2.0
291, 61, 138, 214, 139, 213, -1, 1, 2.356194490192345, 1.4142135623730951
291, 82, 196, 172, 198, 171, -2, 1, 2.677945044588987, 2.23606797749979
291, 85, 269, 142, 271, 141, -2, 1, 2.677945044588987, 2.23606797749979
291, 94, 404, 128, 406, 129, -2, -1, -2.677945044588987, 2.23606797749979
292, 2, 324, 134, 326, 135, -2, -1, -2.677945044588987, 2.23606797749979
292, 10, 248, 148, 252, 150, -4, -2, -2.677945044588987, 4.47213595499958
292, 15, 581, 172, 581, 175, 0, -3, -1.5707963267948966, 3.0
292, 26, 189, 366, 191, 367, -2, -1, -2.677945044588987, 2.23606797749979
292, 47, 137, 215, 138, 214, -1, 1, 2.356194490192345, 1.4142135623730951
292, 54, 160, 150, 162, 150, -2, 0, 3.141592653589793, 2.0
292, 62, 194, 172, 196, 172, -2, 0, 3.141592653589793, 2.0
292, 68, 348, 129, 350, 129, -2, 0, 3.141592653589793, 2.0
292, 71, 402, 127, 404, 128, -2, -1, -2.677945044588987, 2.23606797749979
293, 1, 321, 134, 324, 134, -3, 0, 3.141592653589793, 3.0
293, 6, 245, 146, 248, 148, -3, -2, -2.5535900500422257, 3.605551275463989
293, 18, 187, 365, 189, 366, -2, -1, -2.677945044588987, 2.23606797749979
293, 35, 136, 216, 137, 215, -1, 1, 2.356194490192345, 1.4142135623730951
293, 47, 192, 172, 194, 172, -2, 0, 3.141592653589793, 2.0
294, 1, 319, 133, 321, 134, -2, -1, -2.677945044588987, 2.23606797749979
294, 4, 244, 144, 245, 146, -1, -2, -2.0344439357957027, 2.23606797749979
294, 16, 185, 364, 187, 365, -2, -1, -2.677945044588987, 2.23606797749979
294, 28, 134, 217, 136, 216, -2, 1, 2.677945044588987, 2.23606797749979
294, 33, 275, 131, 277, 131, -2, 0, 3.141592653589793, 2.0
294, 37, 189, 173, 192, 172, -3, 1, 2.819842099193151, 3.1622776601683795
294, 40, 265, 142, 267, 142, -2, 0, 3.141592653589793, 2.0
295, 4, 323, 135, 325, 136, -2, -1, -2.677945044588987, 2.23606797749979
295, 45, 188, 366, 191, 367, -3, -1, -2.819842099193151, 3.1622776601683795
295, 56, 247, 150, 250, 151, -3, -1, -2.819842099193151, 3.1622776601683795
295, 81, 265, 145, 267, 145, -2, 0, 3.141592653589793, 2.0
295, 111, 195, 176, 198, 175, -3, 1, 2.819842099193151, 3.1622776601683795
295, 119, 131, 346, 134, 347, -3, -1, -2.819842099193151, 3.1622776601683795
295, 125, 175, 184, 178, 183, -3, 1, 2.819842099193151, 3.1622776601683795
295, 130, 137, 216, 139, 215, -2, 1, 2.677945044588987, 2.23606797749979
295, 132, 235, 154, 237, 154, -2, 0, 3.141592653589793, 2.0
296, 3, 320, 135, 323, 135, -3, 0, 3.141592653589793, 3.0
296, 30, 66, 136, 68, 137, -2, -1, -2.677945044588987, 2.23606797749979
296, 38, 186, 365, 188, 366, -2, -1, -2.677945044588987, 2.23606797749979
296, 43, 275, 133, 277, 133, -2, 0, 3.141592653589793, 2.0
296, 44, 243, 149, 247, 150, -4, -1, -2.896613990462929, 4.123105625617661
296, 57, 589, 156, 591, 157, -2, -1, -2.677945044588987, 2.23606797749979
296, 61, 262, 145, 265, 145, -3, 0, 3.141592653589793, 3.0
296, 82, 192, 176, 195, 176, -3, 0, 3.141592653589793, 3.0
296, 90, 173, 185, 175, 184, -2, 1, 2.677945044588987, 2.23606797749979
296, 93, 136, 217, 137, 216, -1, 1, 2.356194490192345, 1.4142135623730951
297, 3, 317, 134, 320, 135, -3, -1, -2.819842099193151, 3.1622776601683795
297, 26, 183, 364, 186, 365, -3, -1, -2.819842099193151, 3.1622776601683795
297, 30, 240, 148, 243, 149, -3, -1, -2.819842099193151, 3.1622776601683795
297, 42, 259, 145, 262, 145, -3, 0, 3.141592653589793, 3.0
297, 58, 189, 176, 192, 176, -3, 0, 3.141592653589793, 3.0
297, 65, 170, 186, 173, 185, -3, 1, 2.819842099193151, 3.1622776601683795
297, 67, 134, 218, 136, 217, -2, 1, 2.677945044588987, 2.23606797749979
297, 69, 232, 154, 234, 154, -2, 0, 3.141592653589793, 2.0
298, 3, 315, 134, 317, 134, -2, 0, 3.141592653589793, 2.0
298, 23, 181, 363, 183, 364, -2, -1, -2.677945044588987, 2.23606797749979
298, 27, 237, 147, 240, 148, -3, -1, -2.819842099193151, 3.1622776601683795
298, 36, 257, 145, 259, 145, -2, 0, 3.141592653589793, 2.0
298, 47, 154, 191, 155, 190, -1, 1, 2.356194490192345, 1.4142135623730951
298, 52, 187, 176, 189, 176, -2, 0, 3.141592653589793, 2.0
298, 59, 168, 186, 170, 186, -2, 0, 3.141592653589793, 2.0
298, 62, 230, 154, 232, 154, -2, 0, 3.141592653589793, 2.0
299, 2, 313, 133, 315, 134, -2, -1, -2.677945044588987, 2.23606797749979
299, 22, 271, 133, 273, 133, -2, 0, 3.141592653589793, 2.0
299, 31, 255, 144, 257, 145, -2, -1, -2.677945044588987, 2.23606797749979
299, 43, 185, 176, 187, 176, -2, 0, 3.141592653589793, 2.0
299, 48, 166, 186, 168, 186, -2, 0, 3.141592653589793, 2.0
299, 49, 131, 219, 133, 218, -2, 1, 2.677945044588987, 2.23606797749979
299, 50, 228, 153, 230, 154, -2, -1, -2.677945044588987, 2.23606797749979
300, 0, 316, 136, 319, 136, -3, 0, 3.141592653589793, 3.0
300, 13, 239, 147, 242, 147, -3, 0, 3.141592653589793, 3.0
300, 87, 400, 127, 402, 128, -2, -1, -2.677945044588987, 2.23606797749979
300, 102, 506, 129, 508, 129, -2, 0, 3.141592653589793, 2.0
300, 103, 274, 134, 276, 134, -2, 0, 3.141592653589793, 2.0
300, 104, 135, 220, 136, 219, -1, 1, 2.356194490192345, 1.4142135623730951
300, 105, 570, 156, 571, 155, -1, 1, 2.356194490192345, 1.4142135623730951
300, 118, 171, 186, 173, 186, -2, 0, 3.141592653589793, 2.0
300, 123, 184, 370, 187, 370, -3, 0, 3.141592653589793, 3.0
300, 133, 193, 178, 195, 178, -2, 0, 3.141592653589793, 2.0
300, 140, 143, 356, 146, 358, -3, -2, -2.5535900500422257, 3.605551275463989
300, 143, 146, 198, 147, 197, -1, 1, 2.356194490192345, 1.4142135623730951
300, 148, 335, 144, 336, 146, -1, -2, -2.0344439357957027, 2.23606797749979
300, 156, 264, 151, 266, 151, -2, 0, 3.141592653589793, 2.0
300, 157, 510, 140, 511, 142, -1, -2, -2.0344439357957027, 2.23606797749979
301, 0, 313, 135, 316, 136, -3, -1, -2.819842099193151, 3.1622776601683795
301, 2, 197, 124, 199, 125, -2, -1, -2.677945044588987, 2.23606797749979
301, 10, 237, 147, 239, 147, -2, 0, 3.141592653589793, 2.0
301, 25, 271, 122, 273, 123, -2, -1, -2.677945044588987, 2.23606797749979
301, 50, 517, 116, 518, 119, -1, -3, -1.892546881191539, 3.1622776601683795
301, 53, 344, 129, 347, 130, -3, -1, -2.819842099193151, 3.1622776601683795
301, 60, 397, 125, 400, 127, -3, -2, -2.5535900500422257, 3.605551275463989
301, 71, 505, 127, 506, 129, -1, -2, -2.0344439357957027, 2.23606797749979
301, 72, 270, 133, 274, 134, -4, -1, -2.896613990462929, 4.123105625617661
301, 82, 169, 186, 171, 186, -2, 0, 3.141592653589793, 2.0
301, 86, 182, 370, 184, 370, -2, 0, 3.141592653589793, 2.0
301, 93, 191, 178, 193, 178, -2, 0, 3.141592653589793, 2.0
301, 101, 144, 198, 146, 198, -2, 0, 3.141592653589793, 2.0
301, 104, 333, 143, 335, 144, -2, -1, -2.677945044588987, 2.23606797749979
301, 111, 261, 152, 264, 151, -3, 1, 2.819842099193151, 3.1622776601683795
302, 0, 310, 134, 313, 135, -3, -1, -2.819842099193151, 3.1622776601683795
302, 13, 314, 120, 316, 120, -2, 0, 3.141592653589793, 2.0
302, 27, 368, 122, 370, 122, -2, 0, 3.141592653589793, 2.0
302, 56, 133, 221, 134, 220, -1, 1, 2.356194490192345, 1.4142135623730951
302, 64, 167, 186, 169, 186, -2, 0, 3.141592653589793, 2.0
302, 67, 179, 369, 182, 370, -3, -1, -2.819842099193151, 3.1622776601683795
302, 73, 188, 178, 191, 178, -3, 0, 3.141592653589793, 3.0
302, 80, 331, 143, 333, 143, -2, 0, 3.141592653589793, 2.0
302, 86, 258, 151, 261, 152, -3, -1, -2.819842099193151, 3.1622776601683795
303, 35, 394, 124, 396, 125, -2, -1, -2.677945044588987, 2.23606797749979
303, 48, 154, 192, 155, 191, -1, 1, 2.356194490192345, 1.4142135623730951
303, 49, 165, 186, 167, 186, -2, 0, 3.141592653589793, 2.0
303, 52, 177, 369, 179, 369, -2, 0, 3.141592653589793, 2.0
303, 67, 254, 151, 258, 151, -4, 0, 3.141592653589793, 4.0
304, 0, 307, 133, 309, 134, -2, -1, -2.677945044588987, 2.23606797749979
304, 21, 278, 117, 280, 118, -2, -1, -2.677945044588987, 2.23606797749979
304, 34, 64, 140, 66, 141, -2, -1, -2.677945044588987, 2.23606797749979
304, 43, 175, 369, 177, 369, -2, 0, 3.141592653589793, 2.0
304, 46, 185, 179, 187, 178, -2, 1, 2.677945044588987, 2.23606797749979
304, 54, 252, 151, 254, 151, -2, 0, 3.141592653589793, 2.0
305, 16, 237, 147, 239, 147, -2, 0, 3.141592653589793, 2.0
305, 19, 180, 367, 182, 367, -2, 0, 3.141592653589793, 2.0
305, 26, 309, 136, 312, 136, -3, 0, 3.141592653589793, 3.0
305, 29, 504, 128, 506, 128, -2, 0, 3.141592653589793, 2.0
305, 33, 367, 124, 369, 124, -2, 0, 3.141592653589793, 2.0
305, 43, 136, 193, 138, 193, -2, 0, 3.141592653589793, 2.0
305, 51, 141, 367, 143, 367, -2, 0, 3.141592653589793, 2.0
305, 90, 168, 188, 170, 188, -2, 0, 3.141592653589793, 2.0
305, 105, 138, 353, 141, 355, -3, -2, -2.5535900500422257, 3.605551275463989
305, 106, 396, 127, 398, 127, -2, 0, 3.141592653589793, 2.0
305, 133, 188, 182, 190, 181, -2, 1, 2.677945044588987, 2.23606797749979
305, 148, 427, 134, 429, 136, -2, -2, -2.356194490192345, 2.8284271247461903
305, 152, 156, 201, 157, 200, -1, 1, 2.356194490192345, 1.4142135623730951
306, 12, 235, 147, 237, 147, -2, 0, 3.141592653589793, 2.0
306, 13, 178, 366, 180, 367, -2, -1, -2.677945044588987, 2.23606797749979
306, 17, 307, 136, 309, 136, -2, 0, 3.141592653589793, 2.0
306, 28, 311, 120, 313, 120, -2, 0, 3.141592653589793, 2.0
306, 58, 133, 223, 134, 222, -1, 1, 2.356194490192345, 1.4142135623730951
306, 67, 166, 188, 168, 188, -2, 0, 3.141592653589793, 2.0
306, 79, 135, 352, 138, 353, -3, -1, -2.819842099193151, 3.1622776601683795
306, 80, 394, 127, 396, 127, -2, 0, 3.141592653589793, 2.0
306, 95, 268, 135, 270, 135, -2, 0, 3.141592653589793, 2.0
306, 96, 226, 157, 228, 157, -2, 0, 3.141592653589793, 2.0
306, 100, 187, 183, 188, 182, -1, 1, 2.356194490192345, 1.4142135623730951
306, 112, 425, 133, 427, 134, -2, -1, -2.677945044588987, 2.23606797749979
307, 11, 233, 147, 235, 147, -2, 0, 3.141592653589793, 2.0
307, 12, 176, 365, 178, 366, -2, -1, -2.677945044588987, 2.23606797749979
307, 15, 197, 151, 198, 150, -1, 1, 2.356194490192345, 1.4142135623730951
307, 16, 305, 136, 307, 136, -2, 0, 3.141592653589793, 2.0
307, 33, 341, 129, 343, 129, -2, 0, 3.141592653589793, 2.0
307, 65, 131, 351, 135, 352, -4, -1, -2.896613990462929, 4.123105625617661
307, 71, 278, 118, 280, 119, -2, -1, -2.677945044588987, 2.23606797749979
307, 80, 266, 135, 268, 135, -2, 0, 3.141592653589793, 2.0
307, 81, 224, 157, 226, 157, -2, 0, 3.141592653589793, 2.0
307, 84, 185, 184, 187, 183, -2, 1, 2.677945044588987, 2.23606797749979
307, 94, 423, 132, 425, 133, -2, -1, -2.677945044588987, 2.23606797749979
307, 97, 154, 202, 155, 201, -1, 1, 2.356194490192345, 1.4142135623730951
308, 10, 174, 364, 176, 365, -2, -1, -2.677945044588987, 2.23606797749979
308, 14, 303, 136, 305, 136, -2, 0, 3.141592653589793, 2.0
308, 18, 363, 124, 365, 124, -2, 0, 3.141592653589793, 2.0
308, 20, 308, 120, 310, 120, -2, 0, 3.141592653589793, 2.0
308, 43, 132, 224, 133, 223, -1, 1, 2.356194490192345, 1.4142135623730951
308, 49, 163, 187, 165, 188, -2, -1, -2.677945044588987, 2.23606797749979
308, 55, 129, 350, 131, 351, -2, -1, -2.677945044588987, 2.23606797749979
308, 56, 391, 127, 393, 127, -2, 0, 3.141592653589793, 2.0
308, 67, 220, 157, 224, 157, -4, 0, 3.141592653589793, 4.0
308, 70, 183, 185, 185, 184, -2, 1, 2.677945044588987, 2.23606797749979
308, 74, 152, 192, 154, 191, -2, 1, 2.677945044588987, 2.23606797749979
308, 80, 421, 131, 423, 132, -2, -1, -2.677945044588987, 2.23606797749979
309, 8, 171, 362, 174, 364, -3, -2, -2.5535900500422257, 3.605551275463989
309, 11, 300, 135, 303, 136, -3, -1, -2.819842099193151, 3.1622776601683795
309, 14, 361, 123, 363, 124, -2, -1, -2.677945044588987, 2.23606797749979
309, 25, 338, 129, 340, 129, -2, 0, 3.141592653589793, 2.0
309, 28, 142, 200, 143, 199, -1, 1, 2.356194490192345, 1.4142135623730951
309, 46, 389, 127, 391, 127, -2, 0, 3.141592653589793, 2.0
309, 49, 275, 117, 277, 118, -2, -1, -2.677945044588987, 2.23606797749979
309, 55, 263, 135, 265, 135, -2, 0, 3.141592653589793, 2.0
309, 56, 218, 157, 220, 157, -2, 0, 3.141592653589793, 2.0
309, 59, 181, 186, 183, 185, -2, 1, 2.677945044588987, 2.23606797749979
309, 69, 419, 130, 421, 131, -2, -1, -2.677945044588987, 2.23606797749979
310, 5, 306, 138, 308, 137, -2, 1, 2.677945044588987, 2.23606797749979
310, 25, 75, 140, 77, 141, -2, -1, -2.677945044588987, 2.23606797749979
310, 37, 367, 120, 369, 120, -2, 0, 3.141592653589793, 2.0
310, 41, 174, 369, 177, 369, -3, 0, 3.141592653589793, 3.0
310, 42, 125, 329, 126, 331, -1, -2, -2.0344439357957027, 2.23606797749979
310, 65, 267, 135, 269, 135, -2, 0, 3.141592653589793, 2.0
310, 90, 245, 150, 248, 150, -3, 0, 3.141592653589793, 3.0
310, 92, 340, 128, 342, 128, -2, 0, 3.141592653589793, 2.0
310, 94, 577, 201, 579, 202, -2, -1, -2.677945044588987, 2.23606797749979
310, 114, 393, 127, 395, 127, -2, 0, 3.141592653589793, 2.0
310, 117, 133, 226, 134, 225, -1, 1, 2.356194490192345, 1.4142135623730951
310, 131, 184, 185, 185, 184, -1, 1, 2.356194490192345, 1.4142135623730951
310, 142, 130, 351, 133, 352, -3, -1, -2.819842099193151, 3.1622776601683795
310, 152, 419, 129, 422, 130, -3, -1, -2.819842099193151, 3.1622776601683795
311, 5, 304, 139, 306, 138, -2, 1, 2.677945044588987, 2.23606797749979
311, 27, 233, 147, 235, 147, -2, 0, 3.141592653589793, 2.0
311, 34, 171, 368, 174, 369, -3, -1, -2.819842099193151, 3.1622776601683795
311, 62, 241, 149, 245, 150, -4, -1, -2.896613990462929, 4.123105625617661
311, 80, 391, 127, 393, 127, -2, 0, 3.141592653589793, 2.0
311, 92, 182, 186, 184, 185, -2, 1, 2.677945044588987, 2.23606797749979
311, 97, 128, 350, 130, 351, -2, -1, -2.677945044588987, 2.23606797749979
311, 99, 569, 202, 571, 202, -2, 0, 3.141592653589793, 2.0
311, 106, 417, 128, 419, 129, -2, -1, -2.677945044588987, 2.23606797749979
312, 4, 302, 139, 304, 139, -2, 0, 3.141592653589793, 2.0
312, 29, 364, 120, 366, 120, -2, 0, 3.141592653589793, 2.0
312, 30, 168, 367, 171, 368, -3, -1, -2.819842099193151, 3.1622776601683795
312, 41, 265, 136, 266, 135, -1, 1, 2.356194490192345, 1.4142135623730951
312, 47, 140, 200, 142, 200, -2, 0, 3.141592653589793, 2.0
312, 48, 118, 218, 119, 217, -1, 1, 2.356194490192345, 1.4142135623730951
312, 55, 240, 150, 241, 149, -1, 1, 2.356194490192345, 1.4142135623730951
312, 74, 132, 227, 133, 226, -1, 1, 2.356194490192345, 1.4142135623730951
312, 80, 180, 187, 182, 186, -2, 1, 2.677945044588987, 2.23606797749979
312, 84, 126, 349, 128, 350, -2, -1, -2.677945044588987, 2.23606797749979
312, 89, 415, 127, 417, 128, -2, -1, -2.677945044588987, 2.23606797749979
313, 3, 300, 138, 302, 139, -2, -1, -2.677945044588987, 2.23606797749979
313, 18, 399, 109, 401, 110, -2, -1, -2.677945044588987, 2.23606797749979
313, 24, 153, 170, 155, 171, -2, -1, -2.677945044588987, 2.23606797749979
313, 26, 165, 366, 168, 367, -3, -1, -2.819842099193151, 3.1622776601683795
313, 37, 140, 364, 142, 365, -2, -1, -2.677945044588987, 2.23606797749979
313, 45, 238, 150, 240, 150, -2, 0, 3.141592653589793, 2.0
313, 57, 388, 127, 390, 127, -2, 0, 3.141592653589793, 2.0
313, 66, 178, 187, 180, 187, -2, 0, 3.141592653589793, 2.0
313, 73, 413, 126, 415, 127, -2, -1, -2.677945044588987, 2.23606797749979
314, 16, 229, 147, 231, 147, -2, 0, 3.141592653589793, 2.0
314, 19, 162, 365, 165, 366, -3, -1, -2.819842099193151, 3.1622776601683795
314, 32, 237, 151, 238, 150, -1, 1, 2.356194490192345, 1.4142135623730951
314, 33, 335, 128, 337, 128, -2, 0, 3.141592653589793, 2.0
314, 43, 386, 126, 388, 127, -2, -1, -2.677945044588987, 2.23606797749979
314, 50, 175, 188, 178, 187, -3, 1, 2.819842099193151, 3.1622776601683795
314, 56, 411, 125, 413, 126, -2, -1, -2.677945044588987, 2.23606797749979
314, 57, 64, 348, 66, 348, -2, 0, 3.141592653589793, 2.0
315, 5, 303, 139, 305, 139, -2, 0, 3.141592653589793, 2.0
315, 19, 233, 149, 235, 149, -2, 0, 3.141592653589793, 2.0
315, 28, 122, 331, 123, 333, -1, -2, -2.0344439357957027, 2.23606797749979
315, 48, 364, 119, 366, 120, -2, -1, -2.677945044588987, 2.23606797749979
315, 70, 576, 200, 577, 202, -1, -2, -2.0344439357957027, 2.23606797749979
315, 81, 171, 367, 173, 368, -2, -1, -2.677945044588987, 2.23606797749979
315, 105, 195, 173, 196, 172, -1, 1, 2.356194490192345, 1.4142135623730951
315, 109, 124, 351, 126, 352, -2, -1, -2.677945044588987, 2.23606797749979
315, 112, 266, 137, 267, 136, -1, 1, 2.356194490192345, 1.4142135623730951
315, 117, 390, 129, 392, 129, -2, 0, 3.141592653589793, 2.0
315, 122, 180, 189, 182, 188, -2, 1, 2.677945044588987, 2.23606797749979
315, 134, 218, 160, 220, 160, -2, 0, 3.141592653589793, 2.0
315, 154, 228, 165, 230, 165, -2, 0, 3.141592653589793, 2.0
316, 2, 301, 140, 303, 139, -2, 1, 2.677945044588987, 2.23606797749979
316, 14, 231, 149, 233, 149, -2, 0, 3.141592653589793, 2.0
316, 22, 121, 329, 122, 331, -1, -2, -2.0344439357957027, 2.23606797749979
316, 61, 168, 366, 171, 367, -3, -1, -2.819842099193151, 3.1622776601683795
316, 71, 336, 129, 338, 129, -2, 0, 3.141592653589793, 2.0
316, 84, 122, 350, 124, 351, -2, -1, -2.677945044588987, 2.23606797749979
316, 90, 388, 129, 390, 129, -2, 0, 3.141592653589793, 2.0
316, 93, 178, 189, 180, 189, -2, 0, 3.141592653589793, 2.0
316, 103, 216, 160, 218, 160, -2, 0, 3.141592653589793, 2.0
317, 1, 299, 141, 301, 140, -2, 1, 2.677945044588987, 2.23606797749979
317, 10, 229, 148, 231, 149, -2, -1, -2.677945044588987, 2.23606797749979
317, 16, 119, 327, 121, 329, -2, -2, -2.356194490192345, 2.8284271247461903
317, 22, 265, 126, 267, 126, -2, 0, 3.141592653589793, 2.0
317, 46, 166, 366, 168, 366, -2, 0, 3.141592653589793, 2.0
317, 55, 334, 129, 336, 129, -2, 0, 3.141592653589793, 2.0
317, 63, 192, 174, 194, 173, -2, 1, 2.677945044588987, 2.23606797749979
317, 72, 386, 129, 388, 129, -2, 0, 3.141592653589793, 2.0
317, 75, 176, 190, 178, 189, -2, 1, 2.677945044588987, 2.23606797749979
317, 84, 214, 160, 216, 160, -2, 0, 3.141592653589793, 2.0
317, 95, 225, 164, 227, 165, -2, -1, -2.677945044588987, 2.23606797749979
318, 1, 297, 141, 299, 141, -2, 0, 3.141592653589793, 2.0
318, 9, 227, 149, 229, 148, -2, 1, 2.677945044588987, 2.23606797749979
318, 36, 163, 366, 166, 366, -3, 0, 3.141592653589793, 3.0
318, 59, 174, 191, 176, 190, -2, 1, 2.677945044588987, 2.23606797749979
319, 1, 294, 141, 297, 141, -3, 0, 3.141592653589793, 3.0
319, 16, 262, 126, 264, 126, -2, 0, 3.141592653589793, 2.0
319, 47, 262, 138, 263, 137, -1, 1, 2.356194490192345, 1.4142135623730951
319, 51, 383, 129, 385, 129, -2, 0, 3.141592653589793, 2.0
319, 53, 172, 192, 174, 191, -2, 1, 2.677945044588987, 2.23606797749979
320, 15, 297, 142, 300, 142, -3, 0, 3.141592653589793, 3.0
320, 24, 119, 328, 120, 330, -1, -2, -2.0344439357957027, 2.23606797749979
320, 48, 113, 318, 115, 320, -2, -2, -2.356194490192345, 2.8284271247461903
320, 63, 163, 368, 166, 368, -3, 0, 3.141592653589793, 3.0
320, 79, 231, 151, 232, 150, -1, 1, 2.356194490192345, 1.4142135623730951
320, 91, 334, 131, 336, 131, -2, 0, 3.141592653589793, 2.0
320, 115, 305, 145, 307, 146, -2, -1, -2.677945044588987, 2.23606797749979
320, 117, 125, 324, 126, 326, -1, -2, -2.0344439357957027, 2.23606797749979
320, 136, 387, 131, 389, 131, -2, 0, 3.141592653589793, 2.0
321, 12, 295, 143, 297, 142, -2, 1, 2.677945044588987, 2.23606797749979
321, 18, 118, 326, 119, 328, -1, -2, -2.0344439357957027, 2.23606797749979
321, 46, 161, 368, 163, 368, -2, 0, 3.141592653589793, 2.0
321, 59, 229, 151, 231, 151, -2, 0, 3.141592653589793, 2.0
321, 79, 107, 244, 107, 246, 0, -2, -1.5707963267948966, 2.0
321, 83, 303, 145, 305, 145, -2, 0, 3.141592653589793, 2.0
321, 100, 385, 131, 387, 131, -2, 0, 3.141592653589793, 2.0
322, 12, 292, 143, 295, 143, -3, 0, 3.141592653589793, 3.0
322, 17, 116, 325, 118, 326, -2, -1, -2.677945044588987, 2.23606797749979
322, 37, 158, 367, 161, 368, -3, -1, -2.819842099193151, 3.1622776601683795
322, 45, 180, 152, 182, 153, -2, -1, -2.677945044588987, 2.23606797749979
322, 47, 228, 152, 229, 151, -1, 1, 2.356194490192345, 1.4142135623730951
322, 51, 411, 128, 413, 128, -2, 0, 3.141592653589793, 2.0
322, 54, 331, 131, 333, 131, -2, 0, 3.141592653589793, 2.0
322, 67, 300, 144, 303, 145, -3, -1, -2.819842099193151, 3.1622776601683795
322, 82, 261, 138, 263, 138, -2, 0, 3.141592653589793, 2.0
322, 93, 214, 161, 216, 161, -2, 0, 3.141592653589793, 2.0
323, 10, 290, 143, 292, 143, -2, 0, 3.141592653589793, 2.0
323, 15, 114, 324, 116, 325, -2, -1, -2.677945044588987, 2.23606797749979
323, 31, 156, 366, 158, 367, -2, -1, -2.677945044588987, 2.23606797749979
323, 40, 226, 152, 228, 152, -2, 0, 3.141592653589793, 2.0
323, 44, 409, 128, 411, 128, -2, 0, 3.141592653589793, 2.0
323, 46, 329, 131, 331, 131, -2, 0, 3.141592653589793, 2.0
323, 56, 297, 144, 300, 144, -3, 0, 3.141592653589793, 3.0
324, 8, 287, 143, 290, 143, -3, 0, 3.141592653589793, 3.0
324, 13, 113, 322, 114, 324, -1, -2, -2.0344439357957027, 2.23606797749979
324, 25, 154, 366, 156, 366, -2, 0, 3.141592653589793, 2.0
324, 33, 224, 153, 226, 152, -2, 1, 2.677945044588987, 2.23606797749979
324, 37, 407, 128, 409, 128, -2, 0, 3.141592653589793, 2.0
324, 39, 327, 131, 329, 131, -2, 0, 3.141592653589793, 2.0
324, 47, 294, 144, 297, 144, -3, 0, 3.141592653589793, 3.0
324, 68, 211, 161, 213, 161, -2, 0, 3.141592653589793, 2.0
325, 7, 292, 145, 295, 145, -3, 0, 3.141592653589793, 3.0
325, 18, 227, 153, 229, 152, -2, 1, 2.677945044588987, 2.23606797749979
325, 23, 197, 156, 199, 156, -2, 0, 3.141592653589793, 2.0
325, 24, 117, 325, 118, 327, -1, -2, -2.0344439357957027, 2.23606797749979
325, 26, 158, 366, 161, 367, -3, -1, -2.819842099193151, 3.1622776601683795
325, 31, 357, 122, 359, 123, -2, -1, -2.677945044588987, 2.23606797749979
325, 50, 260, 142, 262, 142, -2, 0, 3.141592653589793, 2.0
325, 52, 328, 132, 330, 132, -2, 0, 3.141592653589793, 2.0
325, 93, 233, 158, 235, 157, -2, 1, 2.677945044588987, 2.23606797749979
325, 101, 173, 195, 175, 194, -2, 1, 2.677945044588987, 2.23606797749979
325, 105, 213, 162, 215, 162, -2, 0, 3.141592653589793, 2.0
325, 109, 285, 118, 287, 119, -2, -1, -2.677945044588987, 2.23606797749979
325, 120, 383, 130, 385, 131, -2, -1, -2.677945044588987, 2.23606797749979
325, 124, 572, 194, 573, 196, -1, -2, -2.0344439357957027, 2.23606797749979
325, 128, 321, 132, 323, 131, -2, 1, 2.677945044588987, 2.23606797749979
326, 4, 287, 145, 292, 145, -5, 0, 3.141592653589793, 5.0
326, 12, 225, 153, 227, 153, -2, 0, 3.141592653589793, 2.0
326, 18, 154, 366, 158, 366, -4, 0, 3.141592653589793, 4.0
326, 29, 57, 308, 59, 307, -2, 1, 2.677945044588987, 2.23606797749979
326, 35, 258, 142, 260, 142, -2, 0, 3.141592653589793, 2.0
326, 63, 231, 158, 233, 158, -2, 0, 3.141592653589793, 2.0
326, 70, 171, 197, 173, 195, -2, 2, 2.356194490192345, 2.8284271247461903
326, 74, 211, 162, 213, 162, -2, 0, 3.141592653589793, 2.0
326, 88, 381, 129, 383, 130, -2, -1, -2.677945044588987, 2.23606797749979
326, 92, 571, 192, 572, 194, -1, -2, -2.0344439357957027, 2.23606797749979
326, 94, 438, 110, 440, 111, -2, -1, -2.677945044588987, 2.23606797749979
327, 3, 283, 144, 287, 145, -4, -1, -2.896613990462929, 4.123105625617661
327, 8, 223, 153, 225, 153, -2, 0, 3.141592653589793, 2.0
327, 14, 152, 366, 154, 366, -2, 0, 3.141592653589793, 2.0
327, 30, 325, 132, 327, 132, -2, 0, 3.141592653589793, 2.0
327, 47, 229, 159, 231, 158, -2, 1, 2.677945044588987, 2.23606797749979
327, 55, 209, 162, 211, 162, -2, 0, 3.141592653589793, 2.0
327, 58, 282, 117, 284, 118, -2, -1, -2.677945044588987, 2.23606797749979
327, 65, 379, 129, 381, 129, -2, 0, 3.141592653589793, 2.0
327, 70, 318, 131, 320, 132, -2, -1, -2.677945044588987, 2.23606797749979
328, 3, 277, 143, 283, 144, -6, -1, -2.976443976175166, 6.082762530298219
328, 7, 221, 153, 223, 153, -2, 0, 3.141592653589793, 2.0
328, 11, 193, 155, 195, 156, -2, -1, -2.677945044588987, 2.23606797749979
328, 12, 149, 365, 152, 366, -3, -1, -2.819842099193151, 3.1622776601683795
328, 25, 255, 142, 257, 142, -2, 0, 3.141592653589793, 2.0
328, 40, 226, 159, 229, 159, -3, 0, 3.141592653589793, 3.0
328, 45, 169, 198, 170, 197, -1, 1, 2.356194490192345, 1.4142135623730951
328, 48, 207, 162, 209, 162, -2, 0, 3.141592653589793, 2.0
328, 61, 316, 131, 318, 131, -2, 0, 3.141592653589793, 2.0
328, 66, 518, 150, 515, 152, 3, -2, -0.5880026035475675, 3.605551275463989
329, 8, 147, 364, 149, 365, -2, -1, -2.677945044588987, 2.23606797749979
329, 18, 253, 142, 255, 142, -2, 0, 3.141592653589793, 2.0
329, 32, 225, 160, 226, 159, -1, 1, 2.356194490192345, 1.4142135623730951
329, 37, 168, 199, 169, 198, -1, 1, 2.356194490192345, 1.4142135623730951
329, 45, 376, 128, 378, 129, -2, -1, -2.677945044588987, 2.23606797749979
329, 49, 314, 131, 316, 131, -2, 0, 3.141592653589793, 2.0
330, 9, 222, 155, 224, 155, -2, 0, 3.141592653589793, 2.0
330, 16, 195, 158, 196, 157, -1, 1, 2.356194490192345, 1.4142135623730951
330, 22, 282, 144, 286, 144, -4, 0, 3.141592653589793, 4.0
330, 48, 153, 367, 155, 368, -2, -1, -2.677945044588987, 2.23606797749979
330, 73, 72, 284, 74, 284, -2, 0, 3.141592653589793, 2.0
330, 74, 325, 133, 327, 133, -2, 0, 3.141592653589793, 2.0
330, 79, 230, 148, 232, 149, -2, -1, -2.677945044588987, 2.23606797749979
330, 97, 257, 143, 259, 143, -2, 0, 3.141592653589793, 2.0
330, 109, 378, 127, 380, 128, -2, -1, -2.677945044588987, 2.23606797749979
330, 120, 172, 199, 173, 198, -1, 1, 2.356194490192345, 1.4142135623730951
330, 124, 114, 310, 115, 312, -1, -2, -2.0344439357957027, 2.23606797749979
331, 6, 220, 156, 222, 155, -2, 1, 2.677945044588987, 2.23606797749979
331, 14, 260, 129, 262, 129, -2, 0, 3.141592653589793, 2.0
331, 18, 278, 143, 282, 144, -4, -1, -2.896613990462929, 4.123105625617661
331, 36, 151, 367, 153, 367, -2, 0, 3.141592653589793, 2.0
331, 57, 112, 186, 110, 186, 2, 0, 0.0, 2.0
331, 60, 228, 147, 230, 148, -2, -1, -2.677945044588987, 2.23606797749979
331, 74, 255, 143, 257, 143, -2, 0, 3.141592653589793, 2.0
331, 81, 376, 126, 378, 127, -2, -1, -2.677945044588987, 2.23606797749979
331, 94, 113, 308, 114, 310, -1, -2, -2.0344439357957027, 2.23606797749979
332, 16, 274, 142, 278, 143, -4, -1, -2.896613990462929, 4.123105625617661
332, 33, 149, 366, 151, 367, -2, -1, -2.677945044588987, 2.23606797749979
332, 52, 226, 146, 228, 147, -2, -1, -2.677945044588987, 2.23606797749979
332, 61, 281, 117, 283, 118, -2, -1, -2.677945044588987, 2.23606797749979
332, 69, 374, 125, 376, 126, -2, -1, -2.677945044588987, 2.23606797749979
332, 76, 170, 200, 171, 199, -1, 1, 2.356194490192345, 1.4142135623730951
333, 4, 216, 157, 219, 156, -3, 1, 2.819842099193151, 3.1622776601683795
333, 9, 302, 115, 304, 116, -2, -1, -2.677945044588987, 2.23606797749979
333, 11, 271, 142, 274, 142, -3, 0, 3.141592653589793, 3.0
333, 27, 147, 366, 149, 366, -2, 0, 3.141592653589793, 2.0
333, 43, 224, 145, 226, 146, -2, -1, -2.677945044588987, 2.23606797749979
333, 52, 252, 143, 254, 143, -2, 0, 3.141592653589793, 2.0
333, 70, 109, 219, 111, 219, -2, 0, 3.141592653589793, 2.0
333, 71, 151, 201, 152, 200, -1, 1, 2.356194490192345, 1.4142135623730951
334, 2, 213, 158, 216, 157, -3, 1, 2.819842099193151, 3.1622776601683795
334, 8, 269, 141, 271, 142, -2, -1, -2.677945044588987, 2.23606797749979
334, 20, 188, 136, 190, 137, -2, -1, -2.677945044588987, 2.23606797749979
334, 29, 136, 367, 138, 366, -2, 1, 2.677945044588987, 2.23606797749979
334, 37, 278, 116, 280, 117, -2, -1, -2.677945044588987, 2.23606797749979
334, 39, 250, 143, 252, 143, -2, 0, 3.141592653589793, 2.0
335, 8, 194, 129, 196, 128, -2, 1, 2.677945044588987, 2.23606797749979
335, 9, 400, 110, 402, 110, -2, 0, 3.141592653589793, 2.0
335, 14, 124, 185, 125, 184, -1, 1, 2.356194490192345, 1.4142135623730951
335, 18, 219, 159, 221, 158, -2, 1, 2.677945044588987, 2.23606797749979
335, 28, 302, 116, 304, 116, -2, 0, 3.141592653589793, 2.0
335, 31, 275, 143, 278, 144, -3, -1, -2.819842099193151, 3.1622776601683795
335, 35, 352, 121, 354, 121, -2, 0, 3.141592653589793, 2.0
335, 62, 148, 369, 150, 370, -2, -1, -2.677945044588987, 2.23606797749979
335, 75, 324, 132, 326, 132, -2, 0, 3.141592653589793, 2.0
335, 80, 373, 131, 375, 132, -2, -1, -2.677945044588987, 2.23606797749979
335, 81, 191, 142, 192, 141, -1, 1, 2.356194490192345, 1.4142135623730951
335, 86, 419, 119, 421, 119, -2, 0, 3.141592653589793, 2.0
335, 104, 112, 307, 113, 309, -1, -2, -2.0344439357957027, 2.23606797749979
335, 119, 226, 147, 229, 147, -3, 0, 3.141592653589793, 3.0
335, 124, 254, 144, 256, 144, -2, 0, 3.141592653589793, 2.0
335, 136, 104, 283, 105, 285, -1, -2, -2.0344439357957027, 2.23606797749979
335, 145, 404, 127, 406, 128, -2, -1, -2.677945044588987, 2.23606797749979
336, 8, 194, 160, 195, 159, -1, 1, 2.356194490192345, 1.4142135623730951
336, 15, 217, 159, 219, 159, -2, 0, 3.141592653589793, 2.0
336, 27, 273, 142, 275, 143, -2, -1, -2.677945044588987, 2.23606797749979
336, 44, 114, 321, 115, 323, -1, -2, -2.0344439357957027, 2.23606797749979
336, 51, 146, 369, 148, 369, -2, 0, 3.141592653589793, 2.0
336, 63, 322, 131, 324, 132, -2, -1, -2.677945044588987, 2.23606797749979
336, 68, 371, 130, 373, 131, -2, -1, -2.677945044588987, 2.23606797749979
336, 92, 268, 120, 270, 120, -2, 0, 3.141592653589793, 2.0
336, 96, 224, 146, 226, 147, -2, -1, -2.677945044588987, 2.23606797749979
336, 117, 401, 126, 404, 127, -3, -1, -2.819842099193151, 3.1622776601683795
337, 10, 215, 159, 217, 159, -2, 0, 3.141592653589793, 2.0
337, 20, 271, 142, 273, 142, -2, 0, 3.141592653589793, 2.0
337, 44, 320, 130, 322, 131, -2, -1, -2.677945044588987, 2.23606797749979
337, 47, 369, 130, 371, 130, -2, 0, 3.141592653589793, 2.0
337, 88, 399, 125, 401, 126, -2, -1, -2.677945044588987, 2.23606797749979
338, 9, 213, 160, 215, 159, -2, 1, 2.677945044588987, 2.23606797749979
338, 36, 164, 200, 166, 200, -2, 0, 3.141592653589793, 2.0
338, 59, 249, 144, 252, 144, -3, 0, 3.141592653589793, 3.0
338, 69, 397, 125, 399, 125, -2, 0, 3.141592653589793, 2.0
339, 27, 142, 368, 144, 369, -2, -1, -2.677945044588987, 2.23606797749979
339, 30, 317, 130, 319, 130, -2, 0, 3.141592653589793, 2.0
339, 49, 247, 143, 249, 144, -2, -1, -2.677945044588987, 2.23606797749979
339, 58, 395, 123, 397, 125, -2, -2, -2.356194490192345, 2.8284271247461903
340, 10, 272, 141, 274, 143, -2, -2, -2.356194490192345, 2.8284271247461903
340, 53, 215, 163, 217, 162, -2, 1, 2.677945044588987, 2.23606797749979
340, 56, 223, 145, 225, 146, -2, -1, -2.677945044588987, 2.23606797749979
340, 64, 121, 315, 122, 317, -1, -2, -2.0344439357957027, 2.23606797749979
340, 80, 398, 127, 400, 128, -2, -1, -2.677945044588987, 2.23606797749979
340, 86, 249, 145, 252, 145, -3, 0, 3.141592653589793, 3.0
340, 113, 319, 130, 321, 130, -2, 0, 3.141592653589793, 2.0
340, 142, 367, 130, 371, 131, -4, -1, -2.896613990462929, 4.123105625617661
341, 8, 270, 140, 272, 141, -2, -1, -2.677945044588987, 2.23606797749979
341, 40, 213, 162, 215, 163, -2, -1, -2.677945044588987, 2.23606797749979
341, 60, 396, 126, 398, 127, -2, -1, -2.677945044588987, 2.23606797749979
341, 64, 247, 144, 249, 145, -2, -1, -2.677945044588987, 2.23606797749979
341, 82, 317, 129, 319, 130, -2, -1, -2.677945044588987, 2.23606797749979
341, 118, 103, 280, 104, 282, -1, -2, -2.0344439357957027, 2.23606797749979
342, 29, 211, 163, 213, 162, -2, 1, 2.677945044588987, 2.23606797749979
342, 43, 394, 125, 396, 126, -2, -1, -2.677945044588987, 2.23606797749979
342, 46, 245, 143, 247, 144, -2, -1, -2.677945044588987, 2.23606797749979
342, 59, 168, 204, 169, 203, -1, 1, 2.356194490192345, 1.4142135623730951
343, 23, 209, 163, 211, 163, -2, 0, 3.141592653589793, 2.0
343, 35, 243, 143, 245, 143, -2, 0, 3.141592653589793, 2.0
343, 59, 363, 130, 365, 130, -2, 0, 3.141592653589793, 2.0
344, 12, 569, 152, 571, 153, -2, -1, -2.677945044588987, 2.23606797749979
344, 29, 241, 143, 243, 143, -2, 0, 3.141592653589793, 2.0
344, 36, 166, 205, 167, 204, -1, 1, 2.356194490192345, 1.4142135623730951
344, 49, 361, 130, 363, 130, -2, 0, 3.141592653589793, 2.0
345, 58, 316, 132, 318, 132, -2, 0, 3.141592653589793, 2.0
345, 97, 246, 145, 248, 145, -2, 0, 3.141592653589793, 2.0
346, 16, 193, 164, 194, 163, -1, 1, 2.356194490192345, 1.4142135623730951
346, 28, 211, 163, 213, 163, -2, 0, 3.141592653589793, 2.0
346, 42, 314, 132, 316, 132, -2, 0, 3.141592653589793, 2.0
346, 71, 244, 145, 246, 145, -2, 0, 3.141592653589793, 2.0
346, 90, 167, 206, 168, 205, -1, 1, 2.356194490192345, 1.4142135623730951
346, 92, 177, 193, 179, 192, -2, 1, 2.677945044588987, 2.23606797749979
347, 35, 312, 132, 314, 132, -2, 0, 3.141592653589793, 2.0
347, 59, 242, 145, 244, 145, -2, 0, 3.141592653589793, 2.0
348, 9, 410, 106, 412, 106, -2, 0, 3.141592653589793, 2.0
348, 21, 208, 164, 210, 163, -2, 1, 2.677945044588987, 2.23606797749979
348, 32, 310, 132, 312, 132, -2, 0, 3.141592653589793, 2.0
348, 53, 240, 145, 242, 145, -2, 0, 3.141592653589793, 2.0
348, 64, 165, 207, 166, 206, -1, 1, 2.356194490192345, 1.4142135623730951
348, 66, 174, 194, 176, 193, -2, 1, 2.677945044588987, 2.23606797749979
349, 39, 238, 145, 240, 145, -2, 0, 3.141592653589793, 2.0
349, 49, 164, 208, 165, 207, -1, 1, 2.356194490192345, 1.4142135623730951
350, 8, 297, 118, 299, 118, -2, 0, 3.141592653589793, 2.0
350, 13, 209, 164, 211, 164, -2, 0, 3.141592653589793, 2.0
350, 17, 123, 184, 125, 185, -2, -1, -2.677945044588987, 2.23606797749979
350, 19, 265, 139, 267, 140, -2, -1, -2.677945044588987, 2.23606797749979
350, 65, 242, 145, 244, 146, -2, -1, -2.677945044588987, 2.23606797749979
350, 80, 313, 132, 315, 132, -2, 0, 3.141592653589793, 2.0
350, 140, 196, 177, 198, 176, -2, 1, 2.677945044588987, 2.23606797749979
350, 145, 162, 208, 164, 208, -2, 0, 3.141592653589793, 2.0
351, 41, 147, 207, 148, 206, -1, 1, 2.356194490192345, 1.4142135623730951
351, 104, 195, 178, 196, 177, -1, 1, 2.356194490192345, 1.4142135623730951
351, 108, 161, 209, 162, 208, -1, 1, 2.356194490192345, 1.4142135623730951
352, 5, 206, 164, 208, 164, -2, 0, 3.141592653589793, 2.0
352, 10, 262, 138, 264, 139, -2, -1, -2.677945044588987, 2.23606797749979
352, 38, 583, 162, 583, 164, 0, -2, -1.5707963267948966, 2.0
352, 49, 310, 132, 312, 132, -2, 0, 3.141592653589793, 2.0
352, 70, 179, 158, 181, 158, -2, 0, 3.141592653589793, 2.0
352, 85, 168, 163, 171, 163, -3, 0, 3.141592653589793, 3.0
353, 5, 204, 164, 206, 164, -2, 0, 3.141592653589793, 2.0
353, 9, 260, 138, 262, 138, -2, 0, 3.141592653589793, 2.0
353, 14, 219, 147, 220, 146, -1, 1, 2.356194490192345, 1.4142135623730951
353, 70, 192, 178, 194, 178, -2, 0, 3.141592653589793, 2.0
353, 73, 159, 210, 160, 209, -1, 1, 2.356194490192345, 1.4142135623730951
354, 5, 202, 164, 204, 164, -2, 0, 3.141592653589793, 2.0
354, 12, 217, 147, 219, 147, -2, 0, 3.141592653589793, 2.0
354, 21, 189, 165, 191, 165, -2, 0, 3.141592653589793, 2.0
355, 12, 172, 145, 174, 146, -2, -1, -2.677945044588987, 2.23606797749979
355, 18, 206, 165, 208, 165, -2, 0, 3.141592653589793, 2.0
355, 57, 162, 212, 163, 211, -1, 1, 2.356194490192345, 1.4142135623730951
355, 110, 356, 133, 358, 134, -2, -1, -2.677945044588987, 2.23606797749979
355, 125, 92, 284, 94, 285, -2, -1, -2.677945044588987, 2.23606797749979
355, 137, 118, 319, 121, 320, -3, -1, -2.819842099193151, 3.1622776601683795
355, 147, 191, 178, 193, 178, -2, 0, 3.141592653589793, 2.0
355, 159, 199, 177, 201, 177, -2, 0, 3.141592653589793, 2.0
356, 6, 404, 111, 406, 111, -2, 0, 3.141592653589793, 2.0
356, 13, 204, 165, 206, 165, -2, 0, 3.141592653589793, 2.0
356, 42, 161, 213, 162, 212, -1, 1, 2.356194490192345, 1.4142135623730951
356, 85, 354, 133, 356, 133, -2, 0, 3.141592653589793, 2.0
356, 112, 190, 179, 191, 178, -1, 1, 2.356194490192345, 1.4142135623730951
356, 123, 197, 177, 199, 177, -2, 0, 3.141592653589793, 2.0
357, 4, 293, 118, 295, 118, -2, 0, 3.141592653589793, 2.0
357, 8, 343, 116, 345, 117, -2, -1, -2.677945044588987, 2.23606797749979
357, 25, 180, 148, 182, 148, -2, 0, 3.141592653589793, 2.0
357, 32, 160, 214, 161, 213, -1, 1, 2.356194490192345, 1.4142135623730951
357, 37, 239, 146, 241, 146, -2, 0, 3.141592653589793, 2.0
357, 48, 130, 172, 131, 171, -1, 1, 2.356194490192345, 1.4142135623730951
357, 64, 352, 133, 354, 133, -2, 0, 3.141592653589793, 2.0
357, 96, 195, 177, 197, 177, -2, 0, 3.141592653589793, 2.0
358, 7, 341, 116, 343, 116, -2, 0, 3.141592653589793, 2.0
358, 10, 201, 165, 203, 165, -2, 0, 3.141592653589793, 2.0
358, 28, 159, 215, 160, 214, -1, 1, 2.356194490192345, 1.4142135623730951
358, 56, 350, 132, 352, 133, -2, -1, -2.677945044588987, 2.23606797749979
358, 75, 187, 180, 189, 179, -2, 1, 2.677945044588987, 2.23606797749979
359, 3, 290, 118, 292, 118, -2, 0, 3.141592653589793, 2.0
359, 6, 199, 165, 201, 165, -2, 0, 3.141592653589793, 2.0
359, 42, 348, 131, 350, 132, -2, -1, -2.677945044588987, 2.23606797749979
359, 58, 186, 181, 187, 180, -1, 1, 2.356194490192345, 1.4142135623730951
360, 49, 575, 177, 575, 179, 0, -2, -1.5707963267948966, 2.0
360, 60, 101, 336, 103, 337, -2, -1, -2.677945044588987, 2.23606797749979
360, 78, 160, 215, 161, 214, -1, 1, 2.356194490192345, 1.4142135623730951
360, 84, 120, 184, 121, 183, -1, 1, 2.356194490192345, 1.4142135623730951
360, 86, 107, 146, 109, 146, -2, 0, 3.141592653589793, 2.0
360, 88, 98, 276, 101, 277, -3, -1, -2.819842099193151, 3.1622776601683795
360, 105, 566, 185, 568, 187, -2, -2, -2.356194490192345, 2.8284271247461903
360, 116, 129, 173, 131, 174, -2, -1, -2.677945044588987, 2.23606797749979
360, 121, 352, 134, 354, 134, -2, 0, 3.141592653589793, 2.0
361, 22, 201, 172, 203, 172, -2, 0, 3.141592653589793, 2.0
361, 30, 219, 150, 221, 150, -2, 0, 3.141592653589793, 2.0
361, 47, 159, 216, 160, 215, -1, 1, 2.356194490192345, 1.4142135623730951
361, 68, 189, 136, 188, 137, 1, -1, -0.7853981633974483, 1.4142135623730951
361, 70, 44, 310, 46, 311, -2, -1, -2.677945044588987, 2.23606797749979
361, 78, 349, 133, 352, 134, -3, -1, -2.819842099193151, 3.1622776601683795
362, 10, 340, 117, 342, 117, -2, 0, 3.141592653589793, 2.0
362, 17, 199, 172, 201, 172, -2, 0, 3.141592653589793, 2.0
362, 36, 157, 217, 159, 216, -2, 1, 2.677945044588987, 2.23606797749979
362, 47, 305, 135, 307, 135, -2, 0, 3.141592653589793, 2.0
362, 61, 347, 133, 349, 133, -2, 0, 3.141592653589793, 2.0
363, 50, 344, 132, 347, 133, -3, -1, -2.819842099193151, 3.1622776601683795
364, 0, 186, 167, 188, 167, -2, 0, 3.141592653589793, 2.0
364, 3, 192, 130, 194, 130, -2, 0, 3.141592653589793, 2.0
364, 8, 337, 117, 339, 117, -2, 0, 3.141592653589793, 2.0
364, 19, 216, 151, 218, 151, -2, 0, 3.141592653589793, 2.0
364, 21, 245, 135, 247, 135, -2, 0, 3.141592653589793, 2.0
364, 32, 300, 135, 304, 135, -4, 0, 3.141592653589793, 4.0
364, 40, 340, 132, 344, 132, -4, 0, 3.141592653589793, 4.0
365, 103, 304, 135, 306, 135, -2, 0, 3.141592653589793, 2.0
365, 113, 160, 218, 161, 217, -1, 1, 2.356194490192345, 1.4142135623730951
365, 117, 187, 187, 188, 186, -1, 1, 2.356194490192345, 1.4142135623730951
365, 134, 345, 133, 348, 133, -3, 0, 3.141592653589793, 3.0
365, 142, 537, 156, 539, 156, -2, 0, 3.141592653589793, 2.0
365, 147, 129, 154, 131, 154, -2, 0, 3.141592653589793, 2.0
365, 149, 389, 121, 391, 122, -2, -1, -2.677945044588987, 2.23606797749979
366, 8, 339, 117, 341, 118, -2, -1, -2.677945044588987, 2.23606797749979
366, 10, 197, 168, 199, 168, -2, 0, 3.141592653589793, 2.0
366, 13, 185, 168, 187, 168, -2, 0, 3.141592653589793, 2.0
366, 83, 159, 219, 160, 218, -1, 1, 2.356194490192345, 1.4142135623730951
366, 95, 343, 132, 345, 133, -2, -1, -2.677945044588987, 2.23606797749979
367, 6, 194, 168, 197, 168, -3, 0, 3.141592653589793, 3.0
367, 47, 156, 199, 157, 198, -1, 1, 2.356194490192345, 1.4142135623730951
367, 57, 301, 135, 303, 135, -2, 0, 3.141592653589793, 2.0
367, 66, 158, 220, 159, 219, -1, 1, 2.356194490192345, 1.4142135623730951
367, 68, 184, 188, 186, 187, -2, 1, 2.677945044588987, 2.23606797749979
367, 76, 341, 131, 343, 132, -2, -1, -2.677945044588987, 2.23606797749979
368, 4, 336, 116, 338, 117, -2, -1, -2.677945044588987, 2.23606797749979
368, 27, 130, 173, 129, 174, 1, -1, -0.7853981633974483, 1.4142135623730951
368, 54, 156, 221, 158, 220, -2, 1, 2.677945044588987, 2.23606797749979
368, 63, 338, 130, 341, 131, -3, -1, -2.819842099193151, 3.1622776601683795
369, 37, 298, 134, 300, 135, -2, -1, -2.677945044588987, 2.23606797749979
369, 46, 155, 222, 156, 221, -1, 1, 2.356194490192345, 1.4142135623730951
369, 55, 336, 129, 338, 130, -2, -1, -2.677945044588987, 2.23606797749979
370, 20, 336, 117, 338, 118, -2, -1, -2.677945044588987, 2.23606797749979
370, 27, 77, 263, 77, 265, 0, -2, -1.5707963267948966, 2.0
370, 65, 339, 133, 342, 134, -3, -1, -2.819842099193151, 3.1622776601683795
370, 83, 158, 221, 159, 220, -1, 1, 2.356194490192345, 1.4142135623730951
370, 103, 302, 135, 304, 135, -2, 0, 3.141592653589793, 2.0
370, 144, 385, 124, 387, 125, -2, -1, -2.677945044588987, 2.23606797749979
370, 146, 557, 181, 558, 183, -1, -2, -2.0344439357957027, 2.23606797749979
370, 149, 394, 117, 396, 118, -2, -1, -2.677945044588987, 2.23606797749979
370, 160, 265, 144, 267, 145, -2, -1, -2.677945044588987, 2.23606797749979
371, 46, 336, 132, 339, 133, -3, -1, -2.819842099193151, 3.1622776601683795
371, 59, 157, 222, 158, 221, -1, 1, 2.356194490192345, 1.4142135623730951
371, 95, 215, 158, 217, 157, -2, 1, 2.677945044588987, 2.23606797749979
371, 107, 383, 123, 385, 124, -2, -1, -2.677945044588987, 2.23606797749979
371, 109, 555, 180, 557, 181, -2, -1, -2.677945044588987, 2.23606797749979
371, 110, 535, 155, 537, 156, -2, -1, -2.677945044588987, 2.23606797749979
372, 5, 185, 171, 186, 170, -1, 1, 2.356194490192345, 1.4142135623730951
372, 34, 334, 131, 336, 132, -2, -1, -2.677945044588987, 2.23606797749979
372, 45, 155, 201, 157, 201, -2, 0, 3.141592653589793, 2.0
372, 46, 156, 223, 157, 222, -1, 1, 2.356194490192345, 1.4142135623730951
372, 61, 299, 135, 301, 135, -2, 0, 3.141592653589793, 2.0
372, 76, 214, 159, 215, 158, -1, 1, 2.356194490192345, 1.4142135623730951
372, 81, 119, 220, 121, 220, -2, 0, 3.141592653589793, 2.0
372, 87, 381, 122, 383, 123, -2, -1, -2.677945044588987, 2.23606797749979
373, 21, 332, 130, 334, 131, -2, -1, -2.677945044588987, 2.23606797749979
373, 30, 155, 224, 156, 223, -1, 1, 2.356194490192345, 1.4142135623730951
373, 48, 212, 160, 214, 159, -2, 1, 2.677945044588987, 2.23606797749979
373, 59, 379, 121, 381, 122, -2, -1, -2.677945044588987, 2.23606797749979
374, 20, 330, 130, 332, 130, -2, 0, 3.141592653589793, 2.0
374, 26, 153, 225, 155, 224, -2, 1, 2.677945044588987, 2.23606797749979
374, 32, 296, 135, 298, 135, -2, 0, 3.141592653589793, 2.0
374, 38, 113, 298, 112, 299, 1, -1, -0.7853981633974483, 1.4142135623730951
374, 50, 377, 120, 379, 121, -2, -1, -2.677945044588987, 2.23606797749979
375, 17, 333, 116, 335, 117, -2, -1, -2.677945044588987, 2.23606797749979
375, 18, 164, 145, 166, 146, -2, -1, -2.677945044588987, 2.23606797749979
375, 68, 333, 130, 337, 132, -4, -2, -2.677945044588987, 4.47213595499958
375, 87, 155, 226, 157, 225, -2, 1, 2.677945044588987, 2.23606797749979
375, 156, 269, 147, 271, 148, -2, -1, -2.677945044588987, 2.23606797749979
376, 64, 153, 227, 155, 226, -2, 1, 2.677945044588987, 2.23606797749979
376, 75, 230, 147, 232, 147, -2, 0, 3.141592653589793, 2.0
377, 3, 192, 174, 193, 173, -1, 1, 2.356194490192345, 1.4142135623730951
377, 5, 107, 264, 108, 266, -1, -2, -2.0344439357957027, 2.23606797749979
377, 36, 330, 128, 332, 130, -2, -2, -2.356194490192345, 2.8284271247461903
377, 38, 244, 140, 245, 139, -1, 1, 2.356194490192345, 1.4142135623730951
377, 48, 152, 228, 153, 227, -1, 1, 2.356194490192345, 1.4142135623730951
377, 86, 297, 136, 299, 136, -2, 0, 3.141592653589793, 2.0
377, 87, 266, 147, 268, 147, -2, 0, 3.141592653589793, 2.0
378, 30, 328, 128, 330, 128, -2, 0, 3.141592653589793, 2.0
378, 40, 150, 228, 152, 228, -2, 0, 3.141592653589793, 2.0
378, 68, 295, 136, 297, 136, -2, 0, 3.141592653589793, 2.0
379, 34, 148, 229, 150, 228, -2, 1, 2.677945044588987, 2.23606797749979
379, 47, 151, 201, 152, 200, -1, 1, 2.356194490192345, 1.4142135623730951
379, 57, 293, 136, 295, 136, -2, 0, 3.141592653589793, 2.0
380, 27, 599, 267, 601, 268, -2, -1, -2.677945044588987, 2.23606797749979
380, 117, 152, 228, 154, 228, -2, 0, 3.141592653589793, 2.0
380, 118, 218, 160, 220, 160, -2, 0, 3.141592653589793, 2.0
380, 123, 295, 137, 297, 137, -2, 0, 3.141592653589793, 2.0
380, 145, 403, 117, 405, 118, -2, -1, -2.677945044588987, 2.23606797749979
381, 20, 63, 137, 62, 136, 1, 1, 0.7853981633974483, 1.4142135623730951
381, 70, 183, 192, 184, 191, -1, 1, 2.356194490192345, 1.4142135623730951
381, 85, 150, 229, 152, 228, -2, 1, 2.677945044588987, 2.23606797749979
381, 86, 216, 160, 218, 160, -2, 0, 3.141592653589793, 2.0
381, 89, 293, 137, 295, 137, -2, 0, 3.141592653589793, 2.0
382, 27, 159, 152, 161, 152, -2, 0, 3.141592653589793, 2.0
382, 37, 243, 140, 244, 139, -1, 1, 2.356194490192345, 1.4142135623730951
382, 66, 148, 230, 150, 229, -2, 1, 2.677945044588987, 2.23606797749979
382, 67, 214, 159, 216, 160, -2, -1, -2.677945044588987, 2.23606797749979
383, 16, 61, 136, 63, 137, -2, -1, -2.677945044588987, 2.23606797749979
383, 34, 241, 140, 243, 140, -2, 0, 3.141592653589793, 2.0
383, 57, 146, 231, 148, 230, -2, 1, 2.677945044588987, 2.23606797749979
383, 58, 212, 159, 214, 159, -2, 0, 3.141592653589793, 2.0
384, 3, 252, 142, 254, 142, -2, 0, 3.141592653589793, 2.0
384, 50, 145, 232, 146, 231, -1, 1, 2.356194490192345, 1.4142135623730951
384, 51, 210, 160, 212, 159, -2, 1, 2.677945044588987, 2.23606797749979
384, 63, 388, 118, 389, 117, -1, 1, 2.356194490192345, 1.4142135623730951
385, 75, 171, 150, 173, 151, -2, -1, -2.677945044588987, 2.23606797749979
385, 76, 228, 150, 229, 149, -1, 1, 2.356194490192345, 1.4142135623730951
385, 78, 148, 232, 150, 231, -2, 1, 2.677945044588987, 2.23606797749979
385, 87, 154, 207, 155, 206, -1, 1, 2.356194490192345, 1.4142135623730951
385, 112, 399, 117, 401, 118, -2, -1, -2.677945044588987, 2.23606797749979
385, 121, 375, 121, 377, 122, -2, -1, -2.677945044588987, 2.23606797749979
385, 124, 389, 119, 391, 119, -2, 0, 3.141592653589793, 2.0
385, 125, 116, 293, 116, 295, 0, -2, -1.5707963267948966, 2.0
385, 134, 203, 164, 205, 164, -2, 0, 3.141592653589793, 2.0
385, 145, 252, 166, 253, 165, -1, 1, 2.356194490192345, 1.4142135623730951
385, 148, 163, 204, 165, 204, -2, 0, 3.141592653589793, 2.0
385, 151, 121, 302, 122, 304, -1, -2, -2.0344439357957027, 2.23606797749979
385, 152, 474, 125, 476, 125, -2, 0, 3.141592653589793, 2.0
386, 57, 226, 150, 228, 150, -2, 0, 3.141592653589793, 2.0
386, 58, 146, 233, 148, 232, -2, 1, 2.677945044588987, 2.23606797749979
386, 75, 240, 142, 242, 142, -2, 0, 3.141592653589793, 2.0
386, 86, 373, 120, 375, 121, -2, -1, -2.677945044588987, 2.23606797749979
386, 108, 120, 300, 121, 302, -1, -2, -2.0344439357957027, 2.23606797749979
387, 6, 60, 105, 64, 105, -4, 0, 3.141592653589793, 4.0
387, 14, 251, 142, 253, 142, -2, 0, 3.141592653589793, 2.0
387, 47, 145, 234, 146, 233, -1, 1, 2.356194490192345, 1.4142135623730951
387, 83, 160, 204, 162, 204, -2, 0, 3.141592653589793, 2.0
388, 40, 143, 235, 145, 234, -2, 1, 2.677945044588987, 2.23606797749979
388, 45, 151, 208, 152, 207, -1, 1, 2.356194490192345, 1.4142135623730951
388, 52, 95, 237, 94, 238, 1, -1, -0.7853981633974483, 1.4142135623730951
389, 31, 141, 236, 143, 235, -2, 1, 2.677945044588987, 2.23606797749979
390, 65, 238, 145, 240, 145, -2, 0, 3.141592653589793, 2.0
390, 67, 599, 215, 601, 217, -2, -2, -2.356194490192345, 2.8284271247461903
390, 77, 151, 208, 153, 207, -2, 1, 2.677945044588987, 2.23606797749979
390, 88, 71, 284, 73, 285, -2, -1, -2.677945044588987, 2.23606797749979
390, 111, 144, 235, 146, 235, -2, 0, 3.141592653589793, 2.0
390, 113, 386, 119, 388, 119, -2, 0, 3.141592653589793, 2.0
390, 123, 591, 227, 593, 229, -2, -2, -2.356194490192345, 2.8284271247461903
390, 128, 203, 163, 205, 163, -2, 0, 3.141592653589793, 2.0
390, 135, 372, 120, 374, 121, -2, -1, -2.677945044588987, 2.23606797749979
390, 140, 549, 172, 550, 174, -1, -2, -2.0344439357957027, 2.23606797749979
390, 141, 398, 118, 400, 118, -2, 0, 3.141592653589793, 2.0
391, 4, 157, 146, 159, 145, -2, 1, 2.677945044588987, 2.23606797749979
391, 47, 324, 129, 326, 129, -2, 0, 3.141592653589793, 2.0
391, 48, 236, 145, 238, 145, -2, 0, 3.141592653589793, 2.0
391, 64, 84, 343, 86, 342, -2, 1, 2.677945044588987, 2.23606797749979
391, 82, 142, 236, 144, 235, -2, 1, 2.677945044588987, 2.23606797749979
391, 84, 384, 118, 386, 119, -2, -1, -2.677945044588987, 2.23606797749979
391, 89, 180, 195, 181, 194, -1, 1, 2.356194490192345, 1.4142135623730951
391, 100, 133, 185, 134, 184, -1, 1, 2.356194490192345, 1.4142135623730951
391, 103, 548, 170, 549, 172, -1, -2, -2.0344439357957027, 2.23606797749979
391, 104, 396, 117, 398, 118, -2, -1, -2.677945044588987, 2.23606797749979
392, 7, 250, 143, 252, 143, -2, 0, 3.141592653589793, 2.0
392, 40, 234, 145, 236, 145, -2, 0, 3.141592653589793, 2.0
392, 54, 223, 152, 225, 152, -2, 0, 3.141592653589793, 2.0
392, 72, 140, 237, 142, 236, -2, 1, 2.677945044588987, 2.23606797749979
392, 83, 200, 163, 202, 163, -2, 0, 3.141592653589793, 2.0
393, 31, 232, 145, 234, 145, -2, 0, 3.141592653589793, 2.0
393, 50, 137, 239, 140, 237, -3, 2, 2.5535900500422257, 3.605551275463989
393, 60, 198, 163, 200, 163, -2, 0, 3.141592653589793, 2.0
394, 26, 320, 129, 322, 129, -2, 0, 3.141592653589793, 2.0
394, 27, 230, 145, 232, 145, -2, 0, 3.141592653589793, 2.0
394, 41, 135, 239, 137, 239, -2, 0, 3.141592653589793, 2.0
395, 2, 250, 144, 252, 144, -2, 0, 3.141592653589793, 2.0
395, 40, 133, 136, 135, 137, -2, -1, -2.677945044588987, 2.23606797749979
395, 103, 140, 240, 142, 239, -2, 1, 2.677945044588987, 2.23606797749979
395, 110, 235, 146, 237, 146, -2, 0, 3.141592653589793, 2.0
395, 114, 223, 154, 225, 154, -2, 0, 3.141592653589793, 2.0
395, 142, 55, 145, 56, 147, -1, -2, -2.0344439357957027, 2.23606797749979
395, 162, 587, 226, 589, 228, -2, -2, -2.356194490192345, 2.8284271247461903
396, 22, 135, 206, 136, 205, -1, 1, 2.356194490192345, 1.4142135623730951
396, 30, 584, 146, 583, 147, 1, -1, -0.7853981633974483, 1.4142135623730951
396, 34, 603, 257, 604, 259, -1, -2, -2.0344439357957027, 2.23606797749979
396, 57, 59, 104, 58, 105, 1, -1, -0.7853981633974483, 1.4142135623730951
396, 72, 319, 121, 321, 122, -2, -1, -2.677945044588987, 2.23606797749979
396, 81, 137, 241, 140, 240, -3, 1, 2.819842099193151, 3.1622776601683795
396, 82, 320, 130, 322, 130, -2, 0, 3.141592653589793, 2.0
396, 87, 233, 146, 235, 146, -2, 0, 3.141592653589793, 2.0
396, 90, 221, 154, 223, 154, -2, 0, 3.141592653589793, 2.0
396, 102, 127, 236, 129, 236, -2, 0, 3.141592653589793, 2.0
396, 121, 586, 224, 587, 226, -1, -2, -2.0344439357957027, 2.23606797749979
396, 122, 382, 120, 384, 120, -2, 0, 3.141592653589793, 2.0
397, 2, 247, 144, 249, 144, -2, 0, 3.141592653589793, 2.0
397, 10, 405, 111, 406, 110, -1, 1, 2.356194490192345, 1.4142135623730951
397, 64, 136, 242, 137, 241, -1, 1, 2.356194490192345, 1.4142135623730951
397, 65, 318, 130, 320, 130, -2, 0, 3.141592653589793, 2.0
397, 69, 231, 146, 233, 146, -2, 0, 3.141592653589793, 2.0
397, 72, 219, 155, 221, 154, -2, 1, 2.677945044588987, 2.23606797749979
397, 93, 585, 222, 586, 224, -1, -2, -2.0344439357957027, 2.23606797749979
398, 1, 245, 144, 247, 144, -2, 0, 3.141592653589793, 2.0
398, 54, 316, 130, 318, 130, -2, 0, 3.141592653589793, 2.0
398, 57, 229, 146, 231, 146, -2, 0, 3.141592653589793, 2.0
398, 59, 217, 155, 219, 155, -2, 0, 3.141592653589793, 2.0
398, 78, 324, 125, 326, 125, -2, 0, 3.141592653589793, 2.0
398, 79, 584, 220, 585, 222, -1, -2, -2.0344439357957027, 2.23606797749979
398, 80, 379, 120, 381, 120, -2, 0, 3.141592653589793, 2.0
399, 1, 243, 144, 245, 144, -2, 0, 3.141592653589793, 2.0
399, 45, 133, 243, 135, 242, -2, 1, 2.677945044588987, 2.23606797749979
399, 46, 314, 130, 316, 130, -2, 0, 3.141592653589793, 2.0
399, 49, 227, 146, 229, 146, -2, 0, 3.141592653589793, 2.0
399, 51, 216, 156, 217, 155, -1, 1, 2.356194490192345, 1.4142135623730951
399, 68, 583, 218, 584, 220, -1, -2, -2.0344439357957027, 2.23606797749979
400, 32, 579, 165, 580, 167, -1, -2, -2.0344439357957027, 2.23606797749979
400, 81, 318, 128, 320, 128, -2, 0, 3.141592653589793, 2.0
400, 82, 221, 155, 223, 155, -2, 0, 3.141592653589793, 2.0
400, 86, 137, 242, 139, 241, -2, 1, 2.677945044588987, 2.23606797749979
400, 104, 468, 123, 470, 124, -2, -1, -2.677945044588987, 2.23606797749979
400, 130, 586, 219, 587, 221, -1, -2, -2.0344439357957027, 2.23606797749979
400, 133, 365, 123, 367, 123, -2, 0, 3.141592653589793, 2.0
400, 134, 229, 147, 232, 147, -3, 0, 3.141592653589793, 3.0
401, 14, 246, 145, 249, 146, -3, -1, -2.819842099193151, 3.1622776601683795
401, 62, 219, 155, 221, 155, -2, 0, 3.141592653589793, 2.0
401, 70, 287, 142, 289, 142, -2, 0, 3.141592653589793, 2.0
401, 100, 585, 217, 586, 219, -1, -2, -2.0344439357957027, 2.23606797749979
401, 101, 363, 122, 365, 123, -2, -1, -2.677945044588987, 2.23606797749979
401, 102, 226, 147, 229, 147, -3, 0, 3.141592653589793, 3.0
401, 103, 584, 311, 584, 313, 0, -2, -1.5707963267948966, 2.0
402, 10, 244, 146, 246, 145, -2, 1, 2.677945044588987, 2.23606797749979
402, 48, 217, 156, 219, 155, -2, 1, 2.677945044588987, 2.23606797749979
402, 50, 135, 243, 136, 242, -1, 1, 2.356194490192345, 1.4142135623730951
402, 55, 285, 141, 287, 142, -2, -1, -2.677945044588987, 2.23606797749979
402, 80, 584, 215, 585, 217, -1, -2, -2.0344439357957027, 2.23606797749979
402, 82, 224, 146, 226, 147, -2, -1, -2.677945044588987, 2.23606797749979
402, 83, 584, 309, 584, 311, 0, -2, -1.5707963267948966, 2.0
403, 2, 179, 176, 180, 175, -1, 1, 2.356194490192345, 1.4142135623730951
403, 9, 242, 146, 244, 146, -2, 0, 3.141592653589793, 2.0
403, 41, 314, 128, 316, 128, -2, 0, 3.141592653589793, 2.0
403, 42, 215, 157, 217, 156, -2, 1, 2.677945044588987, 2.23606797749979
403, 44, 134, 244, 135, 243, -1, 1, 2.356194490192345, 1.4142135623730951
403, 64, 582, 213, 584, 215, -2, -2, -2.356194490192345, 2.8284271247461903
403, 65, 360, 121, 362, 122, -2, -1, -2.677945044588987, 2.23606797749979
403, 66, 222, 146, 224, 146, -2, 0, 3.141592653589793, 2.0
404, 2, 177, 176, 179, 176, -2, 0, 3.141592653589793, 2.0
404, 8, 240, 146, 242, 146, -2, 0, 3.141592653589793, 2.0
404, 34, 312, 127, 314, 128, -2, -1, -2.677945044588987, 2.23606797749979
404, 35, 213, 158, 215, 157, -2, 1, 2.677945044588987, 2.23606797749979
404, 55, 358, 121, 360, 121, -2, 0, 3.141592653589793, 2.0
404, 56, 220, 145, 222, 146, -2, -1, -2.677945044588987, 2.23606797749979
404, 57, 584, 306, 584, 308, 0, -2, -1.5707963267948966, 2.0
405, 41, 242, 148, 244, 148, -2, 0, 3.141592653589793, 2.0
405, 87, 225, 148, 227, 148, -2, 0, 3.141592653589793, 2.0
405, 98, 314, 131, 316, 132, -2, -1, -2.677945044588987, 2.23606797749979
405, 109, 216, 157, 218, 157, -2, 0, 3.141592653589793, 2.0
405, 130, 285, 143, 287, 143, -2, 0, 3.141592653589793, 2.0
405, 158, 302, 134, 304, 134, -2, 0, 3.141592653589793, 2.0
406, 35, 240, 148, 242, 148, -2, 0, 3.141592653589793, 2.0
406, 71, 223, 147, 225, 148, -2, -1, -2.677945044588987, 2.23606797749979
406, 80, 312, 131, 314, 131, -2, 0, 3.141592653589793, 2.0
406, 89, 214, 157, 216, 157, -2, 0, 3.141592653589793, 2.0
406, 105, 283, 143, 285, 143, -2, 0, 3.141592653589793, 2.0
406, 106, 362, 122, 364, 122, -2, 0, 3.141592653589793, 2.0
407, 8, 405, 108, 405, 110, 0, -2, -1.5707963267948966, 2.0
407, 30, 237, 148, 240, 148, -3, 0, 3.141592653589793, 3.0
407, 59, 221, 146, 223, 147, -2, -1, -2.677945044588987, 2.23606797749979
407, 66, 310, 130, 312, 131, -2, -1, -2.677945044588987, 2.23606797749979
407, 86, 281, 143, 283, 143, -2, 0, 3.141592653589793, 2.0
408, 25, 235, 148, 237, 148, -2, 0, 3.141592653589793, 2.0
408, 56, 308, 129, 310, 130, -2, -1, -2.677945044588987, 2.23606797749979
408, 61, 211, 157, 213, 157, -2, 0, 3.141592653589793, 2.0
408, 73, 279, 143, 281, 143, -2, 0, 3.141592653589793, 2.0
409, 4, 191, 180, 192, 179, -1, 1, 2.356194490192345, 1.4142135623730951
409, 19, 109, 218, 111, 219, -2, -1, -2.677945044588987, 2.23606797749979
409, 20, 232, 148, 235, 148, -3, 0, 3.141592653589793, 3.0
409, 47, 306, 128, 308, 129, -2, -1, -2.677945044588987, 2.23606797749979
409, 52, 209, 157, 211, 157, -2, 0, 3.141592653589793, 2.0
409, 62, 277, 143, 279, 143, -2, 0, 3.141592653589793, 2.0
410, 40, 237, 151, 240, 151, -3, 0, 3.141592653589793, 3.0
410, 101, 282, 143, 284, 144, -2, -1, -2.677945044588987, 2.23606797749979
410, 108, 220, 146, 223, 147, -3, -1, -2.819842099193151, 3.1622776601683795
410, 115, 213, 161, 215, 161, -2, 0, 3.141592653589793, 2.0
410, 123, 361, 122, 363, 123, -2, -1, -2.677945044588987, 2.23606797749979
410, 129, 310, 132, 312, 132, -2, 0, 3.141592653589793, 2.0
410, 130, 582, 212, 584, 214, -2, -2, -2.356194490192345, 2.8284271247461903
411, 34, 234, 150, 237, 151, -3, -1, -2.819842099193151, 3.1622776601683795
411, 79, 278, 141, 282, 143, -4, -2, -2.677945044588987, 4.47213595499958
411, 83, 218, 145, 220, 146, -2, -1, -2.677945044588987, 2.23606797749979
411, 86, 568, 163, 567, 164, 1, -1, -0.7853981633974483, 1.4142135623730951
411, 89, 209, 162, 213, 161, -4, 1, 2.896613990462929, 4.123105625617661
411, 99, 308, 132, 310, 132, -2, 0, 3.141592653589793, 2.0
411, 100, 581, 209, 582, 212, -1, -3, -1.892546881191539, 3.1622776601683795
412, 15, 319, 117, 321, 118, -2, -1, -2.677945044588987, 2.23606797749979
412, 29, 232, 150, 234, 150, -2, 0, 3.141592653589793, 2.0
412, 45, 583, 159, 583, 161, 0, -2, -1.5707963267948966, 2.0
412, 66, 174, 165, 176, 165, -2, 0, 3.141592653589793, 2.0
412, 67, 276, 140, 278, 141, -2, -1, -2.677945044588987, 2.23606797749979
412, 69, 134, 230, 135, 229, -1, 1, 2.356194490192345, 1.4142135623730951
412, 71, 216, 144, 218, 145, -2, -1, -2.677945044588987, 2.23606797749979
412, 74, 568, 161, 568, 163, 0, -2, -1.5707963267948966, 2.0
412, 77, 207, 162, 209, 162, -2, 0, 3.141592653589793, 2.0
412, 87, 580, 207, 581, 209, -1, -2, -2.0344439357957027, 2.23606797749979
412, 88, 73, 214, 73, 216, 0, -2, -1.5707963267948966, 2.0
412, 93, 587, 309, 587, 311, 0, -2, -1.5707963267948966, 2.0
413, 24, 229, 149, 232, 150, -3, -1, -2.819842099193151, 3.1622776601683795
413, 61, 274, 139, 276, 140, -2, -1, -2.677945044588987, 2.23606797749979
413, 64, 101, 148, 103, 149, -2, -1, -2.677945044588987, 2.23606797749979
413, 65, 214, 143, 216, 144, -2, -1, -2.677945044588987, 2.23606797749979
413, 69, 205, 162, 207, 162, -2, 0, 3.141592653589793, 2.0
413, 77, 305, 131, 307, 132, -2, -1, -2.677945044588987, 2.23606797749979
413, 78, 578, 206, 580, 207, -2, -1, -2.677945044588987, 2.23606797749979
413, 82, 587, 307, 587, 309, 0, -2, -1.5707963267948966, 2.0
414, 21, 227, 148, 229, 149, -2, -1, -2.677945044588987, 2.23606797749979
414, 66, 576, 205, 578, 206, -2, -1, -2.677945044588987, 2.23606797749979
415, 0, 60, 335, 62, 335, -2, 0, 3.141592653589793, 2.0
415, 1, 137, 360, 139, 361, -2, -1, -2.677945044588987, 2.23606797749979
415, 4, 179, 143, 181, 143, -2, 0, 3.141592653589793, 2.0
415, 13, 181, 174, 183, 175, -2, -1, -2.677945044588987, 2.23606797749979
415, 15, 228, 148, 231, 149, -3, -1, -2.819842099193151, 3.1622776601683795
415, 50, 217, 144, 219, 145, -2, -1, -2.677945044588987, 2.23606797749979
415, 55, 601, 264, 600, 265, 1, -1, -0.7853981633974483, 1.4142135623730951
415, 77, 68, 343, 70, 343, -2, 0, 3.141592653589793, 2.0
415, 87, 583, 204, 584, 207, -1, -3, -1.892546881191539, 3.1622776601683795
415, 102, 114, 152, 116, 152, -2, 0, 3.141592653589793, 2.0
415, 121, 306, 133, 308, 133, -2, 0, 3.141592653589793, 2.0
415, 128, 70, 213, 72, 215, -2, -2, -2.356194490192345, 2.8284271247461903
415, 131, 276, 143, 278, 143, -2, 0, 3.141592653589793, 2.0
415, 133, 116, 311, 118, 312, -2, -1, -2.677945044588987, 2.23606797749979
415, 143, 151, 209, 153, 208, -2, 1, 2.677945044588987, 2.23606797749979
415, 145, 458, 125, 460, 126, -2, -1, -2.677945044588987, 2.23606797749979
416, 13, 226, 148, 228, 148, -2, 0, 3.141592653589793, 2.0
416, 32, 317, 123, 319, 123, -2, 0, 3.141592653589793, 2.0
416, 69, 582, 202, 583, 204, -1, -2, -2.0344439357957027, 2.23606797749979
416, 78, 208, 162, 210, 162, -2, 0, 3.141592653589793, 2.0
416, 102, 274, 142, 276, 143, -2, -1, -2.677945044588987, 2.23606797749979
417, 10, 224, 147, 226, 148, -2, -1, -2.677945044588987, 2.23606797749979
417, 55, 581, 199, 582, 202, -1, -3, -1.892546881191539, 3.1622776601683795
417, 61, 207, 163, 208, 162, -1, 1, 2.356194490192345, 1.4142135623730951
417, 77, 272, 142, 274, 142, -2, 0, 3.141592653589793, 2.0
418, 7, 222, 146, 224, 147, -2, -1, -2.677945044588987, 2.23606797749979
418, 45, 580, 196, 581, 199, -1, -3, -1.892546881191539, 3.1622776601683795
418, 49, 205, 163, 207, 163, -2, 0, 3.141592653589793, 2.0
418, 50, 171, 165, 172, 164, -1, 1, 2.356194490192345, 1.4142135623730951
418, 63, 270, 141, 272, 142, -2, -1, -2.677945044588987, 2.23606797749979
419, 40, 143, 219, 144, 218, -1, 1, 2.356194490192345, 1.4142135623730951
419, 56, 268, 140, 270, 141, -2, -1, -2.677945044588987, 2.23606797749979
420, 32, 97, 234, 98, 233, -1, 1, 2.356194490192345, 1.4142135623730951
420, 39, 226, 150, 228, 151, -2, -1, -2.677945044588987, 2.23606797749979
420, 42, 97, 242, 98, 241, -1, 1, 2.356194490192345, 1.4142135623730951
420, 49, 138, 357, 140, 358, -2, -1, -2.677945044588987, 2.23606797749979
420, 55, 566, 175, 567, 177, -1, -2, -2.0344439357957027, 2.23606797749979
420, 71, 123, 176, 126, 176, -3, 0, 3.141592653589793, 3.0
420, 89, 204, 164, 206, 164, -2, 0, 3.141592653589793, 2.0
420, 101, 271, 143, 273, 144, -2, -1, -2.677945044588987, 2.23606797749979
420, 114, 92, 274, 94, 274, -2, 0, 3.141592653589793, 2.0
420, 115, 355, 120, 357, 120, -2, 0, 3.141592653589793, 2.0
420, 121, 595, 307, 595, 309, 0, -2, -1.5707963267948966, 2.0
420, 136, 576, 199, 577, 202, -1, -3, -1.892546881191539, 3.1622776601683795
420, 169, 369, 121, 371, 122, -2, -1, -2.677945044588987, 2.23606797749979
421, 30, 224, 148, 226, 150, -2, -2, -2.356194490192345, 2.8284271247461903
421, 38, 137, 355, 138, 357, -1, -2, -2.0344439357957027, 2.23606797749979
421, 72, 269, 143, 271, 143, -2, 0, 3.141592653589793, 2.0
421, 82, 353, 119, 355, 120, -2, -1, -2.677945044588987, 2.23606797749979
421, 95, 575, 196, 576, 199, -1, -3, -1.892546881191539, 3.1622776601683795
421, 116, 367, 120, 369, 121, -2, -1, -2.677945044588987, 2.23606797749979
422, 24, 222, 148, 224, 148, -2, 0, 3.141592653589793, 2.0
422, 30, 135, 354, 137, 355, -2, -1, -2.677945044588987, 2.23606797749979
422, 50, 202, 164, 204, 164, -2, 0, 3.141592653589793, 2.0
422, 56, 266, 142, 269, 143, -3, -1, -2.819842099193151, 3.1622776601683795
422, 66, 351, 118, 353, 119, -2, -1, -2.677945044588987, 2.23606797749979
422, 78, 574, 193, 575, 196, -1, -3, -1.892546881191539, 3.1622776601683795
423, 21, 220, 147, 222, 148, -2, -1, -2.677945044588987, 2.23606797749979
423, 37, 137, 364, 136, 365, 1, -1, -0.7853981633974483, 1.4142135623730951
423, 49, 264, 141, 266, 142, -2, -1, -2.677945044588987, 2.23606797749979
423, 67, 573, 191, 574, 193, -1, -2, -2.0344439357957027, 2.23606797749979
424, 39, 199, 164, 201, 164, -2, 0, 3.141592653589793, 2.0
425, 0, 178, 142, 179, 144, -1, -2, -2.0344439357957027, 2.23606797749979
425, 2, 188, 183, 190, 183, -2, 0, 3.141592653589793, 2.0
425, 38, 134, 357, 136, 358, -2, -1, -2.677945044588987, 2.23606797749979
425, 73, 202, 167, 204, 167, -2, 0, 3.141592653589793, 2.0
425, 117, 352, 121, 354, 121, -2, 0, 3.141592653589793, 2.0
425, 140, 475, 125, 477, 126, -2, -1, -2.677945044588987, 2.23606797749979
425, 141, 267, 142, 269, 143, -2, -1, -2.677945044588987, 2.23606797749979
425, 163, 576, 196, 577, 198, -1, -2, -2.0344439357957027, 2.23606797749979
425, 170, 257, 151, 259, 150, -2, 1, 2.677945044588987, 2.23606797749979
426, 31, 131, 355, 134, 357, -3, -2, -2.5535900500422257, 3.605551275463989
426, 53, 187, 168, 189, 168, -2, 0, 3.141592653589793, 2.0
426, 54, 200, 167, 202, 167, -2, 0, 3.141592653589793, 2.0
426, 72, 594, 258, 595, 260, -1, -2, -2.0344439357957027, 2.23606797749979
426, 89, 350, 121, 352, 121, -2, 0, 3.141592653589793, 2.0
426, 106, 473, 123, 475, 125, -2, -2, -2.356194490192345, 2.8284271247461903
426, 107, 265, 141, 267, 142, -2, -1, -2.677945044588987, 2.23606797749979
426, 127, 574, 194, 576, 196, -2, -2, -2.356194490192345, 2.8284271247461903
426, 133, 255, 151, 257, 151, -2, 0, 3.141592653589793, 2.0
427, 41, 49, 358, 52, 358, -3, 0, 3.141592653589793, 3.0
427, 45, 185, 169, 187, 168, -2, 1, 2.677945044588987, 2.23606797749979
427, 46, 197, 167, 200, 167, -3, 0, 3.141592653589793, 3.0
427, 50, 210, 145, 213, 146, -3, -1, -2.819842099193151, 3.1622776601683795
427, 76, 348, 120, 350, 121, -2, -1, -2.677945044588987, 2.23606797749979
427, 92, 471, 122, 473, 123, -2, -1, -2.677945044588987, 2.23606797749979
427, 93, 263, 140, 265, 141, -2, -1, -2.677945044588987, 2.23606797749979
427, 103, 459, 117, 461, 118, -2, -1, -2.677945044588987, 2.23606797749979
427, 109, 573, 192, 574, 194, -1, -2, -2.0344439357957027, 2.23606797749979
427, 115, 253, 151, 255, 151, -2, 0, 3.141592653589793, 2.0
428, 36, 183, 169, 185, 169, -2, 0, 3.141592653589793, 2.0
428, 37, 195, 166, 197, 167, -2, -1, -2.677945044588987, 2.23606797749979
428, 53, 596, 246, 596, 248, 0, -2, -1.5707963267948966, 2.0
428, 60, 346, 119, 348, 120, -2, -1, -2.677945044588987, 2.23606797749979
428, 75, 469, 121, 471, 122, -2, -1, -2.677945044588987, 2.23606797749979
428, 76, 261, 139, 263, 140, -2, -1, -2.677945044588987, 2.23606797749979
428, 88, 572, 190, 573, 192, -1, -2, -2.0344439357957027, 2.23606797749979
428, 94, 251, 151, 253, 151, -2, 0, 3.141592653589793, 2.0
429, 29, 181, 170, 183, 169, -2, 1, 2.677945044588987, 2.23606797749979
429, 30, 193, 166, 195, 166, -2, 0, 3.141592653589793, 2.0
429, 61, 467, 119, 469, 121, -2, -2, -2.356194490192345, 2.8284271247461903
429, 76, 249, 151, 251, 151, -2, 0, 3.141592653589793, 2.0
430, 8, 132, 354, 134, 355, -2, -1, -2.677945044588987, 2.23606797749979
430, 75, 189, 186, 190, 185, -1, 1, 2.356194490192345, 1.4142135623730951
430, 104, 264, 141, 266, 142, -2, -1, -2.677945044588987, 2.23606797749979
430, 140, 361, 121, 363, 121, -2, 0, 3.141592653589793, 2.0
430, 143, 109, 346, 111, 347, -2, -1, -2.677945044588987, 2.23606797749979
430, 145, 348, 121, 350, 122, -2, -1, -2.677945044588987, 2.23606797749979
430, 147, 254, 155, 256, 155, -2, 0, 3.141592653589793, 2.0
431, 0, 178, 144, 179, 143, -1, 1, 2.356194490192345, 1.4142135623730951
431, 7, 131, 352, 132, 354, -1, -2, -2.0344439357957027, 2.23606797749979
431, 84, 261, 140, 264, 141, -3, -1, -2.819842099193151, 3.1622776601683795
431, 116, 346, 120, 348, 121, -2, -1, -2.677945044588987, 2.23606797749979
431, 117, 251, 155, 254, 155, -3, 0, 3.141592653589793, 3.0
431, 118, 184, 140, 186, 140, -2, 0, 3.141592653589793, 2.0
432, 7, 129, 350, 131, 352, -2, -2, -2.356194490192345, 2.8284271247461903
432, 53, 186, 186, 188, 186, -2, 0, 3.141592653589793, 2.0
432, 68, 259, 139, 261, 140, -2, -1, -2.677945044588987, 2.23606797749979
432, 83, 500, 139, 501, 138, -1, 1, 2.356194490192345, 1.4142135623730951
432, 86, 599, 276, 600, 278, -1, -2, -2.0344439357957027, 2.23606797749979
432, 95, 344, 119, 346, 120, -2, -1, -2.677945044588987, 2.23606797749979
432, 96, 249, 155, 251, 155, -2, 0, 3.141592653589793, 2.0
433, 63, 246, 155, 249, 155, -3, 0, 3.141592653589793, 3.0
434, 24, 184, 187, 185, 186, -1, 1, 2.356194490192345, 1.4142135623730951
434, 46, 341, 118, 343, 119, -2, -1, -2.677945044588987, 2.23606797749979
434, 47, 243, 155, 246, 155, -3, 0, 3.141592653589793, 3.0
435, 25, 186, 187, 188, 187, -2, 0, 3.141592653589793, 2.0
435, 59, 56, 359, 54, 359, 2, 0, 0.0, 2.0
435, 63, 75, 258, 77, 259, -2, -1, -2.677945044588987, 2.23606797749979
435, 65, 591, 202, 592, 204, -1, -2, -2.0344439357957027, 2.23606797749979
435, 97, 343, 120, 345, 121, -2, -1, -2.677945044588987, 2.23606797749979
435, 111, 259, 142, 261, 142, -2, 0, 3.141592653589793, 2.0
435, 131, 297, 129, 299, 130, -2, -1, -2.677945044588987, 2.23606797749979
435, 147, 184, 172, 186, 172, -2, 0, 3.141592653589793, 2.0
436, 19, 185, 188, 186, 187, -1, 1, 2.356194490192345, 1.4142135623730951
436, 50, 590, 200, 591, 202, -1, -2, -2.0344439357957027, 2.23606797749979
436, 74, 341, 119, 343, 120, -2, -1, -2.677945044588987, 2.23606797749979
436, 81, 257, 142, 259, 142, -2, 0, 3.141592653589793, 2.0
436, 108, 357, 121, 359, 121, -2, 0, 3.141592653589793, 2.0
436, 110, 193, 173, 195, 173, -2, 0, 3.141592653589793, 2.0
437, 60, 339, 119, 341, 119, -2, 0, 3.141592653589793, 2.0
437, 77, 294, 129, 296, 129, -2, 0, 3.141592653589793, 2.0
437, 88, 181, 172, 183, 172, -2, 0, 3.141592653589793, 2.0
438, 14, 183, 189, 184, 188, -1, 1, 2.356194490192345, 1.4142135623730951
438, 31, 206, 146, 208, 146, -2, 0, 3.141592653589793, 2.0
438, 33, 54, 359, 56, 359, -2, 0, 3.141592653589793, 2.0
438, 67, 292, 129, 294, 129, -2, 0, 3.141592653589793, 2.0
439, 43, 336, 119, 338, 119, -2, 0, 3.141592653589793, 2.0
439, 55, 290, 129, 292, 129, -2, 0, 3.141592653589793, 2.0
439, 56, 70, 227, 69, 226, 1, 1, 0.7853981633974483, 1.4142135623730951
439, 65, 189, 173, 191, 173, -2, 0, 3.141592653589793, 2.0
440, 20, 175, 179, 177, 179, -2, 0, 3.141592653589793, 2.0
440, 36, 140, 184, 142, 185, -2, -1, -2.677945044588987, 2.23606797749979
440, 64, 99, 329, 99, 331, 0, -2, -1.5707963267948966, 2.0
440, 82, 454, 119, 456, 119, -2, 0, 3.141592653589793, 2.0
440, 100, 294, 129, 296, 130, -2, -1, -2.677945044588987, 2.23606797749979
440, 122, 338, 121, 340, 121, -2, 0, 3.141592653589793, 2.0
440, 137, 449, 125, 451, 124, -2, 1, 2.677945044588987, 2.23606797749979
440, 145, 355, 120, 357, 121, -2, -1, -2.677945044588987, 2.23606797749979
440, 154, 545, 166, 546, 168, -1, -2, -2.0344439357957027, 2.23606797749979
441, 46, 180, 171, 182, 171, -2, 0, 3.141592653589793, 2.0
441, 81, 292, 129, 294, 129, -2, 0, 3.141592653589793, 2.0
441, 100, 336, 121, 338, 121, -2, 0, 3.141592653589793, 2.0
441, 130, 262, 131, 264, 132, -2, -1, -2.677945044588987, 2.23606797749979
442, 2, 183, 191, 184, 190, -1, 1, 2.356194490192345, 1.4142135623730951
442, 20, 81, 303, 83, 302, -2, 1, 2.677945044588987, 2.23606797749979
442, 23, 307, 123, 309, 124, -2, -1, -2.677945044588987, 2.23606797749979
442, 62, 290, 129, 292, 129, -2, 0, 3.141592653589793, 2.0
442, 86, 447, 126, 448, 125, -1, 1, 2.356194490192345, 1.4142135623730951
443, 44, 450, 118, 452, 119, -2, -1, -2.677945044588987, 2.23606797749979
443, 45, 131, 155, 130, 156, 1, -1, -0.7853981633974483, 1.4142135623730951
443, 51, 288, 129, 290, 129, -2, 0, 3.141592653589793, 2.0
443, 64, 333, 121, 335, 121, -2, 0, 3.141592653589793, 2.0
443, 72, 445, 126, 447, 126, -2, 0, 3.141592653589793, 2.0
443, 83, 259, 131, 261, 131, -2, 0, 3.141592653589793, 2.0
444, 2, 181, 192, 182, 191, -1, 1, 2.356194490192345, 1.4142135623730951
444, 16, 78, 303, 80, 303, -2, 0, 3.141592653589793, 2.0
444, 66, 442, 125, 445, 126, -3, -1, -2.819842099193151, 3.1622776601683795
445, 26, 184, 196, 185, 195, -1, 1, 2.356194490192345, 1.4142135623730951
445, 61, 337, 118, 339, 119, -2, -1, -2.677945044588987, 2.23606797749979
445, 147, 444, 125, 446, 126, -2, -1, -2.677945044588987, 2.23606797749979
445, 152, 466, 119, 468, 120, -2, -1, -2.677945044588987, 2.23606797749979
446, 53, 335, 117, 337, 118, -2, -1, -2.677945044588987, 2.23606797749979
446, 78, 288, 130, 292, 131, -4, -1, -2.896613990462929, 4.123105625617661
446, 117, 350, 120, 352, 121, -2, -1, -2.677945044588987, 2.23606797749979
446, 119, 441, 124, 444, 125, -3, -1, -2.819842099193151, 3.1622776601683795
447, 43, 333, 117, 335, 117, -2, 0, 3.141592653589793, 2.0
447, 52, 55, 359, 54, 361, 1, -2, -1.1071487177940904, 2.23606797749979
447, 65, 286, 129, 288, 130, -2, -1, -2.677945044588987, 2.23606797749979
447, 99, 439, 123, 441, 124, -2, -1, -2.677945044588987, 2.23606797749979
448, 33, 331, 117, 333, 117, -2, 0, 3.141592653589793, 2.0
448, 63, 143, 170, 142, 171, 1, -1, -0.7853981633974483, 1.4142135623730951
448, 78, 437, 122, 439, 123, -2, -1, -2.677945044588987, 2.23606797749979
449, 67, 346, 119, 348, 120, -2, -1, -2.677945044588987, 2.23606797749979
450, 15, 85, 301, 84, 303, 1, -2, -1.1071487177940904, 2.23606797749979
450, 20, 154, 148, 156, 147, -2, 1, 2.677945044588987, 2.23606797749979
450, 85, 184, 200, 185, 199, -1, 1, 2.356194490192345, 1.4142135623730951
450, 111, 334, 120, 336, 120, -2, 0, 3.141592653589793, 2.0
450, 120, 343, 122, 345, 123, -2, -1, -2.677945044588987, 2.23606797749979
450, 135, 285, 132, 287, 132, -2, 0, 3.141592653589793, 2.0
450, 164, 90, 258, 92, 259, -2, -1, -2.677945044588987, 2.23606797749979
450, 169, 226, 157, 228, 157, -2, 0, 3.141592653589793, 2.0
451, 5, 215, 148, 217, 148, -2, 0, 3.141592653589793, 2.0
451, 39, 170, 181, 172, 181, -2, 0, 3.141592653589793, 2.0
451, 84, 332, 120, 334, 120, -2, 0, 3.141592653589793, 2.0
451, 90, 341, 121, 343, 122, -2, -1, -2.677945044588987, 2.23606797749979
451, 102, 283, 132, 285, 132, -2, 0, 3.141592653589793, 2.0
451, 127, 224, 157, 226, 157, -2, 0, 3.141592653589793, 2.0
452, 35, 476, 115, 475, 116, 1, -1, -0.7853981633974483, 1.4142135623730951
452, 56, 187, 167, 186, 168, 1, -1, -0.7853981633974483, 1.4142135623730951
452, 73, 330, 120, 332, 120, -2, 0, 3.141592653589793, 2.0
452, 85, 281, 132, 283, 132, -2, 0, 3.141592653589793, 2.0
452, 107, 222, 157, 224, 157, -2, 0, 3.141592653589793, 2.0
453, 37, 254, 146, 256, 146, -2, 0, 3.141592653589793, 2.0
453, 63, 328, 120, 330, 120, -2, 0, 3.141592653589793, 2.0
453, 74, 279, 132, 281, 132, -2, 0, 3.141592653589793, 2.0
454, 54, 326, 120, 328, 120, -2, 0, 3.141592653589793, 2.0
454, 61, 277, 131, 279, 132, -2, -1, -2.677945044588987, 2.23606797749979
454, 73, 219, 157, 221, 157, -2, 0, 3.141592653589793, 2.0
455, 49, 281, 133, 283, 133, -2, 0, 3.141592653589793, 2.0
455, 85, 258, 115, 260, 116, -2, -1, -2.677945044588987, 2.23606797749979
455, 105, 331, 120, 333, 120, -2, 0, 3.141592653589793, 2.0
455, 132, 445, 119, 447, 120, -2, -1, -2.677945044588987, 2.23606797749979
455, 150, 447, 127, 449, 128, -2, -1, -2.677945044588987, 2.23606797749979
455, 162, 343, 120, 345, 121, -2, -1, -2.677945044588987, 2.23606797749979
455, 163, 357, 123, 359, 123, -2, 0, 3.141592653589793, 2.0
456, 34, 169, 183, 171, 183, -2, 0, 3.141592653589793, 2.0
456, 35, 279, 133, 281, 133, -2, 0, 3.141592653589793, 2.0
456, 61, 256, 115, 258, 115, -2, 0, 3.141592653589793, 2.0
456, 76, 329, 120, 331, 120, -2, 0, 3.141592653589793, 2.0
456, 98, 443, 119, 445, 119, -2, 0, 3.141592653589793, 2.0
456, 114, 445, 126, 447, 127, -2, -1, -2.677945044588987, 2.23606797749979
456, 116, 296, 123, 298, 124, -2, -1, -2.677945044588987, 2.23606797749979
456, 126, 341, 119, 343, 120, -2, -1, -2.677945044588987, 2.23606797749979
456, 127, 355, 123, 357, 123, -2, 0, 3.141592653589793, 2.0
457, 15, 106, 282, 107, 281, -1, 1, 2.356194490192345, 1.4142135623730951
457, 56, 327, 119, 329, 120, -2, -1, -2.677945044588987, 2.23606797749979
457, 80, 145, 230, 147, 230, -2, 0, 3.141592653589793, 2.0
457, 87, 443, 125, 445, 126, -2, -1, -2.677945044588987, 2.23606797749979
457, 94, 353, 123, 355, 123, -2, 0, 3.141592653589793, 2.0
458, 16, 187, 167, 189, 167, -2, 0, 3.141592653589793, 2.0
458, 40, 325, 119, 327, 119, -2, 0, 3.141592653589793, 2.0
458, 62, 441, 124, 443, 125, -2, -1, -2.677945044588987, 2.23606797749979
458, 64, 293, 123, 295, 123, -2, 0, 3.141592653589793, 2.0
458, 68, 350, 122, 353, 123, -3, -1, -2.819842099193151, 3.1622776601683795
459, 50, 439, 124, 441, 124, -2, 0, 3.141592653589793, 2.0
460, 102, 441, 120, 443, 120, -2, 0, 3.141592653589793, 2.0
460, 121, 252, 146, 254, 147, -2, -1, -2.677945044588987, 2.23606797749979
460, 128, 326, 121, 328, 121, -2, 0, 3.141592653589793, 2.0
461, 1, 182, 200, 183, 199, -1, 1, 2.356194490192345, 1.4142135623730951
461, 37, 112, 292, 113, 294, -1, -2, -2.0344439357957027, 2.23606797749979
461, 53, 174, 173, 173, 174, 1, -1, -0.7853981633974483, 1.4142135623730951
461, 78, 439, 119, 441, 120, -2, -1, -2.677945044588987, 2.23606797749979
461, 94, 250, 146, 252, 146, -2, 0, 3.141592653589793, 2.0
461, 98, 324, 121, 326, 121, -2, 0, 3.141592653589793, 2.0
462, 37, 66, 334, 67, 336, -1, -2, -2.0344439357957027, 2.23606797749979
462, 67, 437, 118, 439, 119, -2, -1, -2.677945044588987, 2.23606797749979
462, 83, 248, 146, 250, 146, -2, 0, 3.141592653589793, 2.0
463, 0, 180, 201, 181, 200, -1, 1, 2.356194490192345, 1.4142135623730951
463, 60, 435, 118, 437, 118, -2, 0, 3.141592653589793, 2.0
463, 72, 246, 145, 248, 146, -2, -1, -2.677945044588987, 2.23606797749979
464, 38, 78, 326, 79, 325, -1, 1, 2.356194490192345, 1.4142135623730951
464, 56, 244, 145, 246, 145, -2, 0, 3.141592653589793, 2.0
465, 42, 137, 360, 137, 362, 0, -2, -1.5707963267948966, 2.0
465, 66, 604, 253, 603, 254, 1, -1, -0.7853981633974483, 1.4142135623730951
465, 107, 434, 122, 436, 122, -2, 0, 3.141592653589793, 2.0
465, 109, 249, 147, 251, 147, -2, 0, 3.141592653589793, 2.0
465, 131, 335, 119, 337, 119, -2, 0, 3.141592653589793, 2.0
465, 133, 322, 121, 324, 122, -2, -1, -2.677945044588987, 2.23606797749979
465, 146, 51, 138, 53, 138, -2, 0, 3.141592653589793, 2.0
465, 152, 348, 122, 350, 123, -2, -1, -2.677945044588987, 2.23606797749979
465, 161, 594, 298, 593, 299, 1, -1, -0.7853981633974483, 1.4142135623730951
466, 11, 182, 201, 184, 201, -2, 0, 3.141592653589793, 2.0
466, 85, 432, 122, 434, 122, -2, 0, 3.141592653589793, 2.0
466, 87, 247, 147, 249, 147, -2, 0, 3.141592653589793, 2.0
466, 92, 136, 255, 138, 255, -2, 0, 3.141592653589793, 2.0
466, 102, 333, 118, 335, 119, -2, -1, -2.677945044588987, 2.23606797749979
466, 103, 318, 120, 322, 121, -4, -1, -2.896613990462929, 4.123105625617661
466, 109, 602, 300, 601, 301, 1, -1, -0.7853981633974483, 1.4142135623730951
466, 117, 346, 121, 348, 122, -2, -1, -2.677945044588987, 2.23606797749979
467, 65, 276, 132, 278, 133, -2, -1, -2.677945044588987, 2.23606797749979
467, 66, 430, 122, 432, 122, -2, 0, 3.141592653589793, 2.0
467, 68, 245, 147, 247, 147, -2, 0, 3.141592653589793, 2.0
467, 81, 331, 118, 333, 118, -2, 0, 3.141592653589793, 2.0
468, 6, 180, 202, 181, 201, -1, 1, 2.356194490192345, 1.4142135623730951
468, 55, 274, 132, 276, 132, -2, 0, 3.141592653589793, 2.0
468, 58, 243, 147, 245, 147, -2, 0, 3.141592653589793, 2.0
468, 71, 329, 117, 331, 118, -2, -1, -2.677945044588987, 2.23606797749979
468, 72, 316, 120, 318, 120, -2, 0, 3.141592653589793, 2.0
469, 4, 178, 202, 180, 202, -2, 0, 3.141592653589793, 2.0
469, 47, 241, 148, 243, 147, -2, 1, 2.677945044588987, 2.23606797749979
470, 50, 183, 206, 184, 205, -1, 1, 2.356194490192345, 1.4142135623730951
470, 56, 136, 360, 137, 362, -1, -2, -2.0344439357957027, 2.23606797749979
470, 110, 275, 134, 277, 134, -2, 0, 3.141592653589793, 2.0
470, 114, 318, 123, 320, 123, -2, 0, 3.141592653589793, 2.0
470, 154, 431, 126, 433, 126, -2, 0, 3.141592653589793, 2.0
470, 160, 435, 119, 437, 120, -2, -1, -2.677945044588987, 2.23606797749979
470, 169, 258, 148, 260, 148, -2, 0, 3.141592653589793, 2.0
471, 34, 181, 206, 183, 206, -2, 0, 3.141592653589793, 2.0
471, 40, 134, 359, 136, 360, -2, -1, -2.677945044588987, 2.23606797749979
471, 46, 164, 213, 166, 213, -2, 0, 3.141592653589793, 2.0
471, 70, 244, 149, 246, 148, -2, 1, 2.677945044588987, 2.23606797749979
471, 89, 316, 123, 318, 123, -2, 0, 3.141592653589793, 2.0
471, 123, 429, 126, 431, 126, -2, 0, 3.141592653589793, 2.0
471, 128, 433, 118, 435, 119, -2, -1, -2.677945044588987, 2.23606797749979
471, 136, 257, 149, 258, 148, -1, 1, 2.356194490192345, 1.4142135623730951
472, 29, 180, 207, 181, 206, -1, 1, 2.356194490192345, 1.4142135623730951
472, 48, 424, 106, 426, 106, -2, 0, 3.141592653589793, 2.0
472, 57, 242, 149, 244, 149, -2, 0, 3.141592653589793, 2.0
472, 68, 272, 134, 274, 134, -2, 0, 3.141592653589793, 2.0
472, 69, 314, 122, 316, 123, -2, -1, -2.677945044588987, 2.23606797749979
472, 91, 427, 126, 429, 126, -2, 0, 3.141592653589793, 2.0
473, 27, 178, 207, 180, 207, -2, 0, 3.141592653589793, 2.0
473, 52, 240, 149, 242, 149, -2, 0, 3.141592653589793, 2.0
473, 54, 134, 154, 133, 155, 1, -1, -0.7853981633974483, 1.4142135623730951
473, 61, 311, 122, 314, 122, -3, 0, 3.141592653589793, 3.0
473, 63, 247, 129, 250, 130, -3, -1, -2.819842099193151, 3.1622776601683795
473, 80, 425, 127, 427, 126, -2, 1, 2.677945044588987, 2.23606797749979
473, 87, 254, 149, 256, 149, -2, 0, 3.141592653589793, 2.0
474, 33, 96, 245, 98, 245, -2, 0, 3.141592653589793, 2.0
474, 44, 121, 223, 123, 223, -2, 0, 3.141592653589793, 2.0
474, 49, 238, 150, 240, 149, -2, 1, 2.677945044588987, 2.23606797749979
474, 57, 309, 121, 311, 122, -2, -1, -2.677945044588987, 2.23606797749979
474, 75, 423, 126, 425, 127, -2, -1, -2.677945044588987, 2.23606797749979
474, 81, 252, 149, 254, 149, -2, 0, 3.141592653589793, 2.0
475, 63, 136, 356, 138, 358, -2, -2, -2.356194490192345, 2.8284271247461903
475, 103, 241, 150, 243, 150, -2, 0, 3.141592653589793, 2.0
475, 141, 185, 207, 187, 207, -2, 0, 3.141592653589793, 2.0
475, 146, 432, 119, 434, 120, -2, -1, -2.677945044588987, 2.23606797749979
475, 156, 315, 127, 317, 128, -2, -1, -2.677945044588987, 2.23606797749979
476, 15, 176, 205, 178, 205, -2, 0, 3.141592653589793, 2.0
476, 39, 116, 151, 117, 150, -1, 1, 2.356194490192345, 1.4142135623730951
476, 71, 272, 136, 274, 136, -2, 0, 3.141592653589793, 2.0
476, 84, 144, 220, 146, 220, -2, 0, 3.141592653589793, 2.0
476, 111, 430, 118, 432, 119, -2, -1, -2.677945044588987, 2.23606797749979
477, 62, 238, 150, 240, 150, -2, 0, 3.141592653589793, 2.0
477, 88, 428, 117, 430, 118, -2, -1, -2.677945044588987, 2.23606797749979
477, 94, 312, 127, 314, 127, -2, 0, 3.141592653589793, 2.0
478, 49, 269, 136, 271, 136, -2, 0, 3.141592653589793, 2.0
478, 74, 181, 207, 183, 207, -2, 0, 3.141592653589793, 2.0
478, 82, 310, 127, 312, 127, -2, 0, 3.141592653589793, 2.0
479, 63, 179, 207, 181, 207, -2, 0, 3.141592653589793, 2.0
479, 65, 425, 116, 427, 117, -2, -1, -2.677945044588987, 2.23606797749979
479, 70, 308, 127, 310, 127, -2, 0, 3.141592653589793, 2.0
480, 12, 599, 251, 601, 252, -2, -1, -2.677945044588987, 2.23606797749979
480, 80, 271, 137, 273, 137, -2, 0, 3.141592653589793, 2.0
480, 129, 133, 355, 135, 356, -2, -1, -2.677945044588987, 2.23606797749979
480, 143, 325, 121, 327, 121, -2, 0, 3.141592653589793, 2.0
480, 153, 428, 119, 430, 120, -2, -1, -2.677945044588987, 2.23606797749979
480, 155, 238, 152, 240, 152, -2, 0, 3.141592653589793, 2.0
480, 156, 312, 122, 314, 122, -2, 0, 3.141592653589793, 2.0
480, 157, 426, 126, 428, 127, -2, -1, -2.677945044588987, 2.23606797749979
481, 2, 174, 207, 176, 207, -2, 0, 3.141592653589793, 2.0
481, 59, 80, 273, 83, 273, -3, 0, 3.141592653589793, 3.0
481, 66, 123, 171, 125, 172, -2, -1, -2.677945044588987, 2.23606797749979
481, 68, 603, 297, 602, 299, 1, -2, -1.1071487177940904, 2.23606797749979
481, 83, 133, 156, 135, 157, -2, -1, -2.677945044588987, 2.23606797749979
481, 99, 130, 354, 133, 355, -3, -1, -2.819842099193151, 3.1622776601683795
481, 111, 323, 121, 325, 121, -2, 0, 3.141592653589793, 2.0
481, 118, 426, 119, 428, 119, -2, 0, 3.141592653589793, 2.0
482, 2, 171, 207, 174, 207, -3, 0, 3.141592653589793, 3.0
482, 51, 268, 137, 270, 137, -2, 0, 3.141592653589793, 2.0
482, 78, 128, 353, 130, 354, -2, -1, -2.677945044588987, 2.23606797749979
482, 86, 320, 120, 323, 121, -3, -1, -2.819842099193151, 3.1622776601683795
483, 43, 266, 137, 268, 137, -2, 0, 3.141592653589793, 2.0
483, 66, 126, 352, 128, 353, -2, -1, -2.677945044588987, 2.23606797749979
484, 24, 120, 288, 119, 289, 1, -1, -0.7853981633974483, 1.4142135623730951
484, 38, 603, 293, 603, 295, 0, -2, -1.5707963267948966, 2.0
484, 61, 308, 123, 309, 122, -1, 1, 2.356194490192345, 1.4142135623730951
485, 32, 561, 166, 563, 167, -2, -1, -2.677945044588987, 2.23606797749979
485, 88, 173, 211, 175, 211, -2, 0, 3.141592653589793, 2.0
485, 108, 320, 120, 322, 120, -2, 0, 3.141592653589793, 2.0
485, 131, 331, 121, 333, 122, -2, -1, -2.677945044588987, 2.23606797749979
485, 135, 555, 166, 555, 168, 0, -2, -1.5707963267948966, 2.0
485, 148, 309, 122, 311, 122, -2, 0, 3.141592653589793, 2.0
485, 150, 418, 123, 420, 124, -2, -1, -2.677945044588987, 2.23606797749979
485, 151, 128, 355, 130, 356, -2, -1, -2.677945044588987, 2.23606797749979
485, 160, 425, 126, 427, 127, -2, -1, -2.677945044588987, 2.23606797749979
486, 16, 292, 122, 294, 122, -2, 0, 3.141592653589793, 2.0
486, 63, 171, 211, 173, 211, -2, 0, 3.141592653589793, 2.0
486, 70, 299, 106, 301, 106, -2, 0, 3.141592653589793, 2.0
486, 79, 318, 119, 320, 120, -2, -1, -2.677945044588987, 2.23606797749979
486, 97, 329, 121, 331, 121, -2, 0, 3.141592653589793, 2.0
486, 105, 212, 165, 214, 166, -2, -1, -2.677945044588987, 2.23606797749979
486, 110, 308, 123, 309, 122, -1, 1, 2.356194490192345, 1.4142135623730951
486, 111, 416, 123, 418, 123, -2, 0, 3.141592653589793, 2.0
486, 112, 126, 354, 128, 355, -2, -1, -2.677945044588987, 2.23606797749979
486, 117, 423, 125, 425, 126, -2, -1, -2.677945044588987, 2.23606797749979
487, 22, 266, 138, 268, 138, -2, 0, 3.141592653589793, 2.0
487, 51, 169, 211, 171, 211, -2, 0, 3.141592653589793, 2.0
487, 78, 327, 120, 329, 121, -2, -1, -2.677945044588987, 2.23606797749979
487, 90, 306, 123, 308, 123, -2, 0, 3.141592653589793, 2.0
487, 92, 124, 353, 126, 354, -2, -1, -2.677945044588987, 2.23606797749979
488, 20, 264, 138, 266, 138, -2, 0, 3.141592653589793, 2.0
488, 69, 325, 120, 327, 120, -2, 0, 3.141592653589793, 2.0
488, 79, 304, 123, 306, 123, -2, 0, 3.141592653589793, 2.0
488, 81, 122, 353, 124, 353, -2, 0, 3.141592653589793, 2.0
489, 18, 262, 137, 264, 138, -2, -1, -2.677945044588987, 2.23606797749979
489, 43, 166, 211, 168, 211, -2, 0, 3.141592653589793, 2.0
489, 69, 415, 122, 414, 123, 1, -1, -0.7853981633974483, 1.4142135623730951
490, 36, 588, 185, 588, 187, 0, -2, -1.5707963267948966, 2.0
490, 50, 115, 292, 115, 294, 0, -2, -1.5707963267948966, 2.0
490, 60, 189, 170, 191, 171, -2, -1, -2.677945044588987, 2.23606797749979
490, 86, 316, 118, 318, 119, -2, -1, -2.677945044588987, 2.23606797749979
490, 88, 192, 140, 194, 140, -2, 0, 3.141592653589793, 2.0
490, 97, 264, 138, 268, 139, -4, -1, -2.896613990462929, 4.123105625617661
490, 104, 183, 178, 185, 178, -2, 0, 3.141592653589793, 2.0
490, 106, 297, 105, 300, 106, -3, -1, -2.819842099193151, 3.1622776601683795
490, 117, 124, 353, 126, 354, -2, -1, -2.677945044588987, 2.23606797749979
490, 126, 231, 152, 235, 153, -4, -1, -2.896613990462929, 4.123105625617661
490, 152, 593, 195, 593, 197, 0, -2, -1.5707963267948966, 2.0
490, 154, 308, 125, 309, 124, -1, 1, 2.356194490192345, 1.4142135623730951
490, 169, 604, 256, 604, 258, 0, -2, -1.5707963267948966, 2.0
491, 19, 52, 257, 53, 259, -1, -2, -2.0344439357957027, 2.23606797749979
491, 70, 314, 117, 316, 118, -2, -1, -2.677945044588987, 2.23606797749979
491, 94, 122, 352, 124, 353, -2, -1, -2.677945044588987, 2.23606797749979
491, 121, 306, 125, 308, 125, -2, 0, 3.141592653589793, 2.0
492, 38, 115, 289, 115, 291, 0, -2, -1.5707963267948966, 2.0
492, 72, 261, 137, 263, 138, -2, -1, -2.677945044588987, 2.23606797749979
492, 106, 304, 126, 306, 125, -2, 1, 2.677945044588987, 2.23606797749979
493, 15, 243, 132, 245, 132, -2, 0, 3.141592653589793, 2.0
493, 40, 134, 186, 137, 187, -3, -1, -2.819842099193151, 3.1622776601683795
494, 2, 167, 213, 168, 212, -1, 1, 2.356194490192345, 1.4142135623730951
495, 92, 216, 127, 218, 127, -2, 0, 3.141592653589793, 2.0
495, 108, 597, 233, 598, 235, -1, -2, -2.0344439357957027, 2.23606797749979
495, 119, 313, 118, 315, 119, -2, -1, -2.677945044588987, 2.23606797749979
495, 165, 123, 302, 122, 303, 1, -1, -0.7853981633974483, 1.4142135623730951
496, 20, 126, 346, 128, 346, -2, 0, 3.141592653589793, 2.0
496, 37, 70, 256, 69, 258, 1, -2, -1.1071487177940904, 2.23606797749979
496, 53, 168, 215, 169, 214, -1, 1, 2.356194490192345, 1.4142135623730951
496, 57, 415, 117, 417, 118, -2, -1, -2.677945044588987, 2.23606797749979
496, 58, 106, 336, 106, 338, 0, -2, -1.5707963267948966, 2.0
496, 70, 260, 138, 262, 139, -2, -1, -2.677945044588987, 2.23606797749979
496, 71, 127, 194, 126, 195, 1, -1, -0.7853981633974483, 1.4142135623730951
496, 85, 304, 130, 306, 130, -2, 0, 3.141592653589793, 2.0
496, 88, 311, 117, 313, 118, -2, -1, -2.677945044588987, 2.23606797749979
496, 94, 152, 209, 151, 210, 1, -1, -0.7853981633974483, 1.4142135623730951
496, 120, 324, 120, 326, 121, -2, -1, -2.677945044588987, 2.23606797749979
496, 128, 140, 212, 142, 212, -2, 0, 3.141592653589793, 2.0
497, 54, 258, 137, 260, 138, -2, -1, -2.677945044588987, 2.23606797749979
497, 67, 303, 131, 304, 130, -1, 1, 2.356194490192345, 1.4142135623730951
498, 33, 165, 216, 167, 215, -2, 1, 2.677945044588987, 2.23606797749979
498, 43, 256, 137, 258, 137, -2, 0, 3.141592653589793, 2.0
498, 55, 301, 131, 303, 131, -2, 0, 3.141592653589793, 2.0
499, 3, 213, 155, 214, 154, -1, 1, 2.356194490192345, 1.4142135623730951
499, 20, 460, 119, 462, 119, -2, 0, 3.141592653589793, 2.0
