frame,i,x1,y1,x2,y2,x,y,angle,size
75, 0, 19, 77, 18, 78, 1, -1, -0.7853981633974483, 1.4142135623730951
75, 9, 15, 40, 16, 42, -1, -2, -2.0344439357957027, 2.23606797749979
78, 1, 10, 61, 9, 62, 1, -1, -0.7853981633974483, 1.4142135623730951
82, 5, 9, 87, 8, 88, 1, -1, -0.7853981633974483, 1.4142135623730951
84, 3, 23, 54, 21, 54, 2, 0, 0.0, 2.0
84, 4, 10, 85, 9, 86, 1, -1, -0.7853981633974483, 1.4142135623730951
89, 6, 5, 88, 4, 89, 1, -1, -0.7853981633974483, 1.4142135623730951
94, 0, 23, 74, 21, 74, 2, 0, 0.0, 2.0
99, 3, 7, 46, 6, 47, 1, -1, -0.7853981633974483, 1.4142135623730951
104, 3, 8, 48, 7, 49, 1, -1, -0.7853981633974483, 1.4142135623730951
107, 0, 23, 77, 22, 78, 1, -1, -0.7853981633974483, 1.4142135623730951
111, 7, 15, 86, 14, 87, 1, -1, -0.7853981633974483, 1.4142135623730951
112, 5, 28, 50, 27, 51, 1, -1, -0.7853981633974483, 1.4142135623730951
113, 5, 28, 48, 28, 50, 0, -2, -1.5707963267948966, 2.0
115, 4, 16, 27, 15, 28, 1, -1, -0.7853981633974483, 1.4142135623730951
118, 6, 14, 16, 12, 16, 2, 0, 0.0, 2.0
120, 3, 4, 40, 6, 40, -2, 0, 3.141592653589793, 2.0
120, 11, 3, 92, 4, 94, -1, -2, -2.0344439357957027, 2.23606797749979
125, 6, 3, 46, 2, 47, 1, -1, -0.7853981633974483, 1.4142135623730951
127, 9, 18, 31, 19, 30, -1, 1, 2.356194490192345, 1.4142135623730951
127, 11, 5, 77, 4, 78, 1, -1, -0.7853981633974483, 1.4142135623730951
130, 8, 11, 45, 10, 46, 1, -1, -0.7853981633974483, 1.4142135623730951
130, 16, 0, 29, 1, 31, -1, -2, -2.0344439357957027, 2.23606797749979
132, 7, 21, 86, 22, 85, -1, 1, 2.356194490192345, 1.4142135623730951
132, 13, 4, 94, 3, 95, 1, -1, -0.7853981633974483, 1.4142135623730951
132, 14, 4, 84, 6, 83, -2, 1, 2.677945044588987, 2.23606797749979
134, 5, 22, 84, 21, 85, 1, -1, -0.7853981633974483, 1.4142135623730951
138, 2, 15, 44, 14, 45, 1, -1, -0.7853981633974483, 1.4142135623730951
139, 0, 34, 44, 33, 46, 1, -2, -1.1071487177940904, 2.23606797749979
139, 2, 16, 43, 15, 44, 1, -1, -0.7853981633974483, 1.4142135623730951
139, 7, 21, 87, 20, 88, 1, -1, -0.7853981633974483, 1.4142135623730951
139, 8, 7, 17, 6, 18, 1, -1, -0.7853981633974483, 1.4142135623730951
143, 9, 8, 95, 7, 96, 1, -1, -0.7853981633974483, 1.4142135623730951
144, 3, 36, 44, 35, 45, 1, -1, -0.7853981633974483, 1.4142135623730951
144, 6, 7, 75, 4, 75, 3, 0, 0.0, 3.0
145, 5, 13, 37, 12, 38, 1, -1, -0.7853981633974483, 1.4142135623730951
145, 7, 8, 45, 7, 46, 1, -1, -0.7853981633974483, 1.4142135623730951
148, 4, 37, 45, 36, 46, 1, -1, -0.7853981633974483, 1.4142135623730951
148, 7, 0, 48, 2, 50, -2, -2, -2.356194490192345, 2.8284271247461903
149, 1, 24, 77, 26, 76, -2, 1, 2.677945044588987, 2.23606797749979
149, 8, 25, 33, 24, 34, 1, -1, -0.7853981633974483, 1.4142135623730951
150, 19, 13, 74, 12, 75, 1, -1, -0.7853981633974483, 1.4142135623730951
153, 0, 4, 39, 3, 40, 1, -1, -0.7853981633974483, 1.4142135623730951
156, 5, 31, 74, 29, 75, 2, -1, -0.4636476090008061, 2.23606797749979
156, 14, 21, 92, 20, 93, 1, -1, -0.7853981633974483, 1.4142135623730951
160, 6, 29, 88, 28, 89, 1, -1, -0.7853981633974483, 1.4142135623730951
160, 19, 24, 67, 23, 68, 1, -1, -0.7853981633974483, 1.4142135623730951
161, 7, 41, 43, 40, 44, 1, -1, -0.7853981633974483, 1.4142135623730951
162, 9, 10, 76, 9, 77, 1, -1, -0.7853981633974483, 1.4142135623730951
163, 9, 12, 76, 10, 76, 2, 0, 0.0, 2.0
165, 14, 15, 30, 14, 31, 1, -1, -0.7853981633974483, 1.4142135623730951
165, 15, 13, 97, 12, 98, 1, -1, -0.7853981633974483, 1.4142135623730951
166, 6, 23, 42, 22, 43, 1, -1, -0.7853981633974483, 1.4142135623730951
167, 7, 7, 49, 6, 50, 1, -1, -0.7853981633974483, 1.4142135623730951
168, 6, 23, 39, 23, 41, 0, -2, -1.5707963267948966, 2.0
168, 7, 9, 48, 7, 49, 2, -1, -0.4636476090008061, 2.23606797749979
171, 13, 6, 98, 5, 99, 1, -1, -0.7853981633974483, 1.4142135623730951
171, 14, 26, 43, 25, 44, 1, -1, -0.7853981633974483, 1.4142135623730951
174, 13, 27, 39, 27, 42, 0, -3, -1.5707963267948966, 3.0
175, 11, 32, 37, 31, 38, 1, -1, -0.7853981633974483, 1.4142135623730951
178, 7, 5, 76, 4, 77, 1, -1, -0.7853981633974483, 1.4142135623730951
180, 17, 19, 27, 17, 29, 2, -2, -0.7853981633974483, 2.8284271247461903
180, 20, 47, 29, 46, 30, 1, -1, -0.7853981633974483, 1.4142135623730951
181, 5, 46, 39, 45, 40, 1, -1, -0.7853981633974483, 1.4142135623730951
182, 0, 12, 49, 11, 50, 1, -1, -0.7853981633974483, 1.4142135623730951
182, 16, 20, 26, 19, 27, 1, -1, -0.7853981633974483, 1.4142135623730951
184, 5, 27, 40, 26, 41, 1, -1, -0.7853981633974483, 1.4142135623730951
184, 18, 26, 68, 27, 67, -1, 1, 2.356194490192345, 1.4142135623730951
184, 19, 26, 29, 25, 30, 1, -1, -0.7853981633974483, 1.4142135623730951
186, 7, 27, 82, 26, 83, 1, -1, -0.7853981633974483, 1.4142135623730951
189, 2, 14, 38, 13, 39, 1, -1, -0.7853981633974483, 1.4142135623730951
192, 4, 18, 79, 17, 80, 1, -1, -0.7853981633974483, 1.4142135623730951
192, 8, 48, 36, 48, 38, 0, -2, -1.5707963267948966, 2.0
193, 7, 49, 35, 48, 36, 1, -1, -0.7853981633974483, 1.4142135623730951
200, 17, 42, 34, 40, 33, 2, 1, 0.4636476090008061, 2.23606797749979
202, 17, 15, 16, 14, 17, 1, -1, -0.7853981633974483, 1.4142135623730951
204, 13, 16, 15, 15, 16, 1, -1, -0.7853981633974483, 1.4142135623730951
204, 14, 39, 89, 38, 90, 1, -1, -0.7853981633974483, 1.4142135623730951
206, 5, 51, 36, 51, 38, 0, -2, -1.5707963267948966, 2.0
207, 15, 41, 16, 40, 17, 1, -1, -0.7853981633974483, 1.4142135623730951
209, 5, 51, 31, 51, 34, 0, -3, -1.5707963267948966, 3.0
216, 12, 46, 90, 45, 91, 1, -1, -0.7853981633974483, 1.4142135623730951
216, 23, 29, 39, 28, 40, 1, -1, -0.7853981633974483, 1.4142135623730951
219, 2, 18, 43, 18, 45, 0, -2, -1.5707963267948966, 2.0
221, 18, 14, 89, 13, 90, 1, -1, -0.7853981633974483, 1.4142135623730951
222, 10, 17, 99, 16, 100, 1, -1, -0.7853981633974483, 1.4142135623730951
226, 16, 37, 38, 36, 39, 1, -1, -0.7853981633974483, 1.4142135623730951
227, 15, 35, 37, 37, 38, -2, -1, -2.677945044588987, 2.23606797749979
228, 15, 35, 15, 34, 16, 1, -1, -0.7853981633974483, 1.4142135623730951
228, 21, 39, 72, 38, 74, 1, -2, -1.1071487177940904, 2.23606797749979
228, 23, 30, 78, 29, 80, 1, -2, -1.1071487177940904, 2.23606797749979
230, 5, 59, 33, 58, 34, 1, -1, -0.7853981633974483, 1.4142135623730951
232, 5, 60, 31, 59, 32, 1, -1, -0.7853981633974483, 1.4142135623730951
232, 15, 18, 95, 17, 96, 1, -1, -0.7853981633974483, 1.4142135623730951
233, 8, 37, 38, 36, 39, 1, -1, -0.7853981633974483, 1.4142135623730951
234, 19, 37, 76, 38, 75, -1, 1, 2.356194490192345, 1.4142135623730951
235, 4, 23, 43, 22, 44, 1, -1, -0.7853981633974483, 1.4142135623730951
237, 13, 62, 83, 61, 84, 1, -1, -0.7853981633974483, 1.4142135623730951
237, 20, 36, 99, 35, 100, 1, -1, -0.7853981633974483, 1.4142135623730951
238, 3, 22, 43, 23, 42, -1, 1, 2.356194490192345, 1.4142135623730951
240, 14, 14, 79, 13, 80, 1, -1, -0.7853981633974483, 1.4142135623730951
243, 0, 0, 77, 1, 76, -1, 1, 2.356194490192345, 1.4142135623730951
245, 19, 52, 29, 51, 30, 1, -1, -0.7853981633974483, 1.4142135623730951
246, 3, 13, 86, 12, 87, 1, -1, -0.7853981633974483, 1.4142135623730951
255, 13, 19, 72, 18, 73, 1, -1, -0.7853981633974483, 1.4142135623730951
256, 1, 6, 75, 5, 76, 1, -1, -0.7853981633974483, 1.4142135623730951
257, 6, 30, 19, 29, 20, 1, -1, -0.7853981633974483, 1.4142135623730951
258, 16, 16, 16, 14, 16, 2, 0, 0.0, 2.0
258, 18, 4, 38, 3, 40, 1, -2, -1.1071487177940904, 2.23606797749979
260, 24, 6, 40, 5, 41, 1, -1, -0.7853981633974483, 1.4142135623730951
261, 29, 16, 96, 14, 97, 2, -1, -0.4636476090008061, 2.23606797749979
262, 10, 28, 98, 27, 99, 1, -1, -0.7853981633974483, 1.4142135623730951
264, 7, 32, 41, 30, 42, 2, -1, -0.4636476090008061, 2.23606797749979
265, 26, 58, 91, 57, 92, 1, -1, -0.7853981633974483, 1.4142135623730951
266, 4, 27, 42, 30, 42, -3, 0, 3.141592653589793, 3.0
267, 8, 19, 41, 18, 42, 1, -1, -0.7853981633974483, 1.4142135623730951
268, 8, 20, 40, 19, 41, 1, -1, -0.7853981633974483, 1.4142135623730951
270, 1, 12, 28, 11, 29, 1, -1, -0.7853981633974483, 1.4142135623730951
279, 5, 5, 76, 4, 78, 1, -2, -1.1071487177940904, 2.23606797749979
284, 8, 36, 80, 35, 81, 1, -1, -0.7853981633974483, 1.4142135623730951
285, 20, 31, 95, 30, 96, 1, -1, -0.7853981633974483, 1.4142135623730951
290, 9, 35, 96, 34, 97, 1, -1, -0.7853981633974483, 1.4142135623730951
290, 14, 44, 38, 43, 39, 1, -1, -0.7853981633974483, 1.4142135623730951
292, 22, 12, 98, 11, 99, 1, -1, -0.7853981633974483, 1.4142135623730951
294, 25, 49, 79, 51, 78, -2, 1, 2.677945044588987, 2.23606797749979
297, 11, 36, 83, 35, 84, 1, -1, -0.7853981633974483, 1.4142135623730951
298, 19, 3, 98, 2, 99, 1, -1, -0.7853981633974483, 1.4142135623730951
299, 1, 19, 91, 20, 90, -1, 1, 2.356194490192345, 1.4142135623730951
299, 5, 14, 97, 13, 98, 1, -1, -0.7853981633974483, 1.4142135623730951
299, 19, 4, 97, 3, 98, 1, -1, -0.7853981633974483, 1.4142135623730951
300, 22, 5, 45, 6, 47, -1, -2, -2.0344439357957027, 2.23606797749979
300, 30, 6, 17, 5, 18, 1, -1, -0.7853981633974483, 1.4142135623730951
301, 27, 38, 100, 37, 101, 1, -1, -0.7853981633974483, 1.4142135623730951
301, 29, 7, 16, 6, 17, 1, -1, -0.7853981633974483, 1.4142135623730951
302, 16, 80, 86, 79, 87, 1, -1, -0.7853981633974483, 1.4142135623730951
303, 25, 39, 99, 38, 100, 1, -1, -0.7853981633974483, 1.4142135623730951
304, 0, 18, 74, 17, 75, 1, -1, -0.7853981633974483, 1.4142135623730951
304, 24, 6, 99, 5, 100, 1, -1, -0.7853981633974483, 1.4142135623730951
305, 32, 39, 76, 38, 77, 1, -1, -0.7853981633974483, 1.4142135623730951
308, 2, 57, 32, 56, 33, 1, -1, -0.7853981633974483, 1.4142135623730951
310, 29, 52, 38, 51, 39, 1, -1, -0.7853981633974483, 1.4142135623730951
312, 14, 50, 30, 49, 31, 1, -1, -0.7853981633974483, 1.4142135623730951
312, 22, 79, 28, 78, 29, 1, -1, -0.7853981633974483, 1.4142135623730951
314, 7, 66, 17, 68, 17, -2, 0, 3.141592653589793, 2.0
314, 8, 60, 15, 59, 16, 1, -1, -0.7853981633974483, 1.4142135623730951
315, 32, 5, 34, 4, 35, 1, -1, -0.7853981633974483, 1.4142135623730951
316, 24, 39, 95, 38, 96, 1, -1, -0.7853981633974483, 1.4142135623730951
317, 29, 31, 21, 30, 22, 1, -1, -0.7853981633974483, 1.4142135623730951
318, 3, 30, 39, 29, 40, 1, -1, -0.7853981633974483, 1.4142135623730951
318, 5, 42, 83, 41, 84, 1, -1, -0.7853981633974483, 1.4142135623730951
318, 9, 40, 37, 42, 38, -2, -1, -2.677945044588987, 2.23606797749979
318, 14, 36, 79, 35, 80, 1, -1, -0.7853981633974483, 1.4142135623730951
319, 8, 41, 36, 40, 37, 1, -1, -0.7853981633974483, 1.4142135623730951
319, 11, 66, 20, 69, 21, -3, -1, -2.819842099193151, 3.1622776601683795
319, 13, 34, 78, 36, 79, -2, -1, -2.677945044588987, 2.23606797749979
319, 19, 79, 29, 78, 30, 1, -1, -0.7853981633974483, 1.4142135623730951
319, 24, 5, 90, 4, 89, 1, 1, 0.7853981633974483, 1.4142135623730951
320, 20, 29, 41, 28, 42, 1, -1, -0.7853981633974483, 1.4142135623730951
327, 16, 14, 41, 13, 42, 1, -1, -0.7853981633974483, 1.4142135623730951
327, 28, 66, 93, 64, 94, 2, -1, -0.4636476090008061, 2.23606797749979
328, 20, 4, 92, 3, 93, 1, -1, -0.7853981633974483, 1.4142135623730951
329, 6, 75, 97, 74, 98, 1, -1, -0.7853981633974483, 1.4142135623730951
329, 11, 15, 39, 14, 40, 1, -1, -0.7853981633974483, 1.4142135623730951
330, 30, 29, 32, 28, 33, 1, -1, -0.7853981633974483, 1.4142135623730951
331, 29, 30, 31, 29, 32, 1, -1, -0.7853981633974483, 1.4142135623730951
332, 0, 24, 76, 23, 77, 1, -1, -0.7853981633974483, 1.4142135623730951
332, 37, 38, 93, 37, 94, 1, -1, -0.7853981633974483, 1.4142135623730951
333, 32, 70, 93, 69, 94, 1, -1, -0.7853981633974483, 1.4142135623730951
334, 22, 70, 22, 69, 23, 1, -1, -0.7853981633974483, 1.4142135623730951
335, 26, 12, 34, 11, 35, 1, -1, -0.7853981633974483, 1.4142135623730951
336, 22, 53, 82, 52, 83, 1, -1, -0.7853981633974483, 1.4142135623730951
337, 22, 52, 83, 53, 82, -1, 1, 2.356194490192345, 1.4142135623730951
345, 13, 14, 46, 13, 47, 1, -1, -0.7853981633974483, 1.4142135623730951
347, 13, 55, 82, 54, 83, 1, -1, -0.7853981633974483, 1.4142135623730951
348, 8, 79, 19, 78, 20, 1, -1, -0.7853981633974483, 1.4142135623730951
348, 20, 89, 29, 88, 30, 1, -1, -0.7853981633974483, 1.4142135623730951
348, 24, 40, 76, 41, 78, -1, -2, -2.0344439357957027, 2.23606797749979
352, 24, 90, 29, 89, 30, 1, -1, -0.7853981633974483, 1.4142135623730951
354, 4, 68, 87, 67, 88, 1, -1, -0.7853981633974483, 1.4142135623730951
354, 7, 23, 38, 22, 39, 1, -1, -0.7853981633974483, 1.4142135623730951
355, 11, 71, 86, 70, 87, 1, -1, -0.7853981633974483, 1.4142135623730951
356, 2, 10, 42, 9, 43, 1, -1, -0.7853981633974483, 1.4142135623730951
357, 27, 13, 17, 12, 18, 1, -1, -0.7853981633974483, 1.4142135623730951
358, 15, 12, 91, 11, 92, 1, -1, -0.7853981633974483, 1.4142135623730951
360, 0, 0, 95, 1, 94, -1, 1, 2.356194490192345, 1.4142135623730951
364, 12, 32, 21, 31, 22, 1, -1, -0.7853981633974483, 1.4142135623730951
364, 14, 21, 98, 20, 100, 1, -2, -1.1071487177940904, 2.23606797749979
364, 21, 55, 83, 54, 84, 1, -1, -0.7853981633974483, 1.4142135623730951
366, 3, 40, 36, 41, 38, -1, -2, -2.0344439357957027, 2.23606797749979
368, 13, 37, 90, 36, 91, 1, -1, -0.7853981633974483, 1.4142135623730951
370, 18, 46, 82, 45, 83, 1, -1, -0.7853981633974483, 1.4142135623730951
371, 14, 54, 84, 53, 85, 1, -1, -0.7853981633974483, 1.4142135623730951
372, 4, 63, 17, 62, 18, 1, -1, -0.7853981633974483, 1.4142135623730951
372, 32, 67, 81, 67, 83, 0, -2, -1.5707963267948966, 2.0
374, 0, 41, 28, 40, 29, 1, -1, -0.7853981633974483, 1.4142135623730951
374, 21, 71, 31, 70, 32, 1, -1, -0.7853981633974483, 1.4142135623730951
375, 6, 39, 97, 38, 98, 1, -1, -0.7853981633974483, 1.4142135623730951
378, 6, 54, 34, 53, 35, 1, -1, -0.7853981633974483, 1.4142135623730951
378, 8, 36, 75, 35, 76, 1, -1, -0.7853981633974483, 1.4142135623730951
383, 4, 8, 82, 7, 83, 1, -1, -0.7853981633974483, 1.4142135623730951
383, 9, 40, 97, 40, 99, 0, -2, -1.5707963267948966, 2.0
383, 34, 83, 92, 82, 93, 1, -1, -0.7853981633974483, 1.4142135623730951
384, 1, 65, 17, 64, 18, 1, -1, -0.7853981633974483, 1.4142135623730951
384, 5, 41, 88, 41, 90, 0, -2, -1.5707963267948966, 2.0
386, 27, 22, 30, 21, 31, 1, -1, -0.7853981633974483, 1.4142135623730951
388, 23, 23, 28, 22, 29, 1, -1, -0.7853981633974483, 1.4142135623730951
391, 27, 84, 88, 83, 89, 1, -1, -0.7853981633974483, 1.4142135623730951
396, 3, 109, 86, 108, 87, 1, -1, -0.7853981633974483, 1.4142135623730951
396, 7, 46, 36, 46, 38, 0, -2, -1.5707963267948966, 2.0
398, 27, 59, 21, 57, 21, 2, 0, 0.0, 2.0
399, 1, 8, 97, 7, 98, 1, -1, -0.7853981633974483, 1.4142135623730951
399, 26, 84, 86, 83, 87, 1, -1, -0.7853981633974483, 1.4142135623730951
400, 9, 29, 42, 28, 43, 1, -1, -0.7853981633974483, 1.4142135623730951
400, 24, 22, 31, 21, 32, 1, -1, -0.7853981633974483, 1.4142135623730951
401, 10, 11, 85, 10, 86, 1, -1, -0.7853981633974483, 1.4142135623730951
402, 8, 30, 41, 29, 42, 1, -1, -0.7853981633974483, 1.4142135623730951
403, 7, 31, 40, 30, 41, 1, -1, -0.7853981633974483, 1.4142135623730951
405, 35, 20, 82, 19, 84, 1, -2, -1.1071487177940904, 2.23606797749979
406, 14, 42, 76, 41, 77, 1, -1, -0.7853981633974483, 1.4142135623730951
406, 34, 20, 76, 19, 77, 1, -1, -0.7853981633974483, 1.4142135623730951
408, 9, 18, 38, 20, 38, -2, 0, 3.141592653589793, 2.0
408, 13, 35, 36, 35, 38, 0, -2, -1.5707963267948966, 2.0
408, 19, 60, 85, 62, 86, -2, -1, -2.677945044588987, 2.23606797749979
408, 25, 97, 99, 94, 98, 3, 1, 0.3217505543966422, 3.1622776601683795
411, 27, 100, 17, 99, 18, 1, -1, -0.7853981633974483, 1.4142135623730951
413, 23, 101, 15, 100, 16, 1, -1, -0.7853981633974483, 1.4142135623730951
414, 6, 48, 27, 47, 28, 1, -1, -0.7853981633974483, 1.4142135623730951
416, 21, 110, 29, 108, 30, 2, -1, -0.4636476090008061, 2.23606797749979
416, 30, 91, 85, 90, 86, 1, -1, -0.7853981633974483, 1.4142135623730951
416, 38, 4, 100, 3, 101, 1, -1, -0.7853981633974483, 1.4142135623730951
417, 4, 33, 41, 32, 42, 1, -1, -0.7853981633974483, 1.4142135623730951
417, 33, 84, 88, 82, 89, 2, -1, -0.4636476090008061, 2.23606797749979
419, 29, 86, 87, 84, 88, 2, -1, -0.4636476090008061, 2.23606797749979
420, 13, 70, 85, 69, 86, 1, -1, -0.7853981633974483, 1.4142135623730951
420, 30, 82, 90, 84, 89, -2, 1, 2.677945044588987, 2.23606797749979
425, 20, 112, 30, 111, 31, 1, -1, -0.7853981633974483, 1.4142135623730951
429, 19, 5, 81, 4, 82, 1, -1, -0.7853981633974483, 1.4142135623730951
431, 21, 46, 33, 45, 34, 1, -1, -0.7853981633974483, 1.4142135623730951
434, 14, 35, 40, 34, 41, 1, -1, -0.7853981633974483, 1.4142135623730951
434, 21, 18, 20, 17, 21, 1, -1, -0.7853981633974483, 1.4142135623730951
437, 21, 71, 83, 70, 84, 1, -1, -0.7853981633974483, 1.4142135623730951
439, 18, 71, 82, 70, 83, 1, -1, -0.7853981633974483, 1.4142135623730951
443, 17, 49, 31, 48, 32, 1, -1, -0.7853981633974483, 1.4142135623730951
444, 6, 18, 98, 19, 97, -1, 1, 2.356194490192345, 1.4142135623730951
444, 13, 7, 80, 6, 81, 1, -1, -0.7853981633974483, 1.4142135623730951
444, 19, 107, 97, 106, 98, 1, -1, -0.7853981633974483, 1.4142135623730951
446, 0, 71, 19, 70, 20, 1, -1, -0.7853981633974483, 1.4142135623730951
447, 14, 57, 26, 57, 28, 0, -2, -1.5707963267948966, 2.0
447, 16, 108, 16, 107, 17, 1, -1, -0.7853981633974483, 1.4142135623730951
448, 16, 106, 16, 108, 16, -2, 0, 3.141592653589793, 2.0
449, 1, 92, 15, 95, 15, -3, 0, 3.141592653589793, 3.0
449, 22, 85, 30, 84, 31, 1, -1, -0.7853981633974483, 1.4142135623730951
450, 23, 92, 88, 91, 89, 1, -1, -0.7853981633974483, 1.4142135623730951
451, 22, 93, 87, 92, 88, 1, -1, -0.7853981633974483, 1.4142135623730951
453, 18, 95, 86, 94, 87, 1, -1, -0.7853981633974483, 1.4142135623730951
456, 8, 42, 42, 41, 41, 1, 1, 0.7853981633974483, 1.4142135623730951
457, 18, 111, 17, 110, 18, 1, -1, -0.7853981633974483, 1.4142135623730951
458, 15, 33, 39, 31, 39, 2, 0, 0.0, 2.0
459, 17, 121, 30, 120, 31, 1, -1, -0.7853981633974483, 1.4142135623730951
460, 18, 24, 85, 23, 86, 1, -1, -0.7853981633974483, 1.4142135623730951
462, 11, 15, 28, 14, 29, 1, -1, -0.7853981633974483, 1.4142135623730951
462, 17, 68, 16, 67, 17, 1, -1, -0.7853981633974483, 1.4142135623730951
464, 6, 37, 98, 37, 100, 0, -2, -1.5707963267948966, 2.0
465, 27, 74, 90, 73, 91, 1, -1, -0.7853981633974483, 1.4142135623730951
467, 24, 97, 87, 96, 88, 1, -1, -0.7853981633974483, 1.4142135623730951
468, 8, 48, 77, 48, 79, 0, -2, -1.5707963267948966, 2.0
468, 17, 32, 37, 30, 38, 2, -1, -0.4636476090008061, 2.23606797749979
474, 9, 14, 80, 12, 81, 2, -1, -0.4636476090008061, 2.23606797749979
474, 23, 126, 27, 125, 28, 1, -1, -0.7853981633974483, 1.4142135623730951
477, 21, 71, 17, 70, 18, 1, -1, -0.7853981633974483, 1.4142135623730951
479, 12, 117, 16, 116, 17, 1, -1, -0.7853981633974483, 1.4142135623730951
479, 15, 71, 16, 70, 17, 1, -1, -0.7853981633974483, 1.4142135623730951
484, 16, 127, 29, 126, 30, 1, -1, -0.7853981633974483, 1.4142135623730951
485, 18, 102, 88, 101, 89, 1, -1, -0.7853981633974483, 1.4142135623730951
487, 16, 104, 87, 103, 88, 1, -1, -0.7853981633974483, 1.4142135623730951
487, 29, 48, 24, 47, 25, 1, -1, -0.7853981633974483, 1.4142135623730951
489, 1, 55, 97, 54, 98, 1, -1, -0.7853981633974483, 1.4142135623730951
490, 24, 14, 40, 13, 41, 1, -1, -0.7853981633974483, 1.4142135623730951
492, 14, 138, 85, 137, 86, 1, -1, -0.7853981633974483, 1.4142135623730951
492, 28, 103, 87, 102, 88, 1, -1, -0.7853981633974483, 1.4142135623730951
499, 16, 133, 29, 132, 30, 1, -1, -0.7853981633974483, 1.4142135623730951
501, 30, 106, 87, 105, 88, 1, -1, -0.7853981633974483, 1.4142135623730951
502, 17, 20, 82, 19, 83, 1, -1, -0.7853981633974483, 1.4142135623730951
503, 1, 19, 20, 18, 21, 1, -1, -0.7853981633974483, 1.4142135623730951
503, 12, 53, 82, 51, 82, 2, 0, 0.0, 2.0
503, 30, 101, 96, 100, 97, 1, -1, -0.7853981633974483, 1.4142135623730951
504, 11, 53, 80, 53, 82, 0, -2, -1.5707963267948966, 2.0
504, 27, 63, 34, 63, 36, 0, -2, -1.5707963267948966, 2.0
504, 28, 102, 95, 101, 96, 1, -1, -0.7853981633974483, 1.4142135623730951
506, 33, 18, 88, 17, 89, 1, -1, -0.7853981633974483, 1.4142135623730951
513, 24, 114, 83, 116, 84, -2, -1, -2.677945044588987, 2.23606797749979
515, 7, 50, 100, 49, 101, 1, -1, -0.7853981633974483, 1.4142135623730951
515, 21, 139, 30, 138, 31, 1, -1, -0.7853981633974483, 1.4142135623730951
516, 10, 116, 23, 118, 22, -2, 1, 2.677945044588987, 2.23606797749979
517, 9, 114, 22, 116, 23, -2, -1, -2.677945044588987, 2.23606797749979
519, 12, 142, 28, 139, 29, 3, -1, -0.3217505543966422, 3.1622776601683795
521, 23, 113, 87, 112, 88, 1, -1, -0.7853981633974483, 1.4142135623730951
523, 8, 45, 98, 44, 99, 1, -1, -0.7853981633974483, 1.4142135623730951
525, 30, 75, 90, 74, 89, 1, 1, 0.7853981633974483, 1.4142135623730951
526, 14, 11, 94, 10, 95, 1, -1, -0.7853981633974483, 1.4142135623730951
528, 3, 149, 86, 148, 87, 1, -1, -0.7853981633974483, 1.4142135623730951
528, 17, 62, 23, 60, 23, 2, 0, 0.0, 2.0
532, 21, 8, 69, 7, 70, 1, -1, -0.7853981633974483, 1.4142135623730951
533, 21, 9, 68, 8, 69, 1, -1, -0.7853981633974483, 1.4142135623730951
534, 25, 70, 91, 69, 92, 1, -1, -0.7853981633974483, 1.4142135623730951
535, 30, 3, 100, 2, 101, 1, -1, -0.7853981633974483, 1.4142135623730951
538, 22, 118, 86, 117, 87, 1, -1, -0.7853981633974483, 1.4142135623730951
539, 15, 57, 23, 60, 24, -3, -1, -2.819842099193151, 3.1622776601683795
542, 21, 5, 24, 4, 25, 1, -1, -0.7853981633974483, 1.4142135623730951
544, 11, 124, 15, 122, 15, 2, 0, 0.0, 2.0
544, 19, 136, 17, 135, 18, 1, -1, -0.7853981633974483, 1.4142135623730951
544, 21, 117, 88, 116, 89, 1, -1, -0.7853981633974483, 1.4142135623730951
545, 21, 25, 83, 24, 84, 1, -1, -0.7853981633974483, 1.4142135623730951
545, 27, 148, 31, 147, 32, 1, -1, -0.7853981633974483, 1.4142135623730951
545, 31, 82, 30, 81, 31, 1, -1, -0.7853981633974483, 1.4142135623730951
548, 15, 26, 82, 25, 83, 1, -1, -0.7853981633974483, 1.4142135623730951
550, 18, 16, 94, 15, 95, 1, -1, -0.7853981633974483, 1.4142135623730951
552, 19, 139, 20, 138, 21, 1, -1, -0.7853981633974483, 1.4142135623730951
552, 20, 64, 22, 63, 23, 1, -1, -0.7853981633974483, 1.4142135623730951
556, 28, 65, 22, 63, 23, 2, -1, -0.4636476090008061, 2.23606797749979
563, 5, 131, 22, 130, 23, 1, -1, -0.7853981633974483, 1.4142135623730951
566, 18, 14, 35, 13, 36, 1, -1, -0.7853981633974483, 1.4142135623730951
575, 19, 78, 24, 77, 25, 1, -1, -0.7853981633974483, 1.4142135623730951
576, 20, 76, 86, 75, 87, 1, -1, -0.7853981633974483, 1.4142135623730951
578, 16, 78, 22, 77, 23, 1, -1, -0.7853981633974483, 1.4142135623730951
579, 15, 134, 22, 133, 23, 1, -1, -0.7853981633974483, 1.4142135623730951
586, 19, 2, 22, 4, 22, -2, 0, 3.141592653589793, 2.0
589, 8, 90, 18, 89, 19, 1, -1, -0.7853981633974483, 1.4142135623730951
591, 25, 105, 88, 104, 89, 1, -1, -0.7853981633974483, 1.4142135623730951
592, 28, 79, 97, 78, 98, 1, -1, -0.7853981633974483, 1.4142135623730951
593, 19, 130, 89, 129, 90, 1, -1, -0.7853981633974483, 1.4142135623730951
593, 26, 9, 96, 8, 97, 1, -1, -0.7853981633974483, 1.4142135623730951
594, 24, 103, 86, 105, 86, -2, 0, 3.141592653589793, 2.0
595, 19, 143, 86, 142, 87, 1, -1, -0.7853981633974483, 1.4142135623730951
600, 17, 96, 20, 95, 21, 1, -1, -0.7853981633974483, 1.4142135623730951
600, 18, 20, 35, 19, 36, 1, -1, -0.7853981633974483, 1.4142135623730951
605, 29, 154, 19, 153, 20, 1, -1, -0.7853981633974483, 1.4142135623730951
609, 8, 141, 16, 140, 17, 1, -1, -0.7853981633974483, 1.4142135623730951
610, 33, 11, 80, 10, 81, 1, -1, -0.7853981633974483, 1.4142135623730951
610, 35, 12, 68, 11, 69, 1, -1, -0.7853981633974483, 1.4142135623730951
614, 12, 143, 16, 142, 17, 1, -1, -0.7853981633974483, 1.4142135623730951
615, 22, 11, 98, 10, 99, 1, -1, -0.7853981633974483, 1.4142135623730951
615, 23, 158, 19, 157, 20, 1, -1, -0.7853981633974483, 1.4142135623730951
618, 8, 146, 23, 145, 24, 1, -1, -0.7853981633974483, 1.4142135623730951
623, 13, 73, 87, 72, 88, 1, -1, -0.7853981633974483, 1.4142135623730951
624, 7, 101, 18, 100, 19, 1, -1, -0.7853981633974483, 1.4142135623730951
628, 6, 98, 19, 100, 19, -2, 0, 3.141592653589793, 2.0
628, 23, 141, 89, 140, 90, 1, -1, -0.7853981633974483, 1.4142135623730951
629, 14, 74, 85, 73, 86, 1, -1, -0.7853981633974483, 1.4142135623730951
631, 28, 58, 78, 58, 80, 0, -2, -1.5707963267948966, 2.0
631, 32, 153, 87, 152, 88, 1, -1, -0.7853981633974483, 1.4142135623730951
632, 14, 150, 23, 149, 24, 1, -1, -0.7853981633974483, 1.4142135623730951
634, 18, 90, 97, 89, 98, 1, -1, -0.7853981633974483, 1.4142135623730951
634, 27, 123, 15, 125, 15, -2, 0, 3.141592653589793, 2.0
634, 33, 133, 97, 132, 98, 1, -1, -0.7853981633974483, 1.4142135623730951
635, 28, 154, 85, 153, 86, 1, -1, -0.7853981633974483, 1.4142135623730951
636, 38, 14, 81, 16, 81, -2, 0, 3.141592653589793, 2.0
639, 21, 115, 89, 114, 90, 1, -1, -0.7853981633974483, 1.4142135623730951
640, 19, 71, 31, 70, 32, 1, -1, -0.7853981633974483, 1.4142135623730951
642, 0, 120, 18, 119, 19, 1, -1, -0.7853981633974483, 1.4142135623730951
643, 19, 94, 85, 93, 86, 1, -1, -0.7853981633974483, 1.4142135623730951
645, 7, 49, 100, 48, 101, 1, -1, -0.7853981633974483, 1.4142135623730951
645, 26, 52, 91, 51, 92, 1, -1, -0.7853981633974483, 1.4142135623730951
647, 33, 26, 69, 25, 70, 1, -1, -0.7853981633974483, 1.4142135623730951
648, 26, 86, 21, 85, 22, 1, -1, -0.7853981633974483, 1.4142135623730951
649, 16, 3, 80, 2, 81, 1, -1, -0.7853981633974483, 1.4142135623730951
650, 10, 13, 90, 12, 91, 1, -1, -0.7853981633974483, 1.4142135623730951
651, 39, 156, 83, 155, 84, 1, -1, -0.7853981633974483, 1.4142135623730951
652, 28, 72, 30, 74, 30, -2, 0, 3.141592653589793, 2.0
652, 35, 107, 29, 106, 30, 1, -1, -0.7853981633974483, 1.4142135623730951
653, 14, 92, 27, 91, 28, 1, -1, -0.7853981633974483, 1.4142135623730951
653, 29, 96, 23, 95, 24, 1, -1, -0.7853981633974483, 1.4142135623730951
653, 33, 154, 81, 156, 82, -2, -1, -2.677945044588987, 2.23606797749979
654, 29, 155, 80, 154, 81, 1, -1, -0.7853981633974483, 1.4142135623730951
658, 9, 109, 20, 108, 21, 1, -1, -0.7853981633974483, 1.4142135623730951
660, 29, 17, 97, 15, 99, 2, -2, -0.7853981633974483, 2.8284271247461903
662, 29, 49, 87, 48, 88, 1, -1, -0.7853981633974483, 1.4142135623730951
663, 13, 78, 84, 80, 85, -2, -1, -2.677945044588987, 2.23606797749979
664, 5, 111, 17, 110, 18, 1, -1, -0.7853981633974483, 1.4142135623730951
664, 6, 94, 27, 93, 28, 1, -1, -0.7853981633974483, 1.4142135623730951
664, 8, 68, 98, 67, 99, 1, -1, -0.7853981633974483, 1.4142135623730951
664, 25, 74, 24, 75, 26, -1, -2, -2.0344439357957027, 2.23606797749979
666, 26, 112, 29, 111, 30, 1, -1, -0.7853981633974483, 1.4142135623730951
668, 28, 157, 22, 157, 24, 0, -2, -1.5707963267948966, 2.0
671, 37, 5, 43, 4, 44, 1, -1, -0.7853981633974483, 1.4142135623730951
672, 11, 6, 69, 5, 70, 1, -1, -0.7853981633974483, 1.4142135623730951
672, 14, 113, 30, 112, 31, 1, -1, -0.7853981633974483, 1.4142135623730951
672, 19, 98, 86, 97, 87, 1, -1, -0.7853981633974483, 1.4142135623730951
672, 35, 3, 43, 5, 43, -2, 0, 3.141592653589793, 2.0
673, 8, 113, 17, 112, 18, 1, -1, -0.7853981633974483, 1.4142135623730951
673, 25, 119, 30, 121, 30, -2, 0, 3.141592653589793, 2.0
675, 20, 126, 90, 125, 91, 1, -1, -0.7853981633974483, 1.4142135623730951
677, 8, 85, 84, 83, 85, 2, -1, -0.4636476090008061, 2.23606797749979
681, 25, 104, 23, 103, 24, 1, -1, -0.7853981633974483, 1.4142135623730951
683, 5, 115, 20, 114, 21, 1, -1, -0.7853981633974483, 1.4142135623730951
683, 15, 85, 86, 84, 87, 1, -1, -0.7853981633974483, 1.4142135623730951
683, 17, 98, 27, 97, 28, 1, -1, -0.7853981633974483, 1.4142135623730951
684, 1, 131, 18, 130, 19, 1, -1, -0.7853981633974483, 1.4142135623730951
684, 5, 53, 97, 55, 98, -2, -1, -2.677945044588987, 2.23606797749979
684, 13, 112, 31, 114, 31, -2, 0, 3.141592653589793, 2.0
686, 38, 127, 31, 126, 32, 1, -1, -0.7853981633974483, 1.4142135623730951
687, 27, 108, 28, 107, 29, 1, -1, -0.7853981633974483, 1.4142135623730951
687, 28, 84, 97, 83, 98, 1, -1, -0.7853981633974483, 1.4142135623730951
692, 31, 117, 83, 116, 84, 1, -1, -0.7853981633974483, 1.4142135623730951
694, 29, 114, 82, 116, 83, -2, -1, -2.677945044588987, 2.23606797749979
695, 25, 51, 89, 50, 90, 1, -1, -0.7853981633974483, 1.4142135623730951
696, 28, 78, 28, 77, 29, 1, -1, -0.7853981633974483, 1.4142135623730951
703, 3, 136, 19, 135, 20, 1, -1, -0.7853981633974483, 1.4142135623730951
705, 32, 9, 32, 11, 32, -2, 0, 3.141592653589793, 2.0
707, 22, 98, 24, 97, 25, 1, -1, -0.7853981633974483, 1.4142135623730951
708, 8, 90, 85, 89, 86, 1, -1, -0.7853981633974483, 1.4142135623730951
717, 17, 125, 28, 124, 29, 1, -1, -0.7853981633974483, 1.4142135623730951
718, 17, 82, 28, 81, 29, 1, -1, -0.7853981633974483, 1.4142135623730951
719, 4, 137, 18, 139, 18, -2, 0, 3.141592653589793, 2.0
723, 0, 45, 15, 44, 16, 1, -1, -0.7853981633974483, 1.4142135623730951
725, 19, 10, 76, 9, 77, 1, -1, -0.7853981633974483, 1.4142135623730951
725, 23, 141, 91, 139, 91, 2, 0, 0.0, 2.0
728, 18, 54, 90, 53, 91, 1, -1, -0.7853981633974483, 1.4142135623730951
729, 7, 113, 85, 112, 86, 1, -1, -0.7853981633974483, 1.4142135623730951
730, 11, 96, 86, 95, 87, 1, -1, -0.7853981633974483, 1.4142135623730951
734, 8, 97, 83, 96, 84, 1, -1, -0.7853981633974483, 1.4142135623730951
734, 14, 12, 32, 11, 33, 1, -1, -0.7853981633974483, 1.4142135623730951
735, 5, 146, 20, 145, 21, 1, -1, -0.7853981633974483, 1.4142135623730951
744, 8, 116, 86, 115, 87, 1, -1, -0.7853981633974483, 1.4142135623730951
744, 9, 112, 26, 113, 28, -1, -2, -2.0344439357957027, 2.23606797749979
744, 23, 3, 27, 2, 28, 1, -1, -0.7853981633974483, 1.4142135623730951
748, 0, 49, 15, 51, 15, -2, 0, 3.141592653589793, 2.0
748, 22, 132, 29, 131, 30, 1, -1, -0.7853981633974483, 1.4142135623730951
749, 4, 116, 28, 114, 28, 2, 0, 0.0, 2.0
749, 23, 20, 78, 19, 79, 1, -1, -0.7853981633974483, 1.4142135623730951
751, 4, 150, 21, 149, 22, 1, -1, -0.7853981633974483, 1.4142135623730951
754, 0, 43, 15, 45, 15, -2, 0, 3.141592653589793, 2.0
759, 6, 129, 24, 131, 24, -2, 0, 3.141592653589793, 2.0
760, 22, 54, 92, 56, 92, -2, 0, 3.141592653589793, 2.0
761, 6, 112, 97, 111, 98, 1, -1, -0.7853981633974483, 1.4142135623730951
763, 8, 100, 84, 103, 84, -3, 0, 3.141592653589793, 3.0
765, 11, 122, 85, 121, 86, 1, -1, -0.7853981633974483, 1.4142135623730951
767, 20, 137, 23, 136, 25, 1, -2, -1.1071487177940904, 2.23606797749979
768, 24, 106, 19, 105, 21, 1, -2, -1.1071487177940904, 2.23606797749979
769, 19, 138, 32, 137, 33, 1, -1, -0.7853981633974483, 1.4142135623730951
772, 3, 153, 23, 154, 22, -1, 1, 2.356194490192345, 1.4142135623730951
772, 10, 107, 86, 106, 87, 1, -1, -0.7853981633974483, 1.4142135623730951
773, 12, 137, 15, 136, 16, 1, -1, -0.7853981633974483, 1.4142135623730951
774, 9, 108, 85, 107, 86, 1, -1, -0.7853981633974483, 1.4142135623730951
774, 11, 138, 14, 137, 15, 1, -1, -0.7853981633974483, 1.4142135623730951
778, 15, 126, 83, 125, 84, 1, -1, -0.7853981633974483, 1.4142135623730951
783, 16, 142, 23, 141, 24, 1, -1, -0.7853981633974483, 1.4142135623730951
785, 9, 105, 89, 106, 88, -1, 1, 2.356194490192345, 1.4142135623730951
792, 23, 76, 98, 75, 99, 1, -1, -0.7853981633974483, 1.4142135623730951
792, 25, 72, 27, 71, 28, 1, -1, -0.7853981633974483, 1.4142135623730951
793, 6, 110, 86, 109, 87, 1, -1, -0.7853981633974483, 1.4142135623730951
796, 21, 33, 91, 32, 93, 1, -2, -1.1071487177940904, 2.23606797749979
799, 4, 128, 30, 127, 31, 1, -1, -0.7853981633974483, 1.4142135623730951
799, 5, 146, 22, 145, 25, 1, -3, -1.2490457723982544, 3.1622776601683795
800, 32, 137, 88, 136, 89, 1, -1, -0.7853981633974483, 1.4142135623730951
801, 30, 69, 81, 69, 83, 0, -2, -1.5707963267948966, 2.0
802, 19, 112, 25, 111, 26, 1, -1, -0.7853981633974483, 1.4142135623730951
804, 4, 113, 84, 115, 85, -2, -1, -2.677945044588987, 2.23606797749979
804, 6, 128, 30, 127, 31, 1, -1, -0.7853981633974483, 1.4142135623730951
806, 19, 31, 69, 30, 70, 1, -1, -0.7853981633974483, 1.4142135623730951
809, 7, 22, 46, 25, 46, -3, 0, 3.141592653589793, 3.0
809, 16, 32, 67, 31, 68, 1, -1, -0.7853981633974483, 1.4142135623730951
811, 25, 134, 84, 133, 85, 1, -1, -0.7853981633974483, 1.4142135623730951
813, 3, 116, 85, 115, 86, 1, -1, -0.7853981633974483, 1.4142135623730951
813, 20, 115, 23, 114, 24, 1, -1, -0.7853981633974483, 1.4142135623730951
823, 26, 40, 31, 39, 32, 1, -1, -0.7853981633974483, 1.4142135623730951
829, 23, 117, 28, 116, 29, 1, -1, -0.7853981633974483, 1.4142135623730951
832, 28, 82, 28, 81, 29, 1, -1, -0.7853981633974483, 1.4142135623730951
834, 23, 37, 98, 36, 99, 1, -1, -0.7853981633974483, 1.4142135623730951
843, 13, 144, 81, 143, 82, 1, -1, -0.7853981633974483, 1.4142135623730951
844, 20, 121, 28, 120, 29, 1, -1, -0.7853981633974483, 1.4142135623730951
848, 9, 117, 83, 116, 84, 1, -1, -0.7853981633974483, 1.4142135623730951
848, 19, 134, 23, 133, 25, 1, -2, -1.1071487177940904, 2.23606797749979
849, 6, 92, 15, 91, 16, 1, -1, -0.7853981633974483, 1.4142135623730951
851, 18, 124, 26, 123, 27, 1, -1, -0.7853981633974483, 1.4142135623730951
852, 20, 41, 98, 41, 100, 0, -2, -1.5707963267948966, 2.0
852, 21, 128, 83, 127, 84, 1, -1, -0.7853981633974483, 1.4142135623730951
853, 20, 129, 82, 128, 83, 1, -1, -0.7853981633974483, 1.4142135623730951
854, 1, 158, 15, 157, 16, 1, -1, -0.7853981633974483, 1.4142135623730951
862, 14, 131, 83, 130, 84, 1, -1, -0.7853981633974483, 1.4142135623730951
863, 13, 129, 81, 131, 83, -2, -2, -2.356194490192345, 2.8284271247461903
863, 19, 149, 80, 148, 81, 1, -1, -0.7853981633974483, 1.4142135623730951
864, 7, 53, 14, 52, 15, 1, -1, -0.7853981633974483, 1.4142135623730951
864, 17, 39, 82, 37, 82, 2, 0, 0.0, 2.0
869, 5, 93, 97, 92, 98, 1, -1, -0.7853981633974483, 1.4142135623730951
878, 15, 139, 24, 141, 25, -2, -1, -2.677945044588987, 2.23606797749979
878, 16, 132, 24, 131, 25, 1, -1, -0.7853981633974483, 1.4142135623730951
879, 15, 134, 23, 132, 24, 2, -1, -0.4636476090008061, 2.23606797749979
883, 14, 126, 82, 125, 83, 1, -1, -0.7853981633974483, 1.4142135623730951
886, 8, 128, 83, 127, 84, 1, -1, -0.7853981633974483, 1.4142135623730951
888, 13, 100, 84, 102, 85, -2, -1, -2.677945044588987, 2.23606797749979
888, 25, 139, 82, 137, 82, 2, 0, 0.0, 2.0
893, 15, 156, 82, 155, 83, 1, -1, -0.7853981633974483, 1.4142135623730951
899, 12, 138, 24, 137, 25, 1, -1, -0.7853981633974483, 1.4142135623730951
904, 4, 147, 24, 149, 25, -2, -1, -2.677945044588987, 2.23606797749979
905, 30, 116, 29, 115, 30, 1, -1, -0.7853981633974483, 1.4142135623730951
912, 17, 140, 24, 140, 26, 0, -2, -1.5707963267948966, 2.0
917, 10, 146, 82, 145, 83, 1, -1, -0.7853981633974483, 1.4142135623730951
917, 22, 49, 36, 48, 37, 1, -1, -0.7853981633974483, 1.4142135623730951
919, 6, 142, 25, 141, 26, 1, -1, -0.7853981633974483, 1.4142135623730951
919, 20, 159, 31, 158, 33, 1, -2, -1.1071487177940904, 2.23606797749979
920, 3, 46, 26, 44, 27, 2, -1, -0.4636476090008061, 2.23606797749979
922, 24, 68, 83, 69, 82, -1, 1, 2.356194490192345, 1.4142135623730951
924, 0, 69, 14, 71, 14, -2, 0, 3.141592653589793, 2.0
931, 3, 141, 81, 140, 82, 1, -1, -0.7853981633974483, 1.4142135623730951
932, 4, 112, 86, 111, 87, 1, -1, -0.7853981633974483, 1.4142135623730951
932, 15, 151, 81, 150, 82, 1, -1, -0.7853981633974483, 1.4142135623730951
932, 17, 159, 27, 158, 28, 1, -1, -0.7853981633974483, 1.4142135623730951
938, 9, 142, 80, 141, 81, 1, -1, -0.7853981633974483, 1.4142135623730951
943, 9, 150, 26, 149, 27, 1, -1, -0.7853981633974483, 1.4142135623730951
947, 10, 116, 88, 114, 88, 2, 0, 0.0, 2.0
948, 9, 155, 82, 154, 83, 1, -1, -0.7853981633974483, 1.4142135623730951
954, 19, 148, 99, 147, 100, 1, -1, -0.7853981633974483, 1.4142135623730951
964, 5, 150, 79, 149, 80, 1, -1, -0.7853981633974483, 1.4142135623730951
968, 3, 117, 95, 116, 96, 1, -1, -0.7853981633974483, 1.4142135623730951
968, 11, 156, 26, 155, 27, 1, -1, -0.7853981633974483, 1.4142135623730951
970, 11, 68, 81, 69, 83, -1, -2, -2.0344439357957027, 2.23606797749979
975, 7, 119, 97, 118, 98, 1, -1, -0.7853981633974483, 1.4142135623730951
976, 10, 154, 80, 153, 81, 1, -1, -0.7853981633974483, 1.4142135623730951
979, 2, 51, 22, 50, 23, 1, -1, -0.7853981633974483, 1.4142135623730951
984, 17, 156, 97, 155, 98, 1, -1, -0.7853981633974483, 1.4142135623730951
995, 7, 97, 17, 96, 18, 1, -1, -0.7853981633974483, 1.4142135623730951
1000, 11, 134, 93, 133, 94, 1, -1, -0.7853981633974483, 1.4142135623730951
1008, 2, 54, 22, 53, 23, 1, -1, -0.7853981633974483, 1.4142135623730951
1013, 10, 134, 82, 133, 83, 1, -1, -0.7853981633974483, 1.4142135623730951
1016, 10, 132, 84, 134, 83, -2, 1, 2.677945044588987, 2.23606797749979
1017, 9, 131, 85, 132, 84, -1, 1, 2.356194490192345, 1.4142135623730951
1021, 16, 135, 83, 134, 84, 1, -1, -0.7853981633974483, 1.4142135623730951
1022, 12, 55, 100, 54, 101, 1, -1, -0.7853981633974483, 1.4142135623730951
1023, 16, 135, 80, 135, 82, 0, -2, -1.5707963267948966, 2.0
1027, 11, 138, 81, 137, 82, 1, -1, -0.7853981633974483, 1.4142135623730951
1029, 6, 136, 87, 139, 89, -3, -2, -2.5535900500422257, 3.605551275463989
1032, 15, 125, 30, 124, 31, 1, -1, -0.7853981633974483, 1.4142135623730951
1039, 1, 99, 15, 101, 15, -2, 0, 3.141592653589793, 2.0
1039, 3, 139, 78, 140, 80, -1, -2, -2.0344439357957027, 2.23606797749979
1039, 9, 124, 97, 123, 98, 1, -1, -0.7853981633974483, 1.4142135623730951
1044, 1, 102, 15, 104, 15, -2, 0, 3.141592653589793, 2.0
1044, 8, 142, 81, 141, 82, 1, -1, -0.7853981633974483, 1.4142135623730951
1054, 4, 141, 83, 143, 82, -2, 1, 2.677945044588987, 2.23606797749979
1059, 11, 145, 77, 145, 79, 0, -2, -1.5707963267948966, 2.0
1069, 3, 149, 80, 148, 81, 1, -1, -0.7853981633974483, 1.4142135623730951
1069, 7, 142, 94, 141, 95, 1, -1, -0.7853981633974483, 1.4142135623730951
1071, 5, 143, 96, 142, 97, 1, -1, -0.7853981633974483, 1.4142135623730951
1072, 12, 80, 27, 78, 28, 2, -1, -0.4636476090008061, 2.23606797749979
1080, 17, 92, 29, 91, 30, 1, -1, -0.7853981633974483, 1.4142135623730951
1082, 10, 140, 32, 139, 33, 1, -1, -0.7853981633974483, 1.4142135623730951
1084, 13, 93, 28, 92, 29, 1, -1, -0.7853981633974483, 1.4142135623730951
1085, 8, 68, 81, 68, 83, 0, -2, -1.5707963267948966, 2.0
1086, 10, 155, 81, 154, 82, 1, -1, -0.7853981633974483, 1.4142135623730951
1090, 20, 93, 28, 91, 28, 2, 0, 0.0, 2.0
1092, 4, 156, 79, 155, 80, 1, -1, -0.7853981633974483, 1.4142135623730951
1093, 4, 157, 78, 156, 79, 1, -1, -0.7853981633974483, 1.4142135623730951
1104, 5, 72, 21, 71, 22, 1, -1, -0.7853981633974483, 1.4142135623730951
1114, 9, 126, 15, 125, 16, 1, -1, -0.7853981633974483, 1.4142135623730951
1118, 9, 97, 25, 96, 26, 1, -1, -0.7853981633974483, 1.4142135623730951
1119, 11, 47, 98, 46, 99, 1, -1, -0.7853981633974483, 1.4142135623730951
1144, 10, 94, 83, 93, 84, 1, -1, -0.7853981633974483, 1.4142135623730951
1148, 6, 135, 16, 134, 17, 1, -1, -0.7853981633974483, 1.4142135623730951
1149, 7, 159, 29, 157, 30, 2, -1, -0.4636476090008061, 2.23606797749979
1152, 7, 59, 89, 58, 90, 1, -1, -0.7853981633974483, 1.4142135623730951
1168, 9, 60, 90, 59, 91, 1, -1, -0.7853981633974483, 1.4142135623730951
1178, 5, 111, 25, 110, 26, 1, -1, -0.7853981633974483, 1.4142135623730951
1184, 5, 76, 20, 75, 21, 1, -1, -0.7853981633974483, 1.4142135623730951
1223, 3, 112, 84, 111, 85, 1, -1, -0.7853981633974483, 1.4142135623730951
1243, 2, 102, 27, 102, 29, 0, -2, -1.5707963267948966, 2.0
1272, 7, 91, 30, 92, 29, -1, 1, 2.356194490192345, 1.4142135623730951
1288, 6, 128, 83, 127, 84, 1, -1, -0.7853981633974483, 1.4142135623730951
1302, 1, 115, 28, 114, 29, 1, -1, -0.7853981633974483, 1.4142135623730951
1318, 3, 131, 84, 134, 83, -3, 1, 2.819842099193151, 3.1622776601683795
1320, 6, 121, 28, 120, 29, 1, -1, -0.7853981633974483, 1.4142135623730951
1323, 2, 92, 98, 91, 99, 1, -1, -0.7853981633974483, 1.4142135623730951
1332, 15, 123, 19, 122, 20, 1, -1, -0.7853981633974483, 1.4142135623730951
1332, 23, 76, 20, 75, 21, 1, -1, -0.7853981633974483, 1.4142135623730951
1333, 10, 124, 27, 123, 28, 1, -1, -0.7853981633974483, 1.4142135623730951
1335, 21, 147, 25, 146, 26, 1, -1, -0.7853981633974483, 1.4142135623730951
1338, 1, 140, 82, 139, 83, 1, -1, -0.7853981633974483, 1.4142135623730951
1338, 19, 148, 23, 147, 24, 1, -1, -0.7853981633974483, 1.4142135623730951
1340, 26, 90, 93, 89, 94, 1, -1, -0.7853981633974483, 1.4142135623730951
1341, 17, 103, 94, 103, 96, 0, -2, -1.5707963267948966, 2.0
1341, 26, 70, 85, 69, 86, 1, -1, -0.7853981633974483, 1.4142135623730951
1343, 17, 104, 94, 103, 93, 1, 1, 0.7853981633974483, 1.4142135623730951
1344, 21, 92, 19, 91, 21, 1, -2, -1.1071487177940904, 2.23606797749979
1348, 11, 159, 28, 158, 29, 1, -1, -0.7853981633974483, 1.4142135623730951
1349, 11, 158, 26, 159, 28, -1, -2, -2.0344439357957027, 2.23606797749979
1353, 22, 146, 27, 145, 28, 1, -1, -0.7853981633974483, 1.4142135623730951
1359, 14, 153, 25, 152, 26, 1, -1, -0.7853981633974483, 1.4142135623730951
1361, 18, 94, 89, 92, 91, 2, -2, -0.7853981633974483, 2.8284271247461903
1363, 9, 99, 15, 98, 16, 1, -1, -0.7853981633974483, 1.4142135623730951
1364, 2, 111, 19, 110, 20, 1, -1, -0.7853981633974483, 1.4142135623730951
1365, 18, 119, 23, 118, 24, 1, -1, -0.7853981633974483, 1.4142135623730951
1369, 8, 132, 30, 131, 31, 1, -1, -0.7853981633974483, 1.4142135623730951
1373, 8, 131, 21, 130, 22, 1, -1, -0.7853981633974483, 1.4142135623730951
1374, 11, 97, 93, 96, 94, 1, -1, -0.7853981633974483, 1.4142135623730951
1376, 20, 155, 35, 154, 37, 1, -2, -1.1071487177940904, 2.23606797749979
1379, 3, 117, 27, 116, 28, 1, -1, -0.7853981633974483, 1.4142135623730951
1379, 5, 61, 18, 63, 19, -2, -1, -2.677945044588987, 2.23606797749979
1380, 1, 115, 20, 114, 21, 1, -1, -0.7853981633974483, 1.4142135623730951
1380, 21, 88, 28, 87, 29, 1, -1, -0.7853981633974483, 1.4142135623730951
1383, 10, 136, 90, 135, 91, 1, -1, -0.7853981633974483, 1.4142135623730951
1387, 10, 136, 31, 135, 32, 1, -1, -0.7853981633974483, 1.4142135623730951
1388, 3, 154, 81, 153, 82, 1, -1, -0.7853981633974483, 1.4142135623730951
1389, 19, 111, 29, 110, 30, 1, -1, -0.7853981633974483, 1.4142135623730951
1394, 1, 117, 18, 116, 19, 1, -1, -0.7853981633974483, 1.4142135623730951
1394, 20, 109, 29, 108, 30, 1, -1, -0.7853981633974483, 1.4142135623730951
1396, 0, 158, 82, 157, 83, 1, -1, -0.7853981633974483, 1.4142135623730951
1399, 0, 157, 78, 158, 80, -1, -2, -2.0344439357957027, 2.23606797749979
1402, 14, 102, 94, 101, 95, 1, -1, -0.7853981633974483, 1.4142135623730951
1403, 9, 63, 19, 65, 19, -2, 0, 3.141592653589793, 2.0
1404, 5, 139, 22, 138, 23, 1, -1, -0.7853981633974483, 1.4142135623730951
1404, 13, 103, 92, 102, 93, 1, -1, -0.7853981633974483, 1.4142135623730951
1406, 6, 85, 98, 84, 99, 1, -1, -0.7853981633974483, 1.4142135623730951
1408, 8, 157, 82, 155, 83, 2, -1, -0.4636476090008061, 2.23606797749979
1412, 7, 159, 82, 158, 83, 1, -1, -0.7853981633974483, 1.4142135623730951
1416, 17, 94, 29, 93, 30, 1, -1, -0.7853981633974483, 1.4142135623730951
1417, 8, 125, 28, 124, 29, 1, -1, -0.7853981633974483, 1.4142135623730951
1419, 9, 118, 30, 117, 31, 1, -1, -0.7853981633974483, 1.4142135623730951
1421, 1, 124, 19, 123, 20, 1, -1, -0.7853981633974483, 1.4142135623730951
1421, 21, 92, 21, 91, 22, 1, -1, -0.7853981633974483, 1.4142135623730951
1422, 22, 106, 22, 105, 23, 1, -1, -0.7853981633974483, 1.4142135623730951
1431, 8, 122, 32, 121, 33, 1, -1, -0.7853981633974483, 1.4142135623730951
1434, 3, 147, 31, 146, 32, 1, -1, -0.7853981633974483, 1.4142135623730951
1437, 10, 131, 26, 132, 25, -1, 1, 2.356194490192345, 1.4142135623730951
1439, 6, 131, 25, 130, 26, 1, -1, -0.7853981633974483, 1.4142135623730951
1440, 8, 91, 98, 90, 99, 1, -1, -0.7853981633974483, 1.4142135623730951
1442, 1, 118, 97, 117, 98, 1, -1, -0.7853981633974483, 1.4142135623730951
1447, 9, 72, 22, 71, 23, 1, -1, -0.7853981633974483, 1.4142135623730951
1452, 18, 103, 96, 102, 97, 1, -1, -0.7853981633974483, 1.4142135623730951
1459, 3, 135, 30, 134, 31, 1, -1, -0.7853981633974483, 1.4142135623730951
1464, 5, 71, 32, 70, 31, 1, 1, 0.7853981633974483, 1.4142135623730951
1464, 13, 115, 92, 114, 91, 1, 1, 0.7853981633974483, 1.4142135623730951
1468, 11, 142, 17, 141, 18, 1, -1, -0.7853981633974483, 1.4142135623730951
1469, 4, 156, 21, 155, 22, 1, -1, -0.7853981633974483, 1.4142135623730951
1474, 4, 156, 33, 155, 34, 1, -1, -0.7853981633974483, 1.4142135623730951
1475, 14, 109, 31, 108, 32, 1, -1, -0.7853981633974483, 1.4142135623730951
1481, 1, 140, 19, 139, 20, 1, -1, -0.7853981633974483, 1.4142135623730951
1484, 6, 66, 80, 67, 83, -1, -3, -1.892546881191539, 3.1622776601683795
1488, 6, 130, 83, 129, 84, 1, -1, -0.7853981633974483, 1.4142135623730951
1490, 14, 117, 85, 116, 86, 1, -1, -0.7853981633974483, 1.4142135623730951
1502, 9, 153, 89, 155, 90, -2, -1, -2.677945044588987, 2.23606797749979
1505, 15, 151, 83, 150, 84, 1, -1, -0.7853981633974483, 1.4142135623730951
1506, 11, 118, 85, 117, 86, 1, -1, -0.7853981633974483, 1.4142135623730951
1506, 19, 108, 88, 107, 89, 1, -1, -0.7853981633974483, 1.4142135623730951
1508, 1, 144, 19, 146, 19, -2, 0, 3.141592653589793, 2.0
1508, 2, 147, 30, 146, 31, 1, -1, -0.7853981633974483, 1.4142135623730951
1511, 7, 78, 93, 77, 94, 1, -1, -0.7853981633974483, 1.4142135623730951
1512, 9, 117, 32, 116, 33, 1, -1, -0.7853981633974483, 1.4142135623730951
1523, 2, 152, 32, 151, 33, 1, -1, -0.7853981633974483, 1.4142135623730951
1524, 6, 141, 82, 140, 83, 1, -1, -0.7853981633974483, 1.4142135623730951
1524, 8, 155, 26, 154, 27, 1, -1, -0.7853981633974483, 1.4142135623730951
1528, 2, 151, 19, 150, 20, 1, -1, -0.7853981633974483, 1.4142135623730951
1528, 14, 82, 91, 81, 92, 1, -1, -0.7853981633974483, 1.4142135623730951
1529, 8, 137, 84, 140, 83, -3, 1, 2.819842099193151, 3.1622776601683795
1533, 1, 151, 19, 150, 20, 1, -1, -0.7853981633974483, 1.4142135623730951
1533, 6, 155, 32, 154, 33, 1, -1, -0.7853981633974483, 1.4142135623730951
1535, 3, 138, 17, 137, 18, 1, -1, -0.7853981633974483, 1.4142135623730951
1541, 8, 145, 83, 144, 84, 1, -1, -0.7853981633974483, 1.4142135623730951
1542, 8, 146, 82, 145, 83, 1, -1, -0.7853981633974483, 1.4142135623730951
1548, 7, 136, 33, 137, 32, -1, 1, 2.356194490192345, 1.4142135623730951
1554, 9, 110, 90, 109, 91, 1, -1, -0.7853981633974483, 1.4142135623730951
1558, 4, 133, 15, 140, 16, -7, -1, -2.999695598985629, 7.0710678118654755
1562, 3, 83, 29, 82, 30, 1, -1, -0.7853981633974483, 1.4142135623730951
1566, 1, 146, 83, 149, 83, -3, 0, 3.141592653589793, 3.0
1582, 5, 119, 90, 117, 91, 2, -1, -0.4636476090008061, 2.23606797749979
1584, 3, 148, 16, 147, 17, 1, -1, -0.7853981633974483, 1.4142135623730951
1587, 3, 151, 17, 150, 18, 1, -1, -0.7853981633974483, 1.4142135623730951
1592, 1, 159, 81, 158, 82, 1, -1, -0.7853981633974483, 1.4142135623730951
1593, 2, 126, 97, 125, 98, 1, -1, -0.7853981633974483, 1.4142135623730951
1598, 5, 148, 16, 151, 16, -3, 0, 3.141592653589793, 3.0
1599, 5, 150, 15, 148, 16, 2, -1, -0.4636476090008061, 2.23606797749979
1620, 14, 123, 21, 122, 22, 1, -1, -0.7853981633974483, 1.4142135623730951
1624, 7, 134, 80, 136, 80, -2, 0, 3.141592653589793, 2.0
1629, 5, 158, 15, 157, 16, 1, -1, -0.7853981633974483, 1.4142135623730951
1629, 6, 155, 96, 154, 97, 1, -1, -0.7853981633974483, 1.4142135623730951
1631, 6, 92, 98, 91, 99, 1, -1, -0.7853981633974483, 1.4142135623730951
1631, 13, 143, 96, 142, 97, 1, -1, -0.7853981633974483, 1.4142135623730951
1631, 15, 118, 31, 117, 32, 1, -1, -0.7853981633974483, 1.4142135623730951
1637, 6, 132, 89, 131, 90, 1, -1, -0.7853981633974483, 1.4142135623730951
1641, 5, 117, 16, 116, 17, 1, -1, -0.7853981633974483, 1.4142135623730951
1642, 5, 118, 15, 117, 16, 1, -1, -0.7853981633974483, 1.4142135623730951
1644, 3, 114, 22, 113, 23, 1, -1, -0.7853981633974483, 1.4142135623730951
1644, 8, 148, 81, 150, 81, -2, 0, 3.141592653589793, 2.0
1644, 11, 117, 34, 115, 34, 2, 0, 0.0, 2.0
1646, 11, 158, 35, 157, 36, 1, -1, -0.7853981633974483, 1.4142135623730951
1648, 5, 124, 16, 123, 17, 1, -1, -0.7853981633974483, 1.4142135623730951
1650, 3, 100, 30, 99, 31, 1, -1, -0.7853981633974483, 1.4142135623730951
1652, 2, 117, 23, 116, 24, 1, -1, -0.7853981633974483, 1.4142135623730951
1652, 7, 138, 88, 137, 89, 1, -1, -0.7853981633974483, 1.4142135623730951
1653, 6, 136, 87, 138, 88, -2, -1, -2.677945044588987, 2.23606797749979
1653, 9, 156, 90, 155, 91, 1, -1, -0.7853981633974483, 1.4142135623730951
1655, 14, 141, 18, 140, 19, 1, -1, -0.7853981633974483, 1.4142135623730951
1655, 15, 131, 21, 130, 22, 1, -1, -0.7853981633974483, 1.4142135623730951
1662, 1, 119, 23, 118, 24, 1, -1, -0.7853981633974483, 1.4142135623730951
1662, 8, 109, 29, 111, 29, -2, 0, 3.141592653589793, 2.0
1663, 8, 110, 28, 109, 29, 1, -1, -0.7853981633974483, 1.4142135623730951
1668, 5, 146, 80, 145, 81, 1, -1, -0.7853981633974483, 1.4142135623730951
1670, 13, 148, 82, 147, 83, 1, -1, -0.7853981633974483, 1.4142135623730951
1679, 5, 146, 33, 145, 34, 1, -1, -0.7853981633974483, 1.4142135623730951
1680, 1, 125, 24, 124, 25, 1, -1, -0.7853981633974483, 1.4142135623730951
1692, 6, 149, 89, 147, 89, 2, 0, 0.0, 2.0
1694, 2, 106, 30, 107, 29, -1, 1, 2.356194490192345, 1.4142135623730951
1701, 5, 131, 16, 130, 17, 1, -1, -0.7853981633974483, 1.4142135623730951
1701, 8, 156, 80, 155, 81, 1, -1, -0.7853981633974483, 1.4142135623730951
1703, 2, 130, 24, 129, 25, 1, -1, -0.7853981633974483, 1.4142135623730951
1703, 7, 156, 24, 155, 26, 1, -2, -1.1071487177940904, 2.23606797749979
1704, 4, 159, 24, 156, 24, 3, 0, 0.0, 3.0
1707, 5, 158, 33, 157, 34, 1, -1, -0.7853981633974483, 1.4142135623730951
1720, 5, 135, 17, 134, 18, 1, -1, -0.7853981633974483, 1.4142135623730951
1722, 4, 115, 29, 114, 30, 1, -1, -0.7853981633974483, 1.4142135623730951
1724, 2, 135, 24, 134, 25, 1, -1, -0.7853981633974483, 1.4142135623730951
1732, 1, 138, 26, 137, 27, 1, -1, -0.7853981633974483, 1.4142135623730951
1734, 3, 148, 88, 147, 89, 1, -1, -0.7853981633974483, 1.4142135623730951
1736, 4, 139, 17, 138, 18, 1, -1, -0.7853981633974483, 1.4142135623730951
1745, 7, 154, 22, 153, 23, 1, -1, -0.7853981633974483, 1.4142135623730951
1747, 7, 155, 20, 154, 21, 1, -1, -0.7853981633974483, 1.4142135623730951
1749, 7, 156, 19, 155, 20, 1, -1, -0.7853981633974483, 1.4142135623730951
1751, 9, 152, 31, 151, 32, 1, -1, -0.7853981633974483, 1.4142135623730951
1752, 5, 136, 95, 135, 96, 1, -1, -0.7853981633974483, 1.4142135623730951
1755, 3, 145, 26, 144, 27, 1, -1, -0.7853981633974483, 1.4142135623730951
1762, 3, 125, 26, 124, 27, 1, -1, -0.7853981633974483, 1.4142135623730951
1763, 3, 122, 26, 125, 26, -3, 0, 3.141592653589793, 3.0
1764, 1, 148, 25, 147, 26, 1, -1, -0.7853981633974483, 1.4142135623730951
1764, 4, 142, 16, 144, 16, -2, 0, 3.141592653589793, 2.0
1767, 6, 147, 89, 146, 90, 1, -1, -0.7853981633974483, 1.4142135623730951
1773, 2, 145, 18, 144, 19, 1, -1, -0.7853981633974483, 1.4142135623730951
1776, 2, 129, 27, 128, 28, 1, -1, -0.7853981633974483, 1.4142135623730951
1778, 7, 149, 80, 148, 81, 1, -1, -0.7853981633974483, 1.4142135623730951
1779, 5, 149, 88, 148, 89, 1, -1, -0.7853981633974483, 1.4142135623730951
1784, 3, 141, 27, 140, 28, 1, -1, -0.7853981633974483, 1.4142135623730951
1785, 3, 132, 27, 131, 28, 1, -1, -0.7853981633974483, 1.4142135623730951
1787, 1, 153, 25, 152, 26, 1, -1, -0.7853981633974483, 1.4142135623730951
1787, 5, 147, 33, 146, 34, 1, -1, -0.7853981633974483, 1.4142135623730951
1788, 1, 155, 24, 153, 25, 2, -1, -0.4636476090008061, 2.23606797749979
1788, 3, 144, 24, 141, 27, 3, -3, -0.7853981633974483, 4.242640687119285
1789, 3, 154, 15, 151, 16, 3, -1, -0.3217505543966422, 3.1622776601683795
1793, 9, 148, 32, 147, 33, 1, -1, -0.7853981633974483, 1.4142135623730951
1795, 9, 149, 36, 148, 37, 1, -1, -0.7853981633974483, 1.4142135623730951
1798, 7, 155, 87, 154, 89, 1, -2, -1.1071487177940904, 2.23606797749979
1799, 6, 154, 78, 153, 79, 1, -1, -0.7853981633974483, 1.4142135623730951
1800, 7, 154, 85, 154, 83, 0, 2, 1.5707963267948966, 2.0
1815, 7, 147, 100, 146, 101, 1, -1, -0.7853981633974483, 1.4142135623730951
1816, 4, 151, 27, 149, 28, 2, -1, -0.4636476090008061, 2.23606797749979
1816, 5, 159, 27, 158, 28, 1, -1, -0.7853981633974483, 1.4142135623730951
1820, 4, 155, 35, 154, 36, 1, -1, -0.7853981633974483, 1.4142135623730951
1820, 5, 151, 29, 150, 30, 1, -1, -0.7853981633974483, 1.4142135623730951
1821, 5, 152, 28, 151, 29, 1, -1, -0.7853981633974483, 1.4142135623730951
1824, 1, 145, 86, 142, 87, 3, -1, -0.3217505543966422, 3.1622776601683795
1834, 2, 141, 27, 140, 28, 1, -1, -0.7853981633974483, 1.4142135623730951
1841, 5, 149, 80, 148, 81, 1, -1, -0.7853981633974483, 1.4142135623730951
1847, 1, 146, 27, 145, 28, 1, -1, -0.7853981633974483, 1.4142135623730951
1859, 1, 148, 26, 147, 27, 1, -1, -0.7853981633974483, 1.4142135623730951
1889, 1, 155, 88, 157, 88, -2, 0, 3.141592653589793, 2.0
1946, 0, 114, 81, 116, 82, -2, -1, -2.677945044588987, 2.23606797749979
